Type,Product,Started Date,Completed Date,Description,Amount,Fee,Currency,State,Balance
Transfer,Deposit,2024-10-06 17:32:08,2024-10-06 17:32:08,Savings Vault topup,11900.00,0.00,EUR,COMPLETED,11900.00
Interest,Deposit,2024-10-07 02:00:00,2024-10-07 03:16:01,Interest earned - Instant Access Savings,0.80,0.26,EUR,COMPLETED,11900.54
Transfer,Deposit,2024-10-07 15:33:56,2024-10-07 15:33:56,From Instant Access Savings,-1107.00,0.00,EUR,COMPLETED,10793.54
Interest,Deposit,2024-10-08 02:00:00,2024-10-08 03:46:28,Interest earned - Instant Access Savings,0.73,0.24,EUR,COMPLETED,10794.03
Transfer,Deposit,2024-10-08 07:55:32,2024-10-08 07:55:32,Savings Vault topup,27850.00,0.00,EUR,COMPLETED,38644.03
Interest,Deposit,2024-10-09 02:00:00,2024-10-09 04:01:11,Interest earned - Instant Access Savings,2.60,0.86,EUR,COMPLETED,38645.77
Transfer,Deposit,2024-10-09 17:53:54,2024-10-09 17:53:54,From Instant Access Savings,-100.00,0.00,EUR,COMPLETED,38545.77
Transfer,Deposit,2024-10-09 18:09:38,2024-10-09 18:09:38,From Instant Access Savings,-150.00,0.00,EUR,COMPLETED,38395.77
Transfer,Deposit,2024-10-09 20:37:19,2024-10-09 20:37:20,From Instant Access Savings,-120.00,0.00,EUR,COMPLETED,38275.77
Interest,Deposit,2024-10-10 02:00:00,2024-10-10 04:01:50,Interest earned - Instant Access Savings,2.59,0.85,EUR,COMPLETED,38277.51
Interest,Deposit,2024-10-11 02:00:00,2024-10-11 04:06:07,Interest earned - Instant Access Savings,2.58,0.85,EUR,COMPLETED,38279.24
Transfer,Deposit,2024-10-11 08:59:34,2024-10-11 08:59:34,From Instant Access Savings,-120.00,0.00,EUR,COMPLETED,38159.24
Transfer,Deposit,2024-10-11 19:50:52,2024-10-11 19:50:52,From Instant Access Savings,-100.00,0.00,EUR,COMPLETED,38059.24
Interest,Deposit,2024-10-12 02:00:00,2024-10-12 03:26:27,Interest earned - Instant Access Savings,2.57,0.85,EUR,COMPLETED,38060.96
Transfer,Deposit,2024-10-12 11:38:07,2024-10-12 11:38:07,From Instant Access Savings,-100.00,0.00,EUR,COMPLETED,37960.96
Transfer,Deposit,2024-10-12 11:54:52,2024-10-12 11:54:52,From Instant Access Savings,-100.00,0.00,EUR,COMPLETED,37860.96
Transfer,Deposit,2024-10-12 12:22:35,2024-10-12 12:22:35,From Instant Access Savings,-250.00,0.00,EUR,COMPLETED,37610.96
Interest,Deposit,2024-10-13 02:00:00,2024-10-13 03:36:43,Interest earned - Instant Access Savings,2.54,0.84,EUR,COMPLETED,37612.66
Transfer,Deposit,2024-10-13 10:22:59,2024-10-13 10:22:59,From Instant Access Savings,-100.00,0.00,EUR,COMPLETED,37512.66
Transfer,Deposit,2024-10-13 16:30:58,2024-10-13 16:30:58,From Instant Access Savings,-100.00,0.00,EUR,COMPLETED,37412.66
Interest,Deposit,2024-10-14 02:00:00,2024-10-14 03:38:04,Interest earned - Instant Access Savings,2.52,0.83,EUR,COMPLETED,37414.35
Transfer,Deposit,2024-10-14 13:52:03,2024-10-14 13:52:03,From Instant Access Savings,-250.00,0.00,EUR,COMPLETED,37164.35
Interest,Deposit,2024-10-15 02:00:00,2024-10-15 03:51:51,Interest earned - Instant Access Savings,2.51,0.83,EUR,COMPLETED,37166.03
Interest,Deposit,2024-10-16 02:00:00,2024-10-16 03:55:06,Interest earned - Instant Access Savings,2.51,0.83,EUR,COMPLETED,37167.71
Transfer,Deposit,2024-10-16 17:23:55,2024-10-16 17:23:55,From Instant Access Savings,-125.00,0.00,EUR,COMPLETED,37042.71
Transfer,Deposit,2024-10-16 18:57:03,2024-10-16 18:57:03,Savings Vault topup,1400.00,0.00,EUR,COMPLETED,38442.71
Interest,Deposit,2024-10-17 02:00:00,2024-10-17 03:54:00,Interest earned - Instant Access Savings,2.59,0.85,EUR,COMPLETED,38444.45
Interest,Deposit,2024-10-18 02:00:00,2024-10-18 03:37:56,Interest earned - Instant Access Savings,2.60,0.86,EUR,COMPLETED,38446.19
Interest,Deposit,2024-10-19 02:00:00,2024-10-19 03:32:57,Interest earned - Instant Access Savings,2.59,0.86,EUR,COMPLETED,38447.92
Transfer,Deposit,2024-10-19 19:07:47,2024-10-19 19:07:47,From Instant Access Savings,-750.00,0.00,EUR,COMPLETED,37697.92
Interest,Deposit,2024-10-20 02:00:00,2024-10-20 03:42:50,Interest earned - Instant Access Savings,2.55,0.84,EUR,COMPLETED,37699.63
Transfer,Deposit,2024-10-20 15:22:48,2024-10-20 15:22:48,From Instant Access Savings,-100.00,0.00,EUR,COMPLETED,37599.63
Transfer,Deposit,2024-10-20 18:24:49,2024-10-20 18:24:50,From Instant Access Savings,-100.00,0.00,EUR,COMPLETED,37499.63
Interest,Deposit,2024-10-21 02:00:00,2024-10-21 03:24:46,Interest earned - Instant Access Savings,2.53,0.83,EUR,COMPLETED,37501.33
Transfer,Deposit,2024-10-21 19:40:55,2024-10-21 19:40:55,From Instant Access Savings,-700.00,0.00,EUR,COMPLETED,36801.33
Interest,Deposit,2024-10-22 02:00:00,2024-10-22 03:58:08,Interest earned - Instant Access Savings,2.48,0.82,EUR,COMPLETED,36802.99
Interest,Deposit,2024-10-23 02:00:00,2024-10-23 03:26:50,Interest earned - Instant Access Savings,2.48,0.82,EUR,COMPLETED,36804.65
Transfer,Deposit,2024-10-23 07:40:55,2024-10-23 07:40:55,Savings Vault topup,473.00,0.00,EUR,COMPLETED,37277.65
Transfer,Deposit,2024-10-23 13:58:06,2024-10-23 13:58:06,From Instant Access Savings,-250.00,0.00,EUR,COMPLETED,37027.65
Transfer,Deposit,2024-10-23 19:20:33,2024-10-23 19:20:33,From Instant Access Savings,-100.00,0.00,EUR,COMPLETED,36927.65
Interest,Deposit,2024-10-24 02:00:00,2024-10-24 04:13:36,Interest earned - Instant Access Savings,2.50,0.82,EUR,COMPLETED,36929.33
Interest,Deposit,2024-10-25 02:00:00,2024-10-25 03:59:44,Interest earned - Instant Access Savings,2.49,0.83,EUR,COMPLETED,36930.99
Transfer,Deposit,2024-10-25 15:20:41,2024-10-25 15:20:41,Savings Vault topup,2000.00,0.00,EUR,COMPLETED,38930.99
Interest,Deposit,2024-10-26 02:00:00,2024-10-26 04:36:37,Interest earned - Instant Access Savings,2.63,0.86,EUR,COMPLETED,38932.76
Interest,Deposit,2024-10-27 01:00:00,2024-10-27 02:53:36,Interest earned - Instant Access Savings,2.62,0.87,EUR,COMPLETED,38934.51
Interest,Deposit,2024-10-28 01:00:00,2024-10-28 02:39:05,Interest earned - Instant Access Savings,2.63,0.87,EUR,COMPLETED,38936.27
Interest,Deposit,2024-10-29 01:00:00,2024-10-29 03:20:44,Interest earned - Instant Access Savings,2.63,0.86,EUR,COMPLETED,38938.04
Transfer,Deposit,2024-10-29 21:11:57,2024-10-29 21:11:57,Savings Vault topup,5.00,0.00,EUR,COMPLETED,38943.04
Transfer,Deposit,2024-10-29 22:02:15,2024-10-29 22:02:15,Savings Vault topup,4.50,0.00,EUR,COMPLETED,38947.54
Interest,Deposit,2024-10-30 01:00:00,2024-10-30 03:03:44,Interest earned - Instant Access Savings,2.63,0.87,EUR,COMPLETED,38949.30
Transfer,Deposit,2024-10-30 08:24:11,2024-10-30 08:24:11,Savings Vault topup,5.00,0.00,EUR,COMPLETED,38954.30
Transfer,Deposit,2024-10-30 08:28:28,2024-10-30 08:28:28,Savings Vault topup,5.00,0.00,EUR,COMPLETED,38959.30
Transfer,Deposit,2024-10-30 13:12:34,2024-10-30 13:12:34,Savings Vault topup,2.75,0.00,EUR,COMPLETED,38962.05
Transfer,Deposit,2024-10-30 16:49:57,2024-10-30 16:49:57,Savings Vault topup,2.05,0.00,EUR,COMPLETED,38964.10
Interest,Deposit,2024-10-31 01:00:00,2024-10-31 03:26:12,Interest earned - Instant Access Savings,2.63,0.87,EUR,COMPLETED,38965.86
Transfer,Deposit,2024-10-31 07:35:03,2024-10-31 07:35:03,Savings Vault topup,2.55,0.00,EUR,COMPLETED,38968.41
Transfer,Deposit,2024-10-31 07:41:14,2024-10-31 07:41:14,Savings Vault topup,4.65,0.00,EUR,COMPLETED,38973.06
Transfer,Deposit,2024-10-31 08:13:00,2024-10-31 08:13:00,Savings Vault topup,5.00,0.00,EUR,COMPLETED,38978.06
Transfer,Deposit,2024-10-31 11:57:04,2024-10-31 11:57:04,Savings Vault topup,5.00,0.00,EUR,COMPLETED,38983.06
Transfer,Deposit,2024-10-31 17:00:44,2024-10-31 17:00:44,Savings Vault topup,5.00,0.00,EUR,COMPLETED,38988.06
Transfer,Deposit,2024-10-31 19:21:36,2024-10-31 19:21:36,Savings Vault topup,5.00,0.00,EUR,COMPLETED,38993.06
Transfer,Deposit,2024-10-31 19:34:59,2024-10-31 19:34:59,Savings Vault topup,2.50,0.00,EUR,COMPLETED,38995.56
Transfer,Deposit,2024-10-31 20:21:42,2024-10-31 20:21:42,Savings Vault topup,2.00,0.00,EUR,COMPLETED,38997.56
Interest,Deposit,2024-11-01 01:00:00,2024-11-01 03:56:33,Interest earned - Instant Access Savings,2.63,0.87,EUR,COMPLETED,38999.32
Transfer,Deposit,2024-11-01 08:29:23,2024-11-01 08:29:24,Savings Vault topup,3.50,0.00,EUR,COMPLETED,39002.82
Transfer,Deposit,2024-11-01 13:28:53,2024-11-01 13:28:53,Savings Vault topup,2.25,0.00,EUR,COMPLETED,39005.07
Transfer,Deposit,2024-11-01 15:07:53,2024-11-01 15:07:53,Savings Vault topup,5.00,0.00,EUR,COMPLETED,39010.07
Transfer,Deposit,2024-11-01 17:09:11,2024-11-01 17:09:11,Savings Vault topup,2.50,0.00,EUR,COMPLETED,39012.57
Transfer,Deposit,2024-11-01 17:14:51,2024-11-01 17:14:51,Savings Vault topup,1.50,0.00,EUR,COMPLETED,39014.07
Transfer,Deposit,2024-11-01 17:47:05,2024-11-01 17:47:05,Savings Vault topup,4.50,0.00,EUR,COMPLETED,39018.57
Transfer,Deposit,2024-11-01 20:41:40,2024-11-01 20:41:40,Savings Vault topup,1.00,0.00,EUR,COMPLETED,39019.57
Transfer,Deposit,2024-11-01 21:10:59,2024-11-01 21:10:59,Savings Vault topup,5.00,0.00,EUR,COMPLETED,39024.57
Transfer,Deposit,2024-11-01 21:43:21,2024-11-01 21:43:21,Savings Vault topup,4.00,0.00,EUR,COMPLETED,39028.57
Transfer,Deposit,2024-11-01 23:18:11,2024-11-01 23:18:11,Savings Vault topup,5.00,0.00,EUR,COMPLETED,39033.57
Interest,Deposit,2024-11-02 01:00:00,2024-11-02 03:36:13,Interest earned - Instant Access Savings,2.63,0.87,EUR,COMPLETED,39035.33
Transfer,Deposit,2024-11-02 10:33:04,2024-11-02 10:33:04,From Instant Access Savings,-100.00,0.00,EUR,COMPLETED,38935.33
Transfer,Deposit,2024-11-02 10:33:11,2024-11-02 10:33:11,Savings Vault topup,0.25,0.00,EUR,COMPLETED,38935.58
Transfer,Deposit,2024-11-02 11:00:25,2024-11-02 11:00:25,Savings Vault topup,0.70,0.00,EUR,COMPLETED,38936.28
Transfer,Deposit,2024-11-02 11:10:35,2024-11-02 11:10:35,Savings Vault topup,1.25,0.00,EUR,COMPLETED,38937.53
Transfer,Deposit,2024-11-02 15:05:16,2024-11-02 15:05:16,Savings Vault topup,4.85,0.00,EUR,COMPLETED,38942.38
Transfer,Deposit,2024-11-02 19:13:12,2024-11-02 19:13:12,Savings Vault topup,0.10,0.00,EUR,COMPLETED,38942.48
Interest,Deposit,2024-11-03 01:00:00,2024-11-03 02:59:46,Interest earned - Instant Access Savings,2.63,0.86,EUR,COMPLETED,38944.25
Transfer,Deposit,2024-11-03 12:31:59,2024-11-03 12:31:59,From Instant Access Savings,-100.00,0.00,EUR,COMPLETED,38844.25
Transfer,Deposit,2024-11-03 12:34:45,2024-11-03 12:34:46,Savings Vault topup,4.60,0.00,EUR,COMPLETED,38848.85
Transfer,Deposit,2024-11-03 19:54:08,2024-11-03 19:54:09,Savings Vault topup,2.15,0.00,EUR,COMPLETED,38851.00
Transfer,Deposit,2024-11-04 02:51:48,2024-11-04 02:51:48,Savings Vault topup,0.05,0.00,EUR,COMPLETED,38851.05
Interest,Deposit,2024-11-04 01:00:00,2024-11-04 02:55:51,Interest earned - Instant Access Savings,2.62,0.87,EUR,COMPLETED,38852.80
Transfer,Deposit,2024-11-04 08:11:45,2024-11-04 08:11:45,Savings Vault topup,5.00,0.00,EUR,COMPLETED,38857.80
Transfer,Deposit,2024-11-04 09:36:20,2024-11-04 09:36:21,Savings Vault topup,1.15,0.00,EUR,COMPLETED,38858.95
Transfer,Deposit,2024-11-04 13:54:34,2024-11-04 13:54:35,From Instant Access Savings,-1200.00,0.00,EUR,COMPLETED,37658.95
Transfer,Deposit,2024-11-04 18:03:03,2024-11-04 18:03:03,Savings Vault topup,2.50,0.00,EUR,COMPLETED,37661.45
Transfer,Deposit,2024-11-04 18:04:24,2024-11-04 18:04:24,Savings Vault topup,4.55,0.00,EUR,COMPLETED,37666.00
Interest,Deposit,2024-11-05 01:00:00,2024-11-05 03:26:22,Interest earned - Instant Access Savings,2.54,0.84,EUR,COMPLETED,37667.70
Transfer,Deposit,2024-11-05 08:39:56,2024-11-05 08:39:56,Savings Vault topup,5.00,0.00,EUR,COMPLETED,37672.70
Interest,Deposit,2024-11-06 01:00:00,2024-11-06 03:14:54,Interest earned - Instant Access Savings,2.55,0.84,EUR,COMPLETED,37674.41
Transfer,Deposit,2024-11-06 09:20:02,2024-11-06 09:20:02,Savings Vault topup,0.25,0.00,EUR,COMPLETED,37674.66
Transfer,Deposit,2024-11-06 16:16:31,2024-11-06 16:16:31,Savings Vault topup,3.95,0.00,EUR,COMPLETED,37678.61
Transfer,Deposit,2024-11-06 16:59:11,2024-11-06 16:59:11,Savings Vault topup,2.50,0.00,EUR,COMPLETED,37681.11
Transfer,Deposit,2024-11-06 18:31:07,2024-11-06 18:31:07,Savings Vault topup,0.80,0.00,EUR,COMPLETED,37681.91
Interest,Deposit,2024-11-07 01:00:00,2024-11-07 03:27:34,Interest earned - Instant Access Savings,2.54,0.84,EUR,COMPLETED,37683.61
Transfer,Deposit,2024-11-07 08:41:26,2024-11-07 08:41:26,Savings Vault topup,2.95,0.00,EUR,COMPLETED,37686.56
Transfer,Deposit,2024-11-07 23:33:07,2024-11-07 23:33:07,Savings Vault topup,1.65,0.00,EUR,COMPLETED,37688.21
Interest,Deposit,2024-11-08 01:00:00,2024-11-08 03:21:00,Interest earned - Instant Access Savings,2.54,0.83,EUR,COMPLETED,37689.92
Transfer,Deposit,2024-11-08 08:12:56,2024-11-08 08:12:56,From Instant Access Savings,-100.00,0.00,EUR,COMPLETED,37589.92
Transfer,Deposit,2024-11-08 08:39:39,2024-11-08 08:39:39,Savings Vault topup,4.00,0.00,EUR,COMPLETED,37593.92
Transfer,Deposit,2024-11-08 10:20:15,2024-11-08 10:20:15,Savings Vault topup,4.55,0.00,EUR,COMPLETED,37598.47
Transfer,Deposit,2024-11-08 10:27:01,2024-11-08 10:27:01,Savings Vault topup,1.75,0.00,EUR,COMPLETED,37600.22
Transfer,Deposit,2024-11-08 19:36:16,2024-11-08 19:36:16,Savings Vault topup,5.00,0.00,EUR,COMPLETED,37605.22
Transfer,Deposit,2024-11-08 20:01:05,2024-11-08 20:01:05,From Instant Access Savings,-100.00,0.00,EUR,COMPLETED,37505.22
Transfer,Deposit,2024-11-08 20:17:04,2024-11-08 20:17:04,Savings Vault topup,3.50,0.00,EUR,COMPLETED,37508.72
Interest,Deposit,2024-11-09 01:00:00,2024-11-09 04:20:38,Interest earned - Instant Access Savings,2.53,0.84,EUR,COMPLETED,37510.41
Transfer,Deposit,2024-11-09 09:52:56,2024-11-09 09:52:56,Savings Vault topup,4.50,0.00,EUR,COMPLETED,37514.91
Transfer,Deposit,2024-11-09 15:01:44,2024-11-09 15:01:44,Savings Vault topup,5.00,0.00,EUR,COMPLETED,37519.91
Interest,Deposit,2024-11-10 01:00:00,2024-11-10 03:24:13,Interest earned - Instant Access Savings,2.54,0.84,EUR,COMPLETED,37521.61
Transfer,Deposit,2024-11-10 08:42:23,2024-11-10 08:42:23,Savings Vault topup,3.50,0.00,EUR,COMPLETED,37525.11
Transfer,Deposit,2024-11-10 12:47:46,2024-11-10 12:47:46,From Instant Access Savings,-100.00,0.00,EUR,COMPLETED,37425.11
Transfer,Deposit,2024-11-10 12:47:57,2024-11-10 12:47:57,Savings Vault topup,0.25,0.00,EUR,COMPLETED,37425.36
Transfer,Deposit,2024-11-10 14:25:42,2024-11-10 14:25:42,Savings Vault topup,4.85,0.00,EUR,COMPLETED,37430.21
Interest,Deposit,2024-11-11 01:00:00,2024-11-11 03:34:36,Interest earned - Instant Access Savings,2.52,0.83,EUR,COMPLETED,37431.90
Transfer,Deposit,2024-11-11 11:33:27,2024-11-11 11:33:27,Savings Vault topup,0.30,0.00,EUR,COMPLETED,37432.20
Transfer,Deposit,2024-11-11 14:17:57,2024-11-11 14:17:57,From Instant Access Savings,-250.00,0.00,EUR,COMPLETED,37182.20
Transfer,Deposit,2024-11-11 14:18:51,2024-11-11 14:18:51,Savings Vault topup,5.00,0.00,EUR,COMPLETED,37187.20
Interest,Deposit,2024-11-12 01:00:00,2024-11-12 03:51:35,Interest earned - Instant Access Savings,2.51,0.83,EUR,COMPLETED,37188.88
Transfer,Deposit,2024-11-12 09:04:52,2024-11-12 09:04:52,Savings Vault topup,0.25,0.00,EUR,COMPLETED,37189.13
Transfer,Deposit,2024-11-12 13:38:38,2024-11-12 13:38:38,From Instant Access Savings,-1000.00,0.00,EUR,COMPLETED,36189.13
Transfer,Deposit,2024-11-12 16:08:06,2024-11-12 16:08:06,Savings Vault topup,2.50,0.00,EUR,COMPLETED,36191.63
Transfer,Deposit,2024-11-12 16:55:38,2024-11-12 16:55:38,Savings Vault topup,5.00,0.00,EUR,COMPLETED,36196.63
Interest,Deposit,2024-11-13 01:00:00,2024-11-13 04:17:21,Interest earned - Instant Access Savings,2.45,0.81,EUR,COMPLETED,36198.27
Transfer,Deposit,2024-11-13 12:27:15,2024-11-13 12:27:15,From Instant Access Savings,-150.00,0.00,EUR,COMPLETED,36048.27
Transfer,Deposit,2024-11-13 13:04:55,2024-11-13 13:04:55,Savings Vault topup,3.30,0.00,EUR,COMPLETED,36051.57
Transfer,Deposit,2024-11-13 16:42:36,2024-11-13 16:42:36,From Instant Access Savings,-100.00,0.00,EUR,COMPLETED,35951.57
Transfer,Deposit,2024-11-13 16:42:46,2024-11-13 16:42:46,Savings Vault topup,1.75,0.00,EUR,COMPLETED,35953.32
Transfer,Deposit,2024-11-13 16:44:31,2024-11-13 16:44:31,Savings Vault topup,3.45,0.00,EUR,COMPLETED,35956.77
Transfer,Deposit,2024-11-13 17:07:49,2024-11-13 17:07:49,Savings Vault topup,4.55,0.00,EUR,COMPLETED,35961.32
Transfer,Deposit,2024-11-13 17:09:12,2024-11-13 17:09:12,Savings Vault topup,4.55,0.00,EUR,COMPLETED,35965.87
Transfer,Deposit,2024-11-13 17:11:40,2024-11-13 17:11:40,Savings Vault topup,4.55,0.00,EUR,COMPLETED,35970.42
Transfer,Deposit,2024-11-13 22:10:21,2024-11-13 22:10:21,Savings Vault topup,5.00,0.00,EUR,COMPLETED,35975.42
Interest,Deposit,2024-11-14 01:00:00,2024-11-14 04:15:55,Interest earned - Instant Access Savings,2.42,0.79,EUR,COMPLETED,35977.05
Transfer,Deposit,2024-11-14 08:42:50,2024-11-14 08:42:50,Savings Vault topup,4.50,0.00,EUR,COMPLETED,35981.55
Transfer,Deposit,2024-11-14 17:33:08,2024-11-14 17:33:08,Savings Vault topup,5.00,0.00,EUR,COMPLETED,35986.55
Interest,Deposit,2024-11-15 01:00:00,2024-11-15 03:51:22,Interest earned - Instant Access Savings,2.43,0.81,EUR,COMPLETED,35988.17
Transfer,Deposit,2024-11-15 14:32:38,2024-11-15 14:32:38,Savings Vault topup,2.10,0.00,EUR,COMPLETED,35990.27
Transfer,Deposit,2024-11-15 18:26:56,2024-11-15 18:26:57,From Instant Access Savings,-100.00,0.00,EUR,COMPLETED,35890.27
Transfer,Deposit,2024-11-15 18:28:16,2024-11-15 18:28:16,Savings Vault topup,1.50,0.00,EUR,COMPLETED,35891.77
Transfer,Deposit,2024-11-15 19:36:36,2024-11-15 19:36:37,Savings Vault topup,1.50,0.00,EUR,COMPLETED,35893.27
Transfer,Deposit,2024-11-15 20:58:59,2024-11-15 20:58:59,Savings Vault topup,2.50,0.00,EUR,COMPLETED,35895.77
Transfer,Deposit,2024-11-15 21:17:05,2024-11-15 21:17:05,Savings Vault topup,5.00,0.00,EUR,COMPLETED,35900.77
Transfer,Deposit,2024-11-15 23:13:15,2024-11-15 23:13:16,Savings Vault topup,2.50,0.00,EUR,COMPLETED,35903.27
Transfer,Deposit,2024-11-16 00:14:28,2024-11-16 00:14:29,From Instant Access Savings,-100.00,0.00,EUR,COMPLETED,35803.27
Transfer,Deposit,2024-11-16 00:14:38,2024-11-16 00:14:38,Savings Vault topup,5.00,0.00,EUR,COMPLETED,35808.27
Transfer,Deposit,2024-11-16 00:45:07,2024-11-16 00:45:07,From Instant Access Savings,-100.00,0.00,EUR,COMPLETED,35708.27
Transfer,Deposit,2024-11-16 00:46:42,2024-11-16 00:46:42,From Instant Access Savings,-100.00,0.00,EUR,COMPLETED,35608.27
Transfer,Deposit,2024-11-16 00:46:54,2024-11-16 00:46:54,Savings Vault topup,5.00,0.00,EUR,COMPLETED,35613.27
Transfer,Deposit,2024-11-16 01:19:21,2024-11-16 01:19:22,Savings Vault topup,5.00,0.00,EUR,COMPLETED,35618.27
Transfer,Deposit,2024-11-16 02:13:53,2024-11-16 02:13:53,Savings Vault topup,3.00,0.00,EUR,COMPLETED,35621.27
Interest,Deposit,2024-11-16 01:00:00,2024-11-16 04:04:40,Interest earned - Instant Access Savings,2.40,0.79,EUR,COMPLETED,35622.88
Transfer,Deposit,2024-11-16 11:34:10,2024-11-16 11:34:10,Savings Vault topup,4.25,0.00,EUR,COMPLETED,35627.13
Transfer,Deposit,2024-11-16 15:44:10,2024-11-16 15:44:10,Savings Vault topup,3.90,0.00,EUR,COMPLETED,35631.03
Transfer,Deposit,2024-11-16 20:49:16,2024-11-16 20:49:16,Savings Vault topup,5.00,0.00,EUR,COMPLETED,35636.03
Interest,Deposit,2024-11-17 01:00:00,2024-11-17 03:59:49,Interest earned - Instant Access Savings,2.41,0.79,EUR,COMPLETED,35637.65
Transfer,Deposit,2024-11-17 10:00:38,2024-11-17 10:00:38,Savings Vault topup,4.50,0.00,EUR,COMPLETED,35642.15
Transfer,Deposit,2024-11-17 10:49:45,2024-11-17 10:49:45,Savings Vault topup,4.50,0.00,EUR,COMPLETED,35646.65
Transfer,Deposit,2024-11-17 11:04:08,2024-11-17 11:04:08,Savings Vault topup,5.00,0.00,EUR,COMPLETED,35651.65
Transfer,Deposit,2024-11-17 14:24:33,2024-11-17 14:24:33,Savings Vault topup,3.25,0.00,EUR,COMPLETED,35654.90
Interest,Deposit,2024-11-18 01:00:00,2024-11-18 03:50:59,Interest earned - Instant Access Savings,2.41,0.80,EUR,COMPLETED,35656.51
Transfer,Deposit,2024-11-18 14:27:09,2024-11-18 14:27:09,From Instant Access Savings,-100.00,0.00,EUR,COMPLETED,35556.51
Transfer,Deposit,2024-11-18 14:27:25,2024-11-18 14:27:25,Savings Vault topup,4.05,0.00,EUR,COMPLETED,35560.56
Transfer,Deposit,2024-11-18 18:45:54,2024-11-18 18:45:54,Savings Vault topup,5.00,0.00,EUR,COMPLETED,35565.56
Interest,Deposit,2024-11-19 01:00:00,2024-11-19 02:50:17,Interest earned - Instant Access Savings,2.40,0.79,EUR,COMPLETED,35567.17
Interest,Deposit,2024-11-20 01:00:00,2024-11-20 03:00:09,Interest earned - Instant Access Savings,2.40,0.79,EUR,COMPLETED,35568.78
Transfer,Deposit,2024-11-20 10:21:12,2024-11-20 10:21:12,From Instant Access Savings,-100.00,0.00,EUR,COMPLETED,35468.78
Transfer,Deposit,2024-11-20 10:21:28,2024-11-20 10:21:28,Savings Vault topup,0.25,0.00,EUR,COMPLETED,35469.03
Transfer,Deposit,2024-11-20 12:47:13,2024-11-20 12:47:13,Savings Vault topup,1.25,0.00,EUR,COMPLETED,35470.28
Transfer,Deposit,2024-11-20 16:38:09,2024-11-20 16:38:09,Savings Vault topup,2.50,0.00,EUR,COMPLETED,35472.78
Transfer,Deposit,2024-11-20 17:35:42,2024-11-20 17:35:43,Savings Vault topup,4.00,0.00,EUR,COMPLETED,35476.78
Interest,Deposit,2024-11-21 01:00:00,2024-11-21 03:30:35,Interest earned - Instant Access Savings,2.39,0.79,EUR,COMPLETED,35478.38
Transfer,Deposit,2024-11-21 08:31:05,2024-11-21 08:31:05,Savings Vault topup,2.50,0.00,EUR,COMPLETED,35480.88
Transfer,Deposit,2024-11-21 18:07:09,2024-11-21 18:07:09,Savings Vault topup,3.05,0.00,EUR,COMPLETED,35483.93
Interest,Deposit,2024-11-22 01:00:00,2024-11-22 03:43:20,Interest earned - Instant Access Savings,2.40,0.79,EUR,COMPLETED,35485.54
Transfer,Deposit,2024-11-22 14:59:31,2024-11-22 14:59:31,From Instant Access Savings,-1000.00,0.00,EUR,COMPLETED,34485.54
Interest,Deposit,2024-11-23 01:00:00,2024-11-23 03:42:55,Interest earned - Instant Access Savings,2.32,0.77,EUR,COMPLETED,34487.09
Transfer,Deposit,2024-11-23 16:48:31,2024-11-23 16:48:31,From Instant Access Savings,-125.00,0.00,EUR,COMPLETED,34362.09
Transfer,Deposit,2024-11-23 17:00:35,2024-11-23 17:00:35,From Instant Access Savings,-175.00,0.00,EUR,COMPLETED,34187.09
Transfer,Deposit,2024-11-23 17:01:16,2024-11-23 17:01:17,Savings Vault topup,4.20,0.00,EUR,COMPLETED,34191.29
Transfer,Deposit,2024-11-23 17:14:34,2024-11-23 17:14:35,Savings Vault topup,0.05,0.00,EUR,COMPLETED,34191.34
Transfer,Deposit,2024-11-23 17:19:17,2024-11-23 17:19:17,Savings Vault topup,5.00,0.00,EUR,COMPLETED,34196.34
Transfer,Deposit,2024-11-23 17:21:53,2024-11-23 17:21:53,Savings Vault topup,1.00,0.00,EUR,COMPLETED,34197.34
Transfer,Deposit,2024-11-23 19:47:27,2024-11-23 19:47:27,Savings Vault topup,2.50,0.00,EUR,COMPLETED,34199.84
Transfer,Deposit,2024-11-23 21:42:13,2024-11-23 21:42:13,Savings Vault topup,3.60,0.00,EUR,COMPLETED,34203.44
Transfer,Deposit,2024-11-24 01:12:02,2024-11-24 01:12:02,Savings Vault topup,3.50,0.00,EUR,COMPLETED,34206.94
Interest,Deposit,2024-11-24 01:00:00,2024-11-24 03:46:11,Interest earned - Instant Access Savings,2.31,0.76,EUR,COMPLETED,34208.49
Transfer,Deposit,2024-11-24 10:50:35,2024-11-24 10:50:35,Savings Vault topup,0.05,0.00,EUR,COMPLETED,34208.54
Transfer,Deposit,2024-11-24 12:31:29,2024-11-24 12:31:29,Savings Vault topup,3.25,0.00,EUR,COMPLETED,34211.79
Transfer,Deposit,2024-11-24 16:19:35,2024-11-24 16:19:35,Savings Vault topup,1.60,0.00,EUR,COMPLETED,34213.39
Transfer,Deposit,2024-11-24 19:00:44,2024-11-24 19:00:45,Savings Vault topup,2.75,0.00,EUR,COMPLETED,34216.14
Transfer,Deposit,2024-11-24 20:30:02,2024-11-24 20:30:02,From Instant Access Savings,-1900.00,0.00,EUR,COMPLETED,32316.14
Interest,Deposit,2024-11-25 01:00:00,2024-11-25 03:17:27,Interest earned - Instant Access Savings,2.18,0.72,EUR,COMPLETED,32317.60
Transfer,Deposit,2024-11-25 08:07:59,2024-11-25 08:07:59,Savings Vault topup,275.00,0.00,EUR,COMPLETED,32592.60
Transfer,Deposit,2024-11-25 08:46:55,2024-11-25 08:46:55,Savings Vault topup,1250.00,0.00,EUR,COMPLETED,33842.60
Transfer,Deposit,2024-11-25 10:40:30,2024-11-25 10:40:30,Savings Vault topup,750.00,0.00,EUR,COMPLETED,34592.60
Transfer,Deposit,2024-11-25 13:15:53,2024-11-25 13:15:53,Savings Vault topup,500.00,0.00,EUR,COMPLETED,35092.60
Transfer,Deposit,2024-11-25 15:06:46,2024-11-25 15:06:46,Savings Vault topup,5.00,0.00,EUR,COMPLETED,35097.60
Transfer,Deposit,2024-11-25 16:56:49,2024-11-25 16:56:49,Savings Vault topup,20000.00,0.00,EUR,COMPLETED,55097.60
Interest,Deposit,2024-11-26 01:00:00,2024-11-26 03:27:15,Interest earned - Instant Access Savings,3.72,1.23,EUR,COMPLETED,55100.09
Interest,Deposit,2024-11-27 01:00:00,2024-11-27 02:05:29,Interest earned - Instant Access Savings,3.72,1.23,EUR,COMPLETED,55102.58
Transfer,Deposit,2024-11-27 09:15:58,2024-11-27 09:15:59,Savings Vault topup,5.00,0.00,EUR,COMPLETED,55107.58
Transfer,Deposit,2024-11-27 22:08:36,2024-11-27 22:08:36,Savings Vault topup,1.60,0.00,EUR,COMPLETED,55109.18
Interest,Deposit,2024-11-28 01:00:00,2024-11-28 02:12:43,Interest earned - Instant Access Savings,3.72,1.22,EUR,COMPLETED,55111.68
Interest,Deposit,2024-11-29 01:00:00,2024-11-29 01:22:06,Interest earned - Instant Access Savings,3.13,1.04,EUR,COMPLETED,55113.77
Transfer,Deposit,2024-11-29 08:09:39,2024-11-29 08:09:39,Savings Vault topup,0.25,0.00,EUR,COMPLETED,55114.02
Transfer,Deposit,2024-11-29 12:13:54,2024-11-29 12:13:54,Savings Vault topup,0.25,0.00,EUR,COMPLETED,55114.27
Transfer,Deposit,2024-11-29 12:21:03,2024-11-29 12:21:03,Savings Vault topup,4.50,0.00,EUR,COMPLETED,55118.77
Transfer,Deposit,2024-11-29 16:24:16,2024-11-29 16:24:16,Savings Vault topup,5.00,0.00,EUR,COMPLETED,55123.77
Transfer,Deposit,2024-11-29 19:27:14,2024-11-29 19:27:14,Savings Vault topup,4.50,0.00,EUR,COMPLETED,55128.27
Transfer,Deposit,2024-11-29 19:41:23,2024-11-29 19:41:23,Savings Vault topup,2.15,0.00,EUR,COMPLETED,55130.42
Transfer,Deposit,2024-11-29 20:25:13,2024-11-29 20:25:13,Savings Vault topup,2.50,0.00,EUR,COMPLETED,55132.92
Transfer,Deposit,2024-11-29 20:29:04,2024-11-29 20:29:04,Savings Vault topup,1.50,0.00,EUR,COMPLETED,55134.42
Transfer,Deposit,2024-11-29 21:38:56,2024-11-29 21:38:56,Savings Vault topup,1.00,0.00,EUR,COMPLETED,55135.42
Transfer,Deposit,2024-11-29 23:59:28,2024-11-29 23:59:28,Savings Vault topup,3.00,0.00,EUR,COMPLETED,55138.42
Transfer,Deposit,2024-11-30 00:09:09,2024-11-30 00:09:09,Savings Vault topup,3.75,0.00,EUR,COMPLETED,55142.17
Transfer,Deposit,2024-11-30 00:12:26,2024-11-30 00:12:26,Savings Vault topup,0.25,0.00,EUR,COMPLETED,55142.42
Interest,Deposit,2024-11-30 01:00:00,2024-11-30 01:26:22,Interest earned - Instant Access Savings,3.13,1.03,EUR,COMPLETED,55144.52
Transfer,Deposit,2024-11-30 15:06:46,2024-11-30 15:06:46,Savings Vault topup,3.50,0.00,EUR,COMPLETED,55148.02
Transfer,Deposit,2024-11-30 16:28:54,2024-11-30 16:28:54,Savings Vault topup,5.00,0.00,EUR,COMPLETED,55153.02
Transfer,Deposit,2024-11-30 17:11:22,2024-11-30 17:11:22,From Instant Access Savings,-100.00,0.00,EUR,COMPLETED,55053.02
Transfer,Deposit,2024-11-30 17:11:35,2024-11-30 17:11:35,Savings Vault topup,2.50,0.00,EUR,COMPLETED,55055.52
Transfer,Deposit,2024-11-30 19:34:56,2024-11-30 19:34:56,Savings Vault topup,3.50,0.00,EUR,COMPLETED,55059.02
Transfer,Deposit,2024-11-30 20:07:07,2024-11-30 20:07:07,Savings Vault topup,0.25,0.00,EUR,COMPLETED,55059.27
Transfer,Deposit,2024-11-30 20:25:52,2024-11-30 20:25:52,Savings Vault topup,5.00,0.00,EUR,COMPLETED,55064.27
Transfer,Deposit,2024-11-30 20:55:09,2024-11-30 20:55:09,Savings Vault topup,3.50,0.00,EUR,COMPLETED,55067.77
Transfer,Deposit,2024-11-30 21:59:58,2024-11-30 21:59:58,Savings Vault topup,2.50,0.00,EUR,COMPLETED,55070.27
Interest,Deposit,2024-12-01 01:00:00,2024-12-01 01:54:54,Interest earned - Instant Access Savings,3.13,1.03,EUR,COMPLETED,55072.37
Transfer,Deposit,2024-12-01 13:01:10,2024-12-01 13:01:10,From Instant Access Savings,-100.00,0.00,EUR,COMPLETED,54972.37
Transfer,Deposit,2024-12-01 13:04:03,2024-12-01 13:04:03,Savings Vault topup,3.85,0.00,EUR,COMPLETED,54976.22
Interest,Deposit,2024-12-02 01:00:00,2024-12-02 01:49:03,Interest earned - Instant Access Savings,3.13,1.04,EUR,COMPLETED,54978.31
Transfer,Deposit,2024-12-02 07:41:33,2024-12-02 07:41:33,Savings Vault topup,2.55,0.00,EUR,COMPLETED,54980.86
Transfer,Deposit,2024-12-02 11:47:06,2024-12-02 11:47:06,Savings Vault topup,0.45,0.00,EUR,COMPLETED,54981.31
Transfer,Deposit,2024-12-02 18:14:21,2024-12-02 18:14:21,Savings Vault topup,3.50,0.00,EUR,COMPLETED,54984.81
Transfer,Deposit,2024-12-02 22:21:57,2024-12-02 22:21:58,From Instant Access Savings,-100.00,0.00,EUR,COMPLETED,54884.81
Interest,Deposit,2024-12-03 01:00:00,2024-12-03 01:27:55,Interest earned - Instant Access Savings,3.12,1.02,EUR,COMPLETED,54886.91
Transfer,Deposit,2024-12-03 18:08:33,2024-12-03 18:08:34,Savings Vault topup,4.50,0.00,EUR,COMPLETED,54891.41
Transfer,Deposit,2024-12-03 22:32:05,2024-12-03 22:32:05,Savings Vault topup,10688.00,0.00,EUR,COMPLETED,65579.41
Interest,Deposit,2024-12-04 01:00:00,2024-12-04 02:07:41,Interest earned - Instant Access Savings,3.72,1.23,EUR,COMPLETED,65581.90
Transfer,Deposit,2024-12-04 02:52:05,2024-12-04 02:52:05,Savings Vault topup,0.05,0.00,EUR,COMPLETED,65581.95
Transfer,Deposit,2024-12-04 08:16:02,2024-12-04 08:16:02,From Instant Access Savings,-1000.00,0.00,EUR,COMPLETED,64581.95
Transfer,Deposit,2024-12-04 09:36:27,2024-12-04 09:36:27,Savings Vault topup,1.00,0.00,EUR,COMPLETED,64582.95
Transfer,Deposit,2024-12-04 11:53:57,2024-12-04 11:53:57,From Instant Access Savings,-4500.00,0.00,EUR,COMPLETED,60082.95
Transfer,Deposit,2024-12-04 17:46:06,2024-12-04 17:46:06,Savings Vault topup,5.00,0.00,EUR,COMPLETED,60087.95
Transfer,Deposit,2024-12-04 19:02:18,2024-12-04 19:02:18,Savings Vault topup,2.95,0.00,EUR,COMPLETED,60090.90
Interest,Deposit,2024-12-05 01:00:00,2024-12-05 01:47:15,Interest earned - Instant Access Savings,3.42,1.13,EUR,COMPLETED,60093.19
Transfer,Deposit,2024-12-05 12:37:49,2024-12-05 12:37:49,Savings Vault topup,0.25,0.00,EUR,COMPLETED,60093.44
Transfer,Deposit,2024-12-05 18:02:53,2024-12-05 18:02:53,Savings Vault topup,2.50,0.00,EUR,COMPLETED,60095.94
Interest,Deposit,2024-12-06 01:00:00,2024-12-06 01:46:01,Interest earned - Instant Access Savings,3.41,1.13,EUR,COMPLETED,60098.22
Transfer,Deposit,2024-12-06 09:40:36,2024-12-06 09:40:36,Savings Vault topup,4.80,0.00,EUR,COMPLETED,60103.02
Transfer,Deposit,2024-12-06 14:42:10,2024-12-06 14:42:10,Savings Vault topup,4.60,0.00,EUR,COMPLETED,60107.62
Transfer,Deposit,2024-12-06 17:39:56,2024-12-06 17:39:56,From Instant Access Savings,-100.00,0.00,EUR,COMPLETED,60007.62
Interest,Deposit,2024-12-07 01:00:00,2024-12-07 01:44:35,Interest earned - Instant Access Savings,3.41,1.12,EUR,COMPLETED,60009.91
Transfer,Deposit,2024-12-07 16:32:23,2024-12-07 16:32:23,Savings Vault topup,0.80,0.00,EUR,COMPLETED,60010.71
Transfer,Deposit,2024-12-07 18:16:43,2024-12-07 18:16:43,From Instant Access Savings,-100.00,0.00,EUR,COMPLETED,59910.71
Interest,Deposit,2024-12-08 01:00:00,2024-12-08 01:35:25,Interest earned - Instant Access Savings,3.41,1.13,EUR,COMPLETED,59912.99
Transfer,Deposit,2024-12-08 16:06:25,2024-12-08 16:06:25,Savings Vault topup,3.25,0.00,EUR,COMPLETED,59916.24
Interest,Deposit,2024-12-09 01:00:00,2024-12-09 01:33:22,Interest earned - Instant Access Savings,3.40,1.12,EUR,COMPLETED,59918.52
Transfer,Deposit,2024-12-09 12:30:18,2024-12-09 12:30:18,Savings Vault topup,2.50,0.00,EUR,COMPLETED,59921.02
Transfer,Deposit,2024-12-09 19:34:51,2024-12-09 19:34:51,Savings Vault topup,5.00,0.00,EUR,COMPLETED,59926.02
Interest,Deposit,2024-12-10 01:00:00,2024-12-10 01:24:55,Interest earned - Instant Access Savings,3.41,1.12,EUR,COMPLETED,59928.31
Transfer,Deposit,2024-12-10 12:45:53,2024-12-10 12:45:53,Savings Vault topup,1.25,0.00,EUR,COMPLETED,59929.56
Transfer,Deposit,2024-12-10 18:21:38,2024-12-10 18:21:38,Savings Vault topup,2.90,0.00,EUR,COMPLETED,59932.46
Interest,Deposit,2024-12-11 01:00:00,2024-12-11 01:24:41,Interest earned - Instant Access Savings,3.41,1.13,EUR,COMPLETED,59934.74
Transfer,Deposit,2024-12-11 13:37:21,2024-12-11 13:37:21,Savings Vault topup,1.00,0.00,EUR,COMPLETED,59935.74
Transfer,Deposit,2024-12-11 17:10:01,2024-12-11 17:10:01,Savings Vault topup,2.50,0.00,EUR,COMPLETED,59938.24
Transfer,Deposit,2024-12-11 17:17:04,2024-12-11 17:17:04,Savings Vault topup,5.00,0.00,EUR,COMPLETED,59943.24
Transfer,Deposit,2024-12-11 17:32:11,2024-12-11 17:32:11,Savings Vault topup,5.00,0.00,EUR,COMPLETED,59948.24
Transfer,Deposit,2024-12-11 18:01:45,2024-12-11 18:01:45,Savings Vault topup,2.50,0.00,EUR,COMPLETED,59950.74
Transfer,Deposit,2024-12-11 18:22:16,2024-12-11 18:22:16,Savings Vault topup,5.00,0.00,EUR,COMPLETED,59955.74
Interest,Deposit,2024-12-12 01:00:00,2024-12-12 01:27:30,Interest earned - Instant Access Savings,3.40,1.12,EUR,COMPLETED,59958.02
Transfer,Deposit,2024-12-12 12:34:21,2024-12-12 12:34:21,Savings Vault topup,5.00,0.00,EUR,COMPLETED,59963.02
Transfer,Deposit,2024-12-12 14:21:35,2024-12-12 14:21:36,Savings Vault topup,3.00,0.00,EUR,COMPLETED,59966.02
Transfer,Deposit,2024-12-12 18:28:46,2024-12-12 18:28:46,From Instant Access Savings,-100.00,0.00,EUR,COMPLETED,59866.02
Transfer,Deposit,2024-12-12 18:29:05,2024-12-12 18:29:05,Savings Vault topup,5.00,0.00,EUR,COMPLETED,59871.02
Transfer,Deposit,2024-12-12 21:55:06,2024-12-12 21:55:07,Savings Vault topup,5.00,0.00,EUR,COMPLETED,59876.02
Interest,Deposit,2024-12-13 01:00:00,2024-12-13 01:35:16,Interest earned - Instant Access Savings,3.41,1.13,EUR,COMPLETED,59878.30
Transfer,Deposit,2024-12-13 11:26:55,2024-12-13 11:26:55,Savings Vault topup,2.50,0.00,EUR,COMPLETED,59880.80
Transfer,Deposit,2024-12-13 12:54:22,2024-12-13 12:54:22,Savings Vault topup,1.85,0.00,EUR,COMPLETED,59882.65
Transfer,Deposit,2024-12-13 15:28:19,2024-12-13 15:28:19,From Instant Access Savings,-200.00,0.00,EUR,COMPLETED,59682.65
Transfer,Deposit,2024-12-13 16:42:58,2024-12-13 16:42:58,Savings Vault topup,4.50,0.00,EUR,COMPLETED,59687.15
Transfer,Deposit,2024-12-13 16:43:41,2024-12-13 16:43:41,Savings Vault topup,4.00,0.00,EUR,COMPLETED,59691.15
Transfer,Deposit,2024-12-13 20:19:39,2024-12-13 20:19:39,Savings Vault topup,2.00,0.00,EUR,COMPLETED,59693.15
Transfer,Deposit,2024-12-13 22:30:24,2024-12-13 22:30:24,Savings Vault topup,5.00,0.00,EUR,COMPLETED,59698.15
Interest,Deposit,2024-12-14 01:00:00,2024-12-14 01:45:46,Interest earned - Instant Access Savings,3.39,1.12,EUR,COMPLETED,59700.42
Transfer,Deposit,2024-12-14 09:50:26,2024-12-14 09:50:26,From Instant Access Savings,-260.00,0.00,EUR,COMPLETED,59440.42
Transfer,Deposit,2024-12-14 09:52:22,2024-12-14 09:52:22,Savings Vault topup,5.00,0.00,EUR,COMPLETED,59445.42
Transfer,Deposit,2024-12-14 10:54:21,2024-12-14 10:54:21,Savings Vault topup,4.25,0.00,EUR,COMPLETED,59449.67
Transfer,Deposit,2024-12-14 11:18:08,2024-12-14 11:18:08,Savings Vault topup,4.50,0.00,EUR,COMPLETED,59454.17
Transfer,Deposit,2024-12-14 12:57:23,2024-12-14 12:57:23,Savings Vault topup,4.50,0.00,EUR,COMPLETED,59458.67
Transfer,Deposit,2024-12-14 13:04:19,2024-12-14 13:04:19,Savings Vault topup,2.50,0.00,EUR,COMPLETED,59461.17
Transfer,Deposit,2024-12-14 14:26:41,2024-12-14 14:26:41,Savings Vault topup,5.00,0.00,EUR,COMPLETED,59466.17
Transfer,Deposit,2024-12-14 16:17:47,2024-12-14 16:17:48,Savings Vault topup,3.00,0.00,EUR,COMPLETED,59469.17
Transfer,Deposit,2024-12-14 16:32:24,2024-12-14 16:32:24,Savings Vault topup,3.50,0.00,EUR,COMPLETED,59472.67
Transfer,Deposit,2024-12-14 17:06:13,2024-12-14 17:06:13,From Instant Access Savings,-200.00,0.00,EUR,COMPLETED,59272.67
Transfer,Deposit,2024-12-14 17:07:26,2024-12-14 17:07:26,Savings Vault topup,5.00,0.00,EUR,COMPLETED,59277.67
Transfer,Deposit,2024-12-14 17:19:01,2024-12-14 17:19:02,Savings Vault topup,1.10,0.00,EUR,COMPLETED,59278.77
Transfer,Deposit,2024-12-14 20:33:19,2024-12-14 20:33:19,Savings Vault topup,5.00,0.00,EUR,COMPLETED,59283.77
Interest,Deposit,2024-12-15 01:00:00,2024-12-15 01:44:49,Interest earned - Instant Access Savings,3.37,1.11,EUR,COMPLETED,59286.03
Transfer,Deposit,2024-12-15 10:32:19,2024-12-15 10:32:19,Savings Vault topup,4.25,0.00,EUR,COMPLETED,59290.28
Transfer,Deposit,2024-12-15 11:28:08,2024-12-15 11:28:08,Savings Vault topup,1.75,0.00,EUR,COMPLETED,59292.03
Transfer,Deposit,2024-12-15 11:41:27,2024-12-15 11:41:27,Savings Vault topup,0.50,0.00,EUR,COMPLETED,59292.53
Transfer,Deposit,2024-12-15 11:46:33,2024-12-15 11:46:33,From Instant Access Savings,-100.00,0.00,EUR,COMPLETED,59192.53
Transfer,Deposit,2024-12-15 11:49:40,2024-12-15 11:49:40,Savings Vault topup,2.50,0.00,EUR,COMPLETED,59195.03
Transfer,Deposit,2024-12-15 13:14:49,2024-12-15 13:14:49,Savings Vault topup,5.00,0.00,EUR,COMPLETED,59200.03
Transfer,Deposit,2024-12-15 14:11:17,2024-12-15 14:11:17,Savings Vault topup,5.00,0.00,EUR,COMPLETED,59205.03
Transfer,Deposit,2024-12-15 14:21:04,2024-12-15 14:21:04,From Instant Access Savings,-100.00,0.00,EUR,COMPLETED,59105.03
Transfer,Deposit,2024-12-15 14:21:30,2024-12-15 14:21:30,Savings Vault topup,5.00,0.00,EUR,COMPLETED,59110.03
Transfer,Deposit,2024-12-15 14:37:43,2024-12-15 14:37:43,Savings Vault topup,0.05,0.00,EUR,COMPLETED,59110.08
Transfer,Deposit,2024-12-15 14:57:07,2024-12-15 14:57:07,Savings Vault topup,2.50,0.00,EUR,COMPLETED,59112.58
Transfer,Deposit,2024-12-15 16:10:34,2024-12-15 16:10:34,From Instant Access Savings,-150.00,0.00,EUR,COMPLETED,58962.58
Transfer,Deposit,2024-12-15 16:11:06,2024-12-15 16:11:06,Savings Vault topup,5.00,0.00,EUR,COMPLETED,58967.58
Transfer,Deposit,2024-12-15 16:33:18,2024-12-15 16:33:18,Savings Vault topup,5.00,0.00,EUR,COMPLETED,58972.58
Transfer,Deposit,2024-12-15 20:12:57,2024-12-15 20:12:57,From Instant Access Savings,-100.00,0.00,EUR,COMPLETED,58872.58
Transfer,Deposit,2024-12-15 20:33:28,2024-12-15 20:33:28,Savings Vault topup,5.00,0.00,EUR,COMPLETED,58877.58
Interest,Deposit,2024-12-16 01:00:00,2024-12-16 01:11:47,Interest earned - Instant Access Savings,3.34,1.10,EUR,COMPLETED,58879.82
Transfer,Deposit,2024-12-16 09:05:32,2024-12-16 09:05:32,Savings Vault topup,4.50,0.00,EUR,COMPLETED,58884.32
Transfer,Deposit,2024-12-16 09:28:33,2024-12-16 09:28:33,Savings Vault topup,1.00,0.00,EUR,COMPLETED,58885.32
Transfer,Deposit,2024-12-16 11:12:56,2024-12-16 11:12:56,Savings Vault topup,1.50,0.00,EUR,COMPLETED,58886.82
Transfer,Deposit,2024-12-16 15:05:30,2024-12-16 15:05:30,Savings Vault topup,2.50,0.00,EUR,COMPLETED,58889.32
Transfer,Deposit,2024-12-16 15:37:39,2024-12-16 15:37:39,Savings Vault topup,0.75,0.00,EUR,COMPLETED,58890.07
Transfer,Deposit,2024-12-16 20:50:32,2024-12-16 20:50:32,Savings Vault topup,5.00,0.00,EUR,COMPLETED,58895.07
Interest,Deposit,2024-12-17 01:00:00,2024-12-17 01:13:45,Interest earned - Instant Access Savings,3.35,1.11,EUR,COMPLETED,58897.31
Interest,Deposit,2024-12-18 01:00:00,2024-12-18 01:11:42,Interest earned - Instant Access Savings,3.35,1.10,EUR,COMPLETED,58899.56
Transfer,Deposit,2024-12-18 14:38:37,2024-12-18 14:38:38,Savings Vault topup,5.00,0.00,EUR,COMPLETED,58904.56
Transfer,Deposit,2024-12-18 16:51:53,2024-12-18 16:51:53,Savings Vault topup,5.00,0.00,EUR,COMPLETED,58909.56
Transfer,Deposit,2024-12-18 17:20:07,2024-12-18 17:20:07,From Instant Access Savings,-100.00,0.00,EUR,COMPLETED,58809.56
Transfer,Deposit,2024-12-18 17:21:04,2024-12-18 17:21:04,Savings Vault topup,5.00,0.00,EUR,COMPLETED,58814.56
Transfer,Deposit,2024-12-18 18:30:42,2024-12-18 18:30:42,Savings Vault topup,4.85,0.00,EUR,COMPLETED,58819.41
Interest,Deposit,2024-12-19 01:00:00,2024-12-19 01:12:47,Interest earned - Instant Access Savings,3.34,1.10,EUR,COMPLETED,58821.65
Transfer,Deposit,2024-12-19 08:24:36,2024-12-19 08:24:36,Savings Vault topup,2.50,0.00,EUR,COMPLETED,58824.15
Transfer,Deposit,2024-12-19 13:14:32,2024-12-19 13:14:32,From Instant Access Savings,-100.00,0.00,EUR,COMPLETED,58724.15
Transfer,Deposit,2024-12-19 13:35:47,2024-12-19 13:35:47,Savings Vault topup,0.05,0.00,EUR,COMPLETED,58724.20
Transfer,Deposit,2024-12-19 16:31:33,2024-12-19 16:31:33,Savings Vault topup,5.00,0.00,EUR,COMPLETED,58729.20
Transfer,Deposit,2024-12-19 18:46:03,2024-12-19 18:46:03,Savings Vault topup,3.65,0.00,EUR,COMPLETED,58732.85
Transfer,Deposit,2024-12-19 21:34:30,2024-12-19 21:34:30,Savings Vault topup,0.80,0.00,EUR,COMPLETED,58733.65
Interest,Deposit,2024-12-20 01:00:00,2024-12-20 01:09:29,Interest earned - Instant Access Savings,3.34,1.11,EUR,COMPLETED,58735.88
Transfer,Deposit,2024-12-20 10:16:26,2024-12-20 10:16:26,From Instant Access Savings,-1000.00,0.00,EUR,COMPLETED,57735.88
Transfer,Deposit,2024-12-20 11:27:54,2024-12-20 11:27:54,Savings Vault topup,5.00,0.00,EUR,COMPLETED,57740.88
Transfer,Deposit,2024-12-20 12:03:06,2024-12-20 12:03:07,Savings Vault topup,2.50,0.00,EUR,COMPLETED,57743.38
Transfer,Deposit,2024-12-20 12:32:19,2024-12-20 12:32:19,Savings Vault topup,0.50,0.00,EUR,COMPLETED,57743.88
Transfer,Deposit,2024-12-20 15:08:58,2024-12-20 15:08:58,Savings Vault topup,2.10,0.00,EUR,COMPLETED,57745.98
Transfer,Deposit,2024-12-20 15:16:48,2024-12-20 15:16:48,Savings Vault topup,3.00,0.00,EUR,COMPLETED,57748.98
Transfer,Deposit,2024-12-20 17:39:47,2024-12-20 17:39:47,Savings Vault topup,0.10,0.00,EUR,COMPLETED,57749.08
Transfer,Deposit,2024-12-20 19:02:44,2024-12-20 19:02:44,Savings Vault topup,2.55,0.00,EUR,COMPLETED,57751.63
Transfer,Deposit,2024-12-20 19:45:53,2024-12-20 19:45:53,Savings Vault topup,3.30,0.00,EUR,COMPLETED,57754.93
Transfer,Deposit,2024-12-20 19:52:21,2024-12-20 19:52:22,Savings Vault topup,0.45,0.00,EUR,COMPLETED,57755.38
Interest,Deposit,2024-12-21 01:00:00,2024-12-21 01:09:59,Interest earned - Instant Access Savings,3.28,1.08,EUR,COMPLETED,57757.58
Exchange,Deposit,2024-12-21 05:28:28,2024-12-21 05:28:28,Exchanged to EUR,0.65,0.01,EUR,COMPLETED,57758.22
Exchange,Deposit,2024-12-21 06:38:34,2024-12-21 06:38:34,Exchanged to EUR,1.30,0.01,EUR,COMPLETED,57759.51
Exchange,Deposit,2024-12-21 08:17:38,2024-12-21 08:17:38,Exchanged to EUR,1.29,0.01,EUR,COMPLETED,57760.79
Exchange,Deposit,2024-12-21 12:00:57,2024-12-21 12:00:57,Exchanged to EUR,0.06,0.00,EUR,COMPLETED,57760.85
Exchange,Deposit,2024-12-21 13:22:28,2024-12-21 13:22:28,Exchanged to EUR,1.09,0.01,EUR,COMPLETED,57761.93
Exchange,Deposit,2024-12-21 14:00:02,2024-12-21 14:00:02,Exchanged to EUR,1.30,0.01,EUR,COMPLETED,57763.22
Exchange,Deposit,2024-12-21 15:43:54,2024-12-21 15:43:54,Exchanged to EUR,1.30,0.01,EUR,COMPLETED,57764.51
Exchange,Deposit,2024-12-21 15:58:08,2024-12-21 15:58:08,Exchanged to EUR,1.30,0.01,EUR,COMPLETED,57765.80
Exchange,Deposit,2024-12-21 17:05:27,2024-12-21 17:05:27,Exchanged to EUR,1.30,0.01,EUR,COMPLETED,57767.09
Interest,Deposit,2024-12-22 01:00:00,2024-12-22 01:09:50,Interest earned - Instant Access Savings,3.28,1.08,EUR,COMPLETED,57769.29
Exchange,Deposit,2024-12-22 06:42:57,2024-12-22 06:42:57,Exchanged to EUR,1.30,0.01,EUR,COMPLETED,57770.58
Transfer,Deposit,2024-12-22 10:55:26,2024-12-22 10:55:26,Savings Vault topup,0.05,0.00,EUR,COMPLETED,57770.63
Exchange,Deposit,2024-12-22 12:57:40,2024-12-22 12:57:40,Exchanged to EUR,0.65,0.01,EUR,COMPLETED,57771.27
Exchange,Deposit,2024-12-22 14:20:56,2024-12-22 14:20:56,Exchanged to EUR,1.30,0.01,EUR,COMPLETED,57772.56
Interest,Deposit,2024-12-23 01:00:00,2024-12-23 01:11:29,Interest earned - Instant Access Savings,3.29,1.09,EUR,COMPLETED,57774.76
Exchange,Deposit,2024-12-23 03:55:47,2024-12-23 03:55:47,Exchanged to EUR,1.29,0.00,EUR,COMPLETED,57776.05
Exchange,Deposit,2024-12-23 03:58:35,2024-12-23 03:58:35,Exchanged to EUR,1.29,0.00,EUR,COMPLETED,57777.34
Exchange,Deposit,2024-12-23 05:16:57,2024-12-23 05:16:57,Exchanged to EUR,1.29,0.00,EUR,COMPLETED,57778.63
Exchange,Deposit,2024-12-23 06:30:47,2024-12-23 06:30:47,Exchanged to EUR,1.30,0.00,EUR,COMPLETED,57779.93
Exchange,Deposit,2024-12-23 11:26:48,2024-12-23 11:26:48,Exchanged to EUR,1.30,0.00,EUR,COMPLETED,57781.23
Exchange,Deposit,2024-12-23 14:36:55,2024-12-23 14:36:56,Exchanged to EUR,1.30,0.00,EUR,COMPLETED,57782.53
Interest,Deposit,2024-12-24 01:00:00,2024-12-24 01:12:49,Interest earned - Instant Access Savings,3.28,1.08,EUR,COMPLETED,57784.73
Exchange,Deposit,2024-12-24 04:56:55,2024-12-24 04:56:55,Exchanged to EUR,1.30,0.00,EUR,COMPLETED,57786.03
Exchange,Deposit,2024-12-24 06:46:38,2024-12-24 06:46:38,Exchanged to EUR,0.87,0.00,EUR,COMPLETED,57786.90
Exchange,Deposit,2024-12-24 07:04:34,2024-12-24 07:04:34,Exchanged to EUR,1.08,0.00,EUR,COMPLETED,57787.98
Exchange,Deposit,2024-12-24 07:48:03,2024-12-24 07:48:03,Exchanged to EUR,1.30,0.00,EUR,COMPLETED,57789.28
Exchange,Deposit,2024-12-24 08:25:27,2024-12-24 08:25:27,Exchanged to EUR,1.30,0.00,EUR,COMPLETED,57790.58
Exchange,Deposit,2024-12-24 09:01:50,2024-12-24 09:01:50,Exchanged to EUR,1.30,0.00,EUR,COMPLETED,57791.88
Exchange,Deposit,2024-12-24 09:40:39,2024-12-24 09:40:39,Exchanged to EUR,1.30,0.00,EUR,COMPLETED,57793.18
Exchange,Deposit,2024-12-24 10:16:30,2024-12-24 10:16:30,Exchanged to EUR,1.30,0.00,EUR,COMPLETED,57794.48
Exchange,Deposit,2024-12-24 17:41:07,2024-12-24 17:41:07,Exchanged to EUR,1.14,0.00,EUR,COMPLETED,57795.62
Exchange,Deposit,2024-12-24 17:47:21,2024-12-24 17:47:22,Exchanged to EUR,1.30,0.00,EUR,COMPLETED,57796.92
Transfer,Deposit,2024-12-24 18:55:39,2024-12-24 18:55:39,Savings Vault topup,2.50,0.00,EUR,COMPLETED,57799.42
Interest,Deposit,2024-12-25 01:00:00,2024-12-25 01:11:32,Interest earned - Instant Access Savings,3.29,1.08,EUR,COMPLETED,57801.63
Exchange,Deposit,2024-12-25 05:17:55,2024-12-25 05:17:55,Exchanged to EUR,1.30,0.00,EUR,COMPLETED,57802.93
Exchange,Deposit,2024-12-25 05:57:22,2024-12-25 05:57:22,Exchanged to EUR,0.65,0.00,EUR,COMPLETED,57803.58
Transfer,Deposit,2024-12-25 07:26:43,2024-12-25 07:26:43,From Instant Access Savings,-1000.00,0.00,EUR,COMPLETED,56803.58
Exchange,Deposit,2024-12-25 08:17:12,2024-12-25 08:17:12,Exchanged to EUR,1.30,0.00,EUR,COMPLETED,56804.88
Exchange,Deposit,2024-12-25 09:05:10,2024-12-25 09:05:10,Exchanged to EUR,1.30,0.00,EUR,COMPLETED,56806.18
Exchange,Deposit,2024-12-25 09:33:53,2024-12-25 09:33:53,Exchanged to EUR,1.30,0.00,EUR,COMPLETED,56807.48
Exchange,Deposit,2024-12-25 11:11:28,2024-12-25 11:11:28,Exchanged to EUR,0.39,0.00,EUR,COMPLETED,56807.87
Exchange,Deposit,2024-12-25 11:41:43,2024-12-25 11:41:43,Exchanged to EUR,1.30,0.00,EUR,COMPLETED,56809.17
Exchange,Deposit,2024-12-25 16:34:47,2024-12-25 16:34:47,Exchanged to EUR,1.30,0.00,EUR,COMPLETED,56810.47
Exchange,Deposit,2024-12-25 16:46:57,2024-12-25 16:46:57,Exchanged to EUR,1.11,0.00,EUR,COMPLETED,56811.58
Exchange,Deposit,2024-12-25 17:19:17,2024-12-25 17:19:17,Exchanged to EUR,0.32,0.00,EUR,COMPLETED,56811.90
Interest,Deposit,2024-12-26 01:00:00,2024-12-26 01:09:04,Interest earned - Instant Access Savings,3.22,1.07,EUR,COMPLETED,56814.05
Exchange,Deposit,2024-12-26 04:48:25,2024-12-26 04:48:25,Exchanged to EUR,1.30,0.00,EUR,COMPLETED,56815.35
Transfer,Deposit,2024-12-26 08:55:57,2024-12-26 08:55:58,From Instant Access Savings,-250.00,0.00,EUR,COMPLETED,56565.35
Exchange,Deposit,2024-12-26 08:59:04,2024-12-26 08:59:04,Exchanged to EUR,1.30,0.00,EUR,COMPLETED,56566.65
Transfer,Deposit,2024-12-26 13:20:51,2024-12-26 13:20:51,Savings Vault topup,5.00,0.00,EUR,COMPLETED,56571.65
Transfer,Deposit,2024-12-26 13:36:19,2024-12-26 13:36:19,From Instant Access Savings,-200.00,0.00,EUR,COMPLETED,56371.65
Interest,Deposit,2024-12-27 01:00:00,2024-12-27 01:10:51,Interest earned - Instant Access Savings,3.21,1.06,EUR,COMPLETED,56373.80
Exchange,Deposit,2024-12-27 05:42:44,2024-12-27 05:42:44,Exchanged to EUR,1.30,0.00,EUR,COMPLETED,56375.10
Exchange,Deposit,2024-12-27 16:02:13,2024-12-27 16:02:13,Exchanged to EUR,1.30,0.00,EUR,COMPLETED,56376.40
Interest,Deposit,2024-12-28 01:00:00,2024-12-28 01:10:54,Interest earned - Instant Access Savings,3.20,1.05,EUR,COMPLETED,56378.55
Interest,Deposit,2024-12-29 01:00:00,2024-12-29 01:10:33,Interest earned - Instant Access Savings,3.21,1.06,EUR,COMPLETED,56380.70
Transfer,Deposit,2024-12-29 09:22:41,2024-12-29 09:22:41,Savings Vault topup,2.50,0.00,EUR,COMPLETED,56383.20
Transfer,Deposit,2024-12-29 14:45:19,2024-12-29 14:45:19,Savings Vault topup,1.80,0.00,EUR,COMPLETED,56385.00
Interest,Deposit,2024-12-30 01:00:00,2024-12-30 01:11:11,Interest earned - Instant Access Savings,3.20,1.06,EUR,COMPLETED,56387.14
Exchange,Deposit,2024-12-30 02:01:54,2024-12-30 02:01:55,Exchanged to EUR,0.67,0.00,EUR,COMPLETED,56387.81
Transfer,Deposit,2024-12-30 14:57:19,2024-12-30 14:57:19,Savings Vault topup,5.00,0.00,EUR,COMPLETED,56392.81
Transfer,Deposit,2024-12-30 15:07:26,2024-12-30 15:07:26,From Instant Access Savings,-200.00,0.00,EUR,COMPLETED,56192.81
Transfer,Deposit,2024-12-30 15:07:33,2024-12-30 15:07:33,Savings Vault topup,1.75,0.00,EUR,COMPLETED,56194.56
Transfer,Deposit,2024-12-30 16:23:16,2024-12-30 16:23:16,Savings Vault topup,0.05,0.00,EUR,COMPLETED,56194.61
Interest,Deposit,2024-12-31 01:00:00,2024-12-31 01:12:33,Interest earned - Instant Access Savings,3.19,1.05,EUR,COMPLETED,56196.75
Transfer,Deposit,2024-12-31 15:17:26,2024-12-31 15:17:26,From Instant Access Savings,-100.00,0.00,EUR,COMPLETED,56096.75
Transfer,Deposit,2024-12-31 15:17:35,2024-12-31 15:17:35,Savings Vault topup,0.70,0.00,EUR,COMPLETED,56097.45
Transfer,Deposit,2024-12-31 16:50:25,2024-12-31 16:50:25,From Instant Access Savings,-100.00,0.00,EUR,COMPLETED,55997.45
Transfer,Deposit,2024-12-31 16:51:20,2024-12-31 16:51:20,Savings Vault topup,3.75,0.00,EUR,COMPLETED,56001.20
Transfer,Deposit,2024-12-31 17:34:25,2024-12-31 17:34:25,Savings Vault topup,5.00,0.00,EUR,COMPLETED,56006.20
Transfer,Deposit,2024-12-31 18:17:02,2024-12-31 18:17:02,Savings Vault topup,1.10,0.00,EUR,COMPLETED,56007.30
Interest,Deposit,2025-01-01 01:00:00,2025-01-01 01:11:28,Interest earned - Instant Access Savings,3.19,1.05,EUR,COMPLETED,56009.44
Transfer,Deposit,2025-01-01 07:17:11,2025-01-01 07:17:11,Savings Vault topup,2.55,0.00,EUR,COMPLETED,56011.99
Transfer,Deposit,2025-01-01 15:21:19,2025-01-01 15:21:19,Savings Vault topup,4.25,0.00,EUR,COMPLETED,56016.24
Transfer,Deposit,2025-01-01 17:14:02,2025-01-01 17:14:02,Savings Vault topup,0.80,0.00,EUR,COMPLETED,56017.04
Interest,Deposit,2025-01-02 01:00:00,2025-01-02 01:11:32,Interest earned - Instant Access Savings,3.19,1.05,EUR,COMPLETED,56019.18
Transfer,Deposit,2025-01-02 11:47:53,2025-01-02 11:47:54,Savings Vault topup,0.55,0.00,EUR,COMPLETED,56019.73
Transfer,Deposit,2025-01-02 19:25:24,2025-01-02 19:25:24,From Instant Access Savings,-100.00,0.00,EUR,COMPLETED,55919.73
Transfer,Deposit,2025-01-02 19:26:17,2025-01-02 19:26:17,Savings Vault topup,2.55,0.00,EUR,COMPLETED,55922.28
Transfer,Deposit,2025-01-02 19:40:24,2025-01-02 19:40:24,Savings Vault topup,0.50,0.00,EUR,COMPLETED,55922.78
Interest,Deposit,2025-01-03 01:00:00,2025-01-03 01:13:11,Interest earned - Instant Access Savings,3.19,1.05,EUR,COMPLETED,55924.92
Transfer,Deposit,2025-01-03 18:07:51,2025-01-03 18:07:51,Savings Vault topup,3.60,0.00,EUR,COMPLETED,55928.52
Interest,Deposit,2025-01-04 01:00:00,2025-01-04 01:13:17,Interest earned - Instant Access Savings,3.18,1.05,EUR,COMPLETED,55930.65
Transfer,Deposit,2025-01-04 02:53:32,2025-01-04 02:53:33,Savings Vault topup,0.05,0.00,EUR,COMPLETED,55930.70
Transfer,Deposit,2025-01-04 10:21:24,2025-01-04 10:21:24,Savings Vault topup,0.05,0.00,EUR,COMPLETED,55930.75
Transfer,Deposit,2025-01-04 18:14:27,2025-01-04 18:14:27,From Instant Access Savings,-100.00,0.00,EUR,COMPLETED,55830.75
Transfer,Deposit,2025-01-04 18:15:42,2025-01-04 18:15:42,Savings Vault topup,0.50,0.00,EUR,COMPLETED,55831.25
Transfer,Deposit,2025-01-04 18:51:43,2025-01-04 18:51:43,Savings Vault topup,1.50,0.00,EUR,COMPLETED,55832.75
Interest,Deposit,2025-01-05 01:00:00,2025-01-05 01:11:44,Interest earned - Instant Access Savings,3.18,1.05,EUR,COMPLETED,55834.88
Transfer,Deposit,2025-01-05 12:25:14,2025-01-05 12:25:14,Savings Vault topup,5.00,0.00,EUR,COMPLETED,55839.88
Transfer,Deposit,2025-01-05 12:57:23,2025-01-05 12:57:23,Savings Vault topup,0.20,0.00,EUR,COMPLETED,55840.08
Transfer,Deposit,2025-01-05 13:08:02,2025-01-05 13:08:02,Savings Vault topup,3.50,0.00,EUR,COMPLETED,55843.58
Transfer,Deposit,2025-01-05 14:39:35,2025-01-05 14:39:35,Savings Vault topup,4.00,0.00,EUR,COMPLETED,55847.58
Transfer,Deposit,2025-01-05 17:37:37,2025-01-05 17:37:37,Savings Vault topup,5.00,0.00,EUR,COMPLETED,55852.58
Interest,Deposit,2025-01-06 01:00:00,2025-01-06 01:12:54,Interest earned - Instant Access Savings,3.19,1.05,EUR,COMPLETED,55854.72
Transfer,Deposit,2025-01-06 15:01:33,2025-01-06 15:01:33,From Instant Access Savings,-500.00,0.00,EUR,COMPLETED,55354.72
Transfer,Deposit,2025-01-06 15:03:52,2025-01-06 15:03:52,Savings Vault topup,2.50,0.00,EUR,COMPLETED,55357.22
Interest,Deposit,2025-01-07 01:00:00,2025-01-07 01:11:42,Interest earned - Instant Access Savings,3.15,1.04,EUR,COMPLETED,55359.33
Interest,Deposit,2025-01-08 01:00:00,2025-01-08 01:11:33,Interest earned - Instant Access Savings,3.16,1.05,EUR,COMPLETED,55361.44
Transfer,Deposit,2025-01-08 07:56:37,2025-01-08 07:56:37,Savings Vault topup,4.60,0.00,EUR,COMPLETED,55366.04
Interest,Deposit,2025-01-09 01:00:00,2025-01-09 01:13:32,Interest earned - Instant Access Savings,3.15,1.04,EUR,COMPLETED,55368.15
Transfer,Deposit,2025-01-09 14:14:19,2025-01-09 14:14:19,Savings Vault topup,0.20,0.00,EUR,COMPLETED,55368.35
Interest,Deposit,2025-01-10 01:00:00,2025-01-10 01:14:03,Interest earned - Instant Access Savings,3.16,1.04,EUR,COMPLETED,55370.47
Transfer,Deposit,2025-01-10 18:55:16,2025-01-10 18:55:16,Savings Vault topup,5.00,0.00,EUR,COMPLETED,55375.47
Interest,Deposit,2025-01-11 01:00:00,2025-01-11 01:14:56,Interest earned - Instant Access Savings,3.15,1.04,EUR,COMPLETED,55377.58
Transfer,Deposit,2025-01-11 10:34:15,2025-01-11 10:34:15,Savings Vault topup,0.50,0.00,EUR,COMPLETED,55378.08
Transfer,Deposit,2025-01-11 13:44:44,2025-01-11 13:44:44,Savings Vault topup,5.00,0.00,EUR,COMPLETED,55383.08
Transfer,Deposit,2025-01-11 13:47:47,2025-01-11 13:47:47,Savings Vault topup,2.50,0.00,EUR,COMPLETED,55385.58
Transfer,Deposit,2025-01-11 13:51:34,2025-01-11 13:51:34,Savings Vault topup,5.00,0.00,EUR,COMPLETED,55390.58
Transfer,Deposit,2025-01-11 15:29:10,2025-01-11 15:29:10,Savings Vault topup,3.50,0.00,EUR,COMPLETED,55394.08
Transfer,Deposit,2025-01-11 16:11:49,2025-01-11 16:11:49,From Instant Access Savings,-140.00,0.00,EUR,COMPLETED,55254.08
Transfer,Deposit,2025-01-11 16:15:22,2025-01-11 16:15:22,Savings Vault topup,0.10,0.00,EUR,COMPLETED,55254.18
Transfer,Deposit,2025-01-11 16:27:34,2025-01-11 16:27:34,Savings Vault topup,5.00,0.00,EUR,COMPLETED,55259.18
Interest,Deposit,2025-01-12 01:00:00,2025-01-12 01:11:47,Interest earned - Instant Access Savings,3.15,1.04,EUR,COMPLETED,55261.29
Interest,Deposit,2025-01-13 01:00:00,2025-01-13 01:12:09,Interest earned - Instant Access Savings,3.15,1.04,EUR,COMPLETED,55263.40
Interest,Deposit,2025-01-14 01:00:00,2025-01-14 01:12:15,Interest earned - Instant Access Savings,3.15,1.04,EUR,COMPLETED,55265.51
Transfer,Deposit,2025-01-14 21:07:37,2025-01-14 21:07:37,Savings Vault topup,4.35,0.00,EUR,COMPLETED,55269.86
Transfer,Deposit,2025-01-14 22:49:14,2025-01-14 22:49:14,Savings Vault topup,2.70,0.00,EUR,COMPLETED,55272.56
Interest,Deposit,2025-01-15 01:00:00,2025-01-15 01:12:35,Interest earned - Instant Access Savings,3.15,1.04,EUR,COMPLETED,55274.67
Transfer,Deposit,2025-01-15 20:01:21,2025-01-15 20:01:21,From Instant Access Savings,-100.00,0.00,EUR,COMPLETED,55174.67
Transfer,Deposit,2025-01-15 20:01:58,2025-01-15 20:01:58,Savings Vault topup,1.90,0.00,EUR,COMPLETED,55176.57
Interest,Deposit,2025-01-16 01:00:00,2025-01-16 01:14:37,Interest earned - Instant Access Savings,3.14,1.03,EUR,COMPLETED,55178.68
Transfer,Deposit,2025-01-16 08:34:12,2025-01-16 08:34:12,Savings Vault topup,3.30,0.00,EUR,COMPLETED,55181.98
Transfer,Deposit,2025-01-16 18:38:52,2025-01-16 18:38:52,Savings Vault topup,4.00,0.00,EUR,COMPLETED,55185.98
Interest,Deposit,2025-01-17 01:00:00,2025-01-17 01:13:04,Interest earned - Instant Access Savings,3.15,1.04,EUR,COMPLETED,55188.09
Transfer,Deposit,2025-01-17 17:40:14,2025-01-17 17:40:14,From Instant Access Savings,-150.00,0.00,EUR,COMPLETED,55038.09
Transfer,Deposit,2025-01-17 19:02:12,2025-01-17 19:02:13,Savings Vault topup,0.50,0.00,EUR,COMPLETED,55038.59
Interest,Deposit,2025-01-18 01:00:00,2025-01-18 01:13:45,Interest earned - Instant Access Savings,3.14,1.04,EUR,COMPLETED,55040.69
Transfer,Deposit,2025-01-18 17:13:23,2025-01-18 17:13:23,Savings Vault topup,5.00,0.00,EUR,COMPLETED,55045.69
Transfer,Deposit,2025-01-18 18:00:19,2025-01-18 18:00:19,Savings Vault topup,2.50,0.00,EUR,COMPLETED,55048.19
Transfer,Deposit,2025-01-18 20:31:51,2025-01-18 20:31:51,Savings Vault topup,4.00,0.00,EUR,COMPLETED,55052.19
Interest,Deposit,2025-01-19 01:00:00,2025-01-19 01:14:27,Interest earned - Instant Access Savings,3.13,1.03,EUR,COMPLETED,55054.29
Transfer,Deposit,2025-01-19 10:55:18,2025-01-19 10:55:18,Savings Vault topup,0.05,0.00,EUR,COMPLETED,55054.34
Transfer,Deposit,2025-01-19 13:58:35,2025-01-19 13:58:35,From Instant Access Savings,-650.00,0.00,EUR,COMPLETED,54404.34
Transfer,Deposit,2025-01-19 13:59:04,2025-01-19 13:59:04,Savings Vault topup,1.70,0.00,EUR,COMPLETED,54406.04
Transfer,Deposit,2025-01-19 17:28:10,2025-01-19 17:28:10,Savings Vault topup,0.15,0.00,EUR,COMPLETED,54406.19
Transfer,Deposit,2025-01-19 17:40:07,2025-01-19 17:40:07,Savings Vault topup,3.25,0.00,EUR,COMPLETED,54409.44
Transfer,Deposit,2025-01-19 18:51:33,2025-01-19 18:51:33,Savings Vault topup,0.65,0.00,EUR,COMPLETED,54410.09
Transfer,Deposit,2025-01-19 22:24:24,2025-01-19 22:24:24,Savings Vault topup,2.00,0.00,EUR,COMPLETED,54412.09
Interest,Deposit,2025-01-20 01:00:00,2025-01-20 01:13:33,Interest earned - Instant Access Savings,3.10,1.02,EUR,COMPLETED,54414.17
Interest,Deposit,2025-01-21 01:00:00,2025-01-21 01:12:12,Interest earned - Instant Access Savings,3.10,1.03,EUR,COMPLETED,54416.24
Transfer,Deposit,2025-01-21 08:35:37,2025-01-21 08:35:37,Savings Vault topup,3.70,0.00,EUR,COMPLETED,54419.94
Transfer,Deposit,2025-01-21 16:19:31,2025-01-21 16:19:31,From Instant Access Savings,-400.00,0.00,EUR,COMPLETED,54019.94
Transfer,Deposit,2025-01-21 16:19:47,2025-01-21 16:19:47,Savings Vault topup,1.50,0.00,EUR,COMPLETED,54021.44
Interest,Deposit,2025-01-22 01:00:00,2025-01-22 01:11:47,Interest earned - Instant Access Savings,3.08,1.01,EUR,COMPLETED,54023.51
Transfer,Deposit,2025-01-22 16:32:24,2025-01-22 16:32:24,From Instant Access Savings,-500.00,0.00,EUR,COMPLETED,53523.51
Interest,Deposit,2025-01-23 01:00:00,2025-01-23 01:12:04,Interest earned - Instant Access Savings,3.05,1.01,EUR,COMPLETED,53525.55
Transfer,Deposit,2025-01-23 09:10:28,2025-01-23 09:10:28,Savings Vault topup,0.50,0.00,EUR,COMPLETED,53526.05
Transfer,Deposit,2025-01-23 17:22:15,2025-01-23 17:22:15,Savings Vault topup,3.25,0.00,EUR,COMPLETED,53529.30
Interest,Deposit,2025-01-24 01:00:00,2025-01-24 01:14:49,Interest earned - Instant Access Savings,3.05,1.01,EUR,COMPLETED,53531.34
Transfer,Deposit,2025-01-24 06:27:18,2025-01-24 06:27:18,To Instant Access Savings,275.00,0.00,EUR,COMPLETED,53806.34
Transfer,Deposit,2025-01-24 09:20:56,2025-01-24 09:20:56,Savings Vault topup,1000.00,0.00,EUR,COMPLETED,54806.34
Transfer,Deposit,2025-01-24 11:18:21,2025-01-24 11:18:21,Savings Vault topup,3.25,0.00,EUR,COMPLETED,54809.59
Transfer,Deposit,2025-01-24 11:56:46,2025-01-24 11:56:46,Savings Vault topup,2.55,0.00,EUR,COMPLETED,54812.14
Transfer,Deposit,2025-01-24 12:56:53,2025-01-24 12:56:53,Savings Vault topup,550.00,0.00,EUR,COMPLETED,55362.14
Transfer,Deposit,2025-01-24 16:33:12,2025-01-24 16:33:12,Savings Vault topup,2.15,0.00,EUR,COMPLETED,55364.29
Transfer,Deposit,2025-01-24 18:33:21,2025-01-24 18:33:21,From Instant Access Savings,-364.00,0.00,EUR,COMPLETED,55000.29
Transfer,Deposit,2025-01-24 18:53:41,2025-01-24 18:53:41,Savings Vault topup,3.30,0.00,EUR,COMPLETED,55003.59
Interest,Deposit,2025-01-25 01:00:00,2025-01-25 01:14:33,Interest earned - Instant Access Savings,3.14,1.03,EUR,COMPLETED,55005.70
Transfer,Deposit,2025-01-25 08:56:38,2025-01-25 08:56:38,From Instant Access Savings,-500.00,0.00,EUR,COMPLETED,54505.70
Transfer,Deposit,2025-01-25 16:57:33,2025-01-25 16:57:33,Savings Vault topup,1.50,0.00,EUR,COMPLETED,54507.20
Interest,Deposit,2025-01-26 01:00:00,2025-01-26 01:13:25,Interest earned - Instant Access Savings,3.10,1.03,EUR,COMPLETED,54509.27
Transfer,Deposit,2025-01-26 09:10:02,2025-01-26 09:10:02,Savings Vault topup,0.05,0.00,EUR,COMPLETED,54509.32
Transfer,Deposit,2025-01-26 10:54:53,2025-01-26 10:54:53,Savings Vault topup,21764.00,0.00,EUR,COMPLETED,76273.32
Transfer,Deposit,2025-01-26 13:22:58,2025-01-26 13:22:58,Savings Vault topup,5.00,0.00,EUR,COMPLETED,76278.32
Transfer,Deposit,2025-01-26 16:04:50,2025-01-26 16:04:50,Savings Vault topup,4.10,0.00,EUR,COMPLETED,76282.42
Interest,Deposit,2025-01-27 01:00:00,2025-01-27 01:12:39,Interest earned - Instant Access Savings,4.35,1.43,EUR,COMPLETED,76285.34
Transfer,Deposit,2025-01-27 14:44:47,2025-01-27 14:44:47,Savings Vault topup,5.00,0.00,EUR,COMPLETED,76290.34
Interest,Deposit,2025-01-28 01:00:00,2025-01-28 01:12:50,Interest earned - Instant Access Savings,4.35,1.44,EUR,COMPLETED,76293.25
Transfer,Deposit,2025-01-28 08:34:06,2025-01-28 08:34:06,Savings Vault topup,3.90,0.00,EUR,COMPLETED,76297.15
Transfer,Deposit,2025-01-28 13:31:27,2025-01-28 13:31:27,Savings Vault topup,0.25,0.00,EUR,COMPLETED,76297.40
Interest,Deposit,2025-01-29 01:00:00,2025-01-29 01:13:34,Interest earned - Instant Access Savings,4.35,1.43,EUR,COMPLETED,76300.32
Transfer,Deposit,2025-01-29 11:59:47,2025-01-29 11:59:47,Savings Vault topup,3.50,0.00,EUR,COMPLETED,76303.82
Transfer,Deposit,2025-01-29 13:55:49,2025-01-29 13:55:49,From Instant Access Savings,-185.00,0.00,EUR,COMPLETED,76118.82
Transfer,Deposit,2025-01-29 13:56:03,2025-01-29 13:56:03,Savings Vault topup,5.00,0.00,EUR,COMPLETED,76123.82
Transfer,Deposit,2025-01-29 14:59:54,2025-01-29 14:59:54,Savings Vault topup,4.25,0.00,EUR,COMPLETED,76128.07
Transfer,Deposit,2025-01-29 19:16:50,2025-01-29 19:16:50,From Instant Access Savings,-100.00,0.00,EUR,COMPLETED,76028.07
Interest,Deposit,2025-01-30 01:00:00,2025-01-30 01:13:54,Interest earned - Instant Access Savings,4.33,1.43,EUR,COMPLETED,76030.97
Transfer,Deposit,2025-01-30 02:05:04,2025-01-30 02:05:04,Savings Vault topup,5.00,0.00,EUR,COMPLETED,76035.97
Transfer,Deposit,2025-01-30 13:08:07,2025-01-30 13:08:08,From Instant Access Savings,-100.00,0.00,EUR,COMPLETED,75935.97
Transfer,Deposit,2025-01-30 13:08:14,2025-01-30 13:08:14,Savings Vault topup,1.00,0.00,EUR,COMPLETED,75936.97
Transfer,Deposit,2025-01-30 13:36:22,2025-01-30 13:36:22,From Instant Access Savings,-200.00,0.00,EUR,COMPLETED,75736.97
Transfer,Deposit,2025-01-30 13:36:27,2025-01-30 13:36:27,Savings Vault topup,0.10,0.00,EUR,COMPLETED,75737.07
Transfer,Deposit,2025-01-30 16:58:08,2025-01-30 16:58:09,Savings Vault topup,3.10,0.00,EUR,COMPLETED,75740.17
Transfer,Deposit,2025-01-30 17:18:32,2025-01-30 17:18:32,From Instant Access Savings,-2000.00,0.00,EUR,COMPLETED,73740.17
Transfer,Deposit,2025-01-30 17:18:49,2025-01-30 17:18:49,Savings Vault topup,1.00,0.00,EUR,COMPLETED,73741.17
Interest,Deposit,2025-01-31 01:00:00,2025-01-31 01:13:12,Interest earned - Instant Access Savings,4.20,1.39,EUR,COMPLETED,73743.98
Transfer,Deposit,2025-01-31 10:44:39,2025-01-31 10:44:40,Savings Vault topup,5.00,0.00,EUR,COMPLETED,73748.98
Transfer,Deposit,2025-01-31 11:04:35,2025-01-31 11:04:35,Savings Vault topup,2.00,0.00,EUR,COMPLETED,73750.98
Transfer,Deposit,2025-01-31 11:28:02,2025-01-31 11:28:02,Savings Vault topup,0.35,0.00,EUR,COMPLETED,73751.33
Transfer,Deposit,2025-01-31 11:39:17,2025-01-31 11:39:17,Savings Vault topup,3.15,0.00,EUR,COMPLETED,73754.48
Transfer,Deposit,2025-01-31 17:49:25,2025-01-31 17:49:25,To Instant Access Savings,1.05,0.00,EUR,COMPLETED,73755.53
Interest,Deposit,2025-02-01 01:00:00,2025-02-01 01:18:31,Interest earned - Instant Access Savings,4.20,1.38,EUR,COMPLETED,73758.35
Transfer,Deposit,2025-02-01 07:19:51,2025-02-01 07:19:51,To Instant Access Savings,2.55,0.00,EUR,COMPLETED,73760.90
Transfer,Deposit,2025-02-01 13:17:39,2025-02-01 13:17:39,To Instant Access Savings,1.45,0.00,EUR,COMPLETED,73762.35
Transfer,Deposit,2025-02-01 16:14:35,2025-02-01 16:14:35,To Instant Access Savings,2.65,0.00,EUR,COMPLETED,73765.00
Transfer,Deposit,2025-02-01 23:41:05,2025-02-01 23:41:05,To Instant Access Savings,2.45,0.00,EUR,COMPLETED,73767.45
Interest,Deposit,2025-02-02 01:00:00,2025-02-02 01:17:45,Interest earned - Instant Access Savings,4.21,1.39,EUR,COMPLETED,73770.27
Transfer,Deposit,2025-02-02 12:04:22,2025-02-02 12:04:22,To Instant Access Savings,1.05,0.00,EUR,COMPLETED,73771.32
Transfer,Deposit,2025-02-02 17:03:24,2025-02-02 17:03:24,To Instant Access Savings,1.25,0.00,EUR,COMPLETED,73772.57
Transfer,Deposit,2025-02-02 18:56:22,2025-02-02 18:56:22,To Instant Access Savings,1800.00,0.00,EUR,COMPLETED,75572.57
Interest,Deposit,2025-02-03 01:00:00,2025-02-03 01:11:52,Interest earned - Instant Access Savings,4.30,1.42,EUR,COMPLETED,75575.45
Interest,Deposit,2025-02-04 01:00:00,2025-02-04 01:13:47,Interest earned - Instant Access Savings,4.31,1.42,EUR,COMPLETED,75578.34
Interest,Deposit,2025-02-05 01:00:00,2025-02-05 01:13:49,Interest earned - Instant Access Savings,4.31,1.43,EUR,COMPLETED,75581.22
Transfer,Deposit,2025-02-05 14:15:11,2025-02-05 14:15:11,To Instant Access Savings,2.75,0.00,EUR,COMPLETED,75583.97
Transfer,Deposit,2025-02-05 16:28:15,2025-02-05 16:28:15,To Instant Access Savings,2.50,0.00,EUR,COMPLETED,75586.47
Transfer,Deposit,2025-02-05 17:36:30,2025-02-05 17:36:30,To Instant Access Savings,2.50,0.00,EUR,COMPLETED,75588.97
Transfer,Deposit,2025-02-05 18:22:25,2025-02-05 18:22:25,To Instant Access Savings,2.55,0.00,EUR,COMPLETED,75591.52
Interest,Deposit,2025-02-06 01:00:00,2025-02-06 01:14:43,Interest earned - Instant Access Savings,4.31,1.42,EUR,COMPLETED,75594.41
Transfer,Deposit,2025-02-06 13:18:42,2025-02-06 13:18:42,From Instant Access Savings,-100.00,0.00,EUR,COMPLETED,75494.41
Transfer,Deposit,2025-02-06 13:27:31,2025-02-06 13:27:31,To Instant Access Savings,3.75,0.00,EUR,COMPLETED,75498.16
Transfer,Deposit,2025-02-06 17:08:19,2025-02-06 17:08:19,To Instant Access Savings,15000.00,0.00,EUR,COMPLETED,90498.16
Transfer,Deposit,2025-02-06 19:32:15,2025-02-06 19:32:15,To Instant Access Savings,5.00,0.00,EUR,COMPLETED,90503.16
Interest,Deposit,2025-02-07 01:00:00,2025-02-07 01:15:25,Interest earned - Instant Access Savings,5.15,1.70,EUR,COMPLETED,90506.61
Transfer,Deposit,2025-02-07 14:00:25,2025-02-07 14:00:25,To Instant Access Savings,1.30,0.00,EUR,COMPLETED,90507.91
Transfer,Deposit,2025-02-07 14:17:27,2025-02-07 14:17:27,To Instant Access Savings,1.50,0.00,EUR,COMPLETED,90509.41
Interest,Deposit,2025-02-08 01:00:00,2025-02-08 01:20:34,Interest earned - Instant Access Savings,5.16,1.70,EUR,COMPLETED,90512.87
Transfer,Deposit,2025-02-08 09:28:56,2025-02-08 09:28:56,To Instant Access Savings,5.00,0.00,EUR,COMPLETED,90517.87
Transfer,Deposit,2025-02-08 12:16:57,2025-02-08 12:16:57,To Instant Access Savings,5.00,0.00,EUR,COMPLETED,90522.87
Transfer,Deposit,2025-02-08 13:05:57,2025-02-08 13:05:57,From Instant Access Savings,-100.00,0.00,EUR,COMPLETED,90422.87
Transfer,Deposit,2025-02-08 13:06:15,2025-02-08 13:06:15,To Instant Access Savings,0.05,0.00,EUR,COMPLETED,90422.92
Transfer,Deposit,2025-02-08 13:08:58,2025-02-08 13:08:58,To Instant Access Savings,3.25,0.00,EUR,COMPLETED,90426.17
Transfer,Deposit,2025-02-08 17:05:33,2025-02-08 17:05:33,From Instant Access Savings,-200.00,0.00,EUR,COMPLETED,90226.17
Transfer,Deposit,2025-02-08 17:22:55,2025-02-08 17:22:55,To Instant Access Savings,4.70,0.00,EUR,COMPLETED,90230.87
Transfer,Deposit,2025-02-08 21:24:29,2025-02-08 21:24:30,To Instant Access Savings,0.75,0.00,EUR,COMPLETED,90231.62
Interest,Deposit,2025-02-09 01:00:00,2025-02-09 01:18:36,Interest earned - Instant Access Savings,5.14,1.70,EUR,COMPLETED,90235.06
Transfer,Deposit,2025-02-09 12:55:54,2025-02-09 12:55:55,To Instant Access Savings,5.00,0.00,EUR,COMPLETED,90240.06
Transfer,Deposit,2025-02-09 14:56:05,2025-02-09 14:56:06,From Instant Access Savings,-100.00,0.00,EUR,COMPLETED,90140.06
Transfer,Deposit,2025-02-09 14:56:10,2025-02-09 14:56:10,To Instant Access Savings,4.40,0.00,EUR,COMPLETED,90144.46
Interest,Deposit,2025-02-10 01:00:00,2025-02-10 01:16:53,Interest earned - Instant Access Savings,5.14,1.69,EUR,COMPLETED,90147.91
Interest,Deposit,2025-02-11 01:00:00,2025-02-11 01:14:09,Interest earned - Instant Access Savings,5.14,1.70,EUR,COMPLETED,90151.35
Transfer,Deposit,2025-02-11 13:51:40,2025-02-11 13:51:40,To Instant Access Savings,0.50,0.00,EUR,COMPLETED,90151.85
Transfer,Deposit,2025-02-11 17:39:28,2025-02-11 17:39:28,From Instant Access Savings,-100.00,0.00,EUR,COMPLETED,90051.85
Transfer,Deposit,2025-02-11 19:05:50,2025-02-11 19:05:50,From Instant Access Savings,-1200.00,0.00,EUR,COMPLETED,88851.85
Transfer,Deposit,2025-02-11 19:07:17,2025-02-11 19:07:17,To Instant Access Savings,5.00,0.00,EUR,COMPLETED,88856.85
Transfer,Deposit,2025-02-11 19:07:17,2025-02-11 19:07:17,To Instant Access Savings,1.55,0.00,EUR,COMPLETED,88858.40
Transfer,Deposit,2025-02-11 20:05:24,2025-02-11 20:05:24,To Instant Access Savings,2.30,0.00,EUR,COMPLETED,88860.70
Interest,Deposit,2025-02-12 01:00:00,2025-02-12 01:13:54,Interest earned - Instant Access Savings,5.06,1.67,EUR,COMPLETED,88864.09
Transfer,Deposit,2025-02-12 08:44:31,2025-02-12 08:44:31,To Instant Access Savings,0.35,0.00,EUR,COMPLETED,88864.44
Transfer,Deposit,2025-02-12 16:49:55,2025-02-12 16:49:55,To Instant Access Savings,2.90,0.00,EUR,COMPLETED,88867.34
Transfer,Deposit,2025-02-12 17:49:51,2025-02-12 17:49:51,To Instant Access Savings,3.25,0.00,EUR,COMPLETED,88870.59
Interest,Deposit,2025-02-13 01:00:00,2025-02-13 01:15:01,Interest earned - Instant Access Savings,5.07,1.67,EUR,COMPLETED,88873.99
Transfer,Deposit,2025-02-13 20:40:40,2025-02-13 20:40:41,To Instant Access Savings,5.00,0.00,EUR,COMPLETED,88878.99
Interest,Deposit,2025-02-14 01:00:00,2025-02-14 01:17:10,Interest earned - Instant Access Savings,5.06,1.67,EUR,COMPLETED,88882.38
Transfer,Deposit,2025-02-14 08:58:52,2025-02-14 08:58:52,To Instant Access Savings,2.50,0.00,EUR,COMPLETED,88884.88
Transfer,Deposit,2025-02-14 09:04:55,2025-02-14 09:04:55,To Instant Access Savings,5.00,0.00,EUR,COMPLETED,88889.88
Transfer,Deposit,2025-02-14 09:11:42,2025-02-14 09:11:42,To Instant Access Savings,2.50,0.00,EUR,COMPLETED,88892.38
Transfer,Deposit,2025-02-14 17:58:30,2025-02-14 17:58:30,To Instant Access Savings,3.55,0.00,EUR,COMPLETED,88895.93
Transfer,Deposit,2025-02-14 18:20:07,2025-02-14 18:20:07,To Instant Access Savings,3.50,0.00,EUR,COMPLETED,88899.43
Transfer,Deposit,2025-02-14 18:42:26,2025-02-14 18:42:26,To Instant Access Savings,5.00,0.00,EUR,COMPLETED,88904.43
Transfer,Deposit,2025-02-14 21:59:00,2025-02-14 21:59:00,From Instant Access Savings,-50.00,0.00,EUR,COMPLETED,88854.43
Transfer,Deposit,2025-02-14 22:00:57,2025-02-14 22:00:57,To Instant Access Savings,1.80,0.00,EUR,COMPLETED,88856.23
Transfer,Deposit,2025-02-14 23:06:10,2025-02-14 23:06:10,To Instant Access Savings,1.50,0.00,EUR,COMPLETED,88857.73
Interest,Deposit,2025-02-15 01:00:00,2025-02-15 01:17:24,Interest earned - Instant Access Savings,5.06,1.67,EUR,COMPLETED,88861.12
Transfer,Deposit,2025-02-15 10:34:30,2025-02-15 10:34:30,To Instant Access Savings,2.00,0.00,EUR,COMPLETED,88863.12
Transfer,Deposit,2025-02-15 11:40:53,2025-02-15 11:40:53,From Instant Access Savings,-100.00,0.00,EUR,COMPLETED,88763.12
Transfer,Deposit,2025-02-15 11:41:58,2025-02-15 11:41:58,To Instant Access Savings,3.75,0.00,EUR,COMPLETED,88766.87
Transfer,Deposit,2025-02-15 16:05:19,2025-02-15 16:05:19,From Instant Access Savings,-600.00,0.00,EUR,COMPLETED,88166.87
Transfer,Deposit,2025-02-15 16:30:35,2025-02-15 16:30:35,To Instant Access Savings,5.00,0.00,EUR,COMPLETED,88171.87
Transfer,Deposit,2025-02-15 19:02:49,2025-02-15 19:02:49,To Instant Access Savings,5.00,0.00,EUR,COMPLETED,88176.87
Transfer,Deposit,2025-02-15 22:09:45,2025-02-15 22:09:45,To Instant Access Savings,5.00,0.00,EUR,COMPLETED,88181.87
Transfer,Deposit,2025-02-16 00:24:37,2025-02-16 00:24:37,To Instant Access Savings,5.00,0.00,EUR,COMPLETED,88186.87
Transfer,Deposit,2025-02-16 00:46:11,2025-02-16 00:46:11,To Instant Access Savings,1.50,0.00,EUR,COMPLETED,88188.37
Transfer,Deposit,2025-02-16 01:04:03,2025-02-16 01:04:04,To Instant Access Savings,5.00,0.00,EUR,COMPLETED,88193.37
Interest,Deposit,2025-02-16 01:00:00,2025-02-16 01:17:34,Interest earned - Instant Access Savings,5.03,1.66,EUR,COMPLETED,88196.74
Transfer,Deposit,2025-02-16 01:46:05,2025-02-16 01:46:05,To Instant Access Savings,2.00,0.00,EUR,COMPLETED,88198.74
Transfer,Deposit,2025-02-16 02:44:03,2025-02-16 02:44:04,To Instant Access Savings,2.50,0.00,EUR,COMPLETED,88201.24
Transfer,Deposit,2025-02-16 10:55:20,2025-02-16 10:55:20,To Instant Access Savings,0.05,0.00,EUR,COMPLETED,88201.29
Transfer,Deposit,2025-02-16 11:15:25,2025-02-16 11:15:25,To Instant Access Savings,0.05,0.00,EUR,COMPLETED,88201.34
Transfer,Deposit,2025-02-16 13:11:22,2025-02-16 13:11:22,To Instant Access Savings,2.55,0.00,EUR,COMPLETED,88203.89
Interest,Deposit,2025-02-17 01:00:00,2025-02-17 01:16:01,Interest earned - Instant Access Savings,5.03,1.66,EUR,COMPLETED,88207.26
Transfer,Deposit,2025-02-17 17:42:10,2025-02-17 17:42:10,To Instant Access Savings,1.00,0.00,EUR,COMPLETED,88208.26
Transfer,Deposit,2025-02-17 18:39:19,2025-02-17 18:39:19,To Instant Access Savings,3.95,0.00,EUR,COMPLETED,88212.21
Interest,Deposit,2025-02-18 01:00:00,2025-02-18 01:17:06,Interest earned - Instant Access Savings,5.02,1.66,EUR,COMPLETED,88215.57
Transfer,Deposit,2025-02-18 16:18:23,2025-02-18 16:18:23,To Instant Access Savings,4.35,0.00,EUR,COMPLETED,88219.92
Transfer,Deposit,2025-02-18 21:41:08,2025-02-18 21:41:08,To Instant Access Savings,3.80,0.00,EUR,COMPLETED,88223.72
Interest,Deposit,2025-02-19 01:00:00,2025-02-19 01:21:07,Interest earned - Instant Access Savings,5.03,1.66,EUR,COMPLETED,88227.09
Transfer,Deposit,2025-02-19 12:45:16,2025-02-19 12:45:16,To Instant Access Savings,5.00,0.00,EUR,COMPLETED,88232.09
Transfer,Deposit,2025-02-19 12:45:24,2025-02-19 12:45:24,From Instant Access Savings,-195.00,0.00,EUR,COMPLETED,88037.09
Transfer,Deposit,2025-02-19 12:49:53,2025-02-19 12:49:53,To Instant Access Savings,5.00,0.00,EUR,COMPLETED,88042.09
Interest,Deposit,2025-02-20 01:00:00,2025-02-20 01:19:38,Interest earned - Instant Access Savings,5.02,1.66,EUR,COMPLETED,88045.45
Transfer,Deposit,2025-02-20 14:41:52,2025-02-20 14:41:53,To Instant Access Savings,2.50,0.00,EUR,COMPLETED,88047.95
Transfer,Deposit,2025-02-20 14:54:42,2025-02-20 14:54:42,To Instant Access Savings,0.50,0.00,EUR,COMPLETED,88048.45
Transfer,Deposit,2025-02-20 19:05:16,2025-02-20 19:05:16,To Instant Access Savings,2.00,0.00,EUR,COMPLETED,88050.45
Interest,Deposit,2025-02-21 01:00:00,2025-02-21 01:18:46,Interest earned - Instant Access Savings,5.02,1.65,EUR,COMPLETED,88053.82
Transfer,Deposit,2025-02-21 08:02:37,2025-02-21 08:02:37,To Instant Access Savings,3.50,0.00,EUR,COMPLETED,88057.32
Transfer,Deposit,2025-02-21 11:33:01,2025-02-21 11:33:01,To Instant Access Savings,1.75,0.00,EUR,COMPLETED,88059.07
Transfer,Deposit,2025-02-21 16:06:13,2025-02-21 16:06:13,To Instant Access Savings,5.00,0.00,EUR,COMPLETED,88064.07
Interest,Deposit,2025-02-22 01:00:00,2025-02-22 01:20:55,Interest earned - Instant Access Savings,5.01,1.65,EUR,COMPLETED,88067.43
Transfer,Deposit,2025-02-22 09:55:08,2025-02-22 09:55:08,To Instant Access Savings,3.50,0.00,EUR,COMPLETED,88070.93
Transfer,Deposit,2025-02-22 14:43:48,2025-02-22 14:43:48,To Instant Access Savings,2.00,0.00,EUR,COMPLETED,88072.93
Transfer,Deposit,2025-02-22 15:27:20,2025-02-22 15:27:20,To Instant Access Savings,3.45,0.00,EUR,COMPLETED,88076.38
Interest,Deposit,2025-02-23 01:00:00,2025-02-23 01:11:50,Interest earned - Instant Access Savings,5.02,1.66,EUR,COMPLETED,88079.74
Transfer,Deposit,2025-02-23 09:56:07,2025-02-23 09:56:07,To Instant Access Savings,0.50,0.00,EUR,COMPLETED,88080.24
Transfer,Deposit,2025-02-23 14:48:36,2025-02-23 14:48:36,From Instant Access Savings,-160.00,0.00,EUR,COMPLETED,87920.24
Transfer,Deposit,2025-02-23 14:48:43,2025-02-23 14:48:43,To Instant Access Savings,2.50,0.00,EUR,COMPLETED,87922.74
Transfer,Deposit,2025-02-23 16:18:52,2025-02-23 16:18:52,To Instant Access Savings,2.05,0.00,EUR,COMPLETED,87924.79
Transfer,Deposit,2025-02-23 16:23:18,2025-02-23 16:23:18,To Instant Access Savings,1.50,0.00,EUR,COMPLETED,87926.29
Interest,Deposit,2025-02-24 01:00:00,2025-02-24 01:10:34,Interest earned - Instant Access Savings,5.01,1.65,EUR,COMPLETED,87929.65
Transfer,Deposit,2025-02-24 18:14:35,2025-02-24 18:14:36,From Instant Access Savings,-2100.00,0.00,EUR,COMPLETED,85829.65
Transfer,Deposit,2025-02-24 18:43:21,2025-02-24 18:43:21,To Instant Access Savings,0.20,0.00,EUR,COMPLETED,85829.85
Transfer,Deposit,2025-02-24 19:48:37,2025-02-24 19:48:37,To Instant Access Savings,0.50,0.00,EUR,COMPLETED,85830.35
Interest,Deposit,2025-02-25 01:00:00,2025-02-25 01:16:45,Interest earned - Instant Access Savings,4.89,1.62,EUR,COMPLETED,85833.62
Transfer,Deposit,2025-02-25 06:35:00,2025-02-25 06:35:00,To Instant Access Savings,275.00,0.00,EUR,COMPLETED,86108.62
Transfer,Deposit,2025-02-25 08:39:02,2025-02-25 08:39:02,To Instant Access Savings,2.50,0.00,EUR,COMPLETED,86111.12
Transfer,Deposit,2025-02-25 11:47:50,2025-02-25 11:47:50,To Instant Access Savings,500.00,0.00,EUR,COMPLETED,86611.12
Transfer,Deposit,2025-02-25 17:23:15,2025-02-25 17:23:15,To Instant Access Savings,5.00,0.00,EUR,COMPLETED,86616.12
Transfer,Deposit,2025-02-25 20:15:15,2025-02-25 20:15:15,To Instant Access Savings,1.00,0.00,EUR,COMPLETED,86617.12
Interest,Deposit,2025-02-26 01:00:00,2025-02-26 01:16:45,Interest earned - Instant Access Savings,4.94,1.63,EUR,COMPLETED,86620.43
Transfer,Deposit,2025-02-26 07:53:26,2025-02-26 07:53:26,To Instant Access Savings,1.50,0.00,EUR,COMPLETED,86621.93
Transfer,Deposit,2025-02-26 07:54:04,2025-02-26 07:54:04,To Instant Access Savings,1.00,0.00,EUR,COMPLETED,86622.93
Transfer,Deposit,2025-02-26 14:15:23,2025-02-26 14:15:23,To Instant Access Savings,2.50,0.00,EUR,COMPLETED,86625.43
Interest,Deposit,2025-02-27 01:00:00,2025-02-27 01:14:17,Interest earned - Instant Access Savings,4.94,1.63,EUR,COMPLETED,86628.74
Transfer,Deposit,2025-02-27 08:46:32,2025-02-27 08:46:32,To Instant Access Savings,2.75,0.00,EUR,COMPLETED,86631.49
Transfer,Deposit,2025-02-27 14:24:24,2025-02-27 14:24:24,To Instant Access Savings,1.75,0.00,EUR,COMPLETED,86633.24
Transfer,Deposit,2025-02-27 20:59:55,2025-02-27 20:59:55,To Instant Access Savings,2.65,0.00,EUR,COMPLETED,86635.89
Interest,Deposit,2025-02-28 01:00:00,2025-02-28 01:11:02,Interest earned - Instant Access Savings,4.93,1.63,EUR,COMPLETED,86639.19
Transfer,Deposit,2025-02-28 16:13:52,2025-02-28 16:13:52,To Instant Access Savings,2.75,0.00,EUR,COMPLETED,86641.94
Interest,Deposit,2025-03-01 01:00:00,2025-03-01 01:22:31,Interest earned - Instant Access Savings,4.94,1.63,EUR,COMPLETED,86645.25
Transfer,Deposit,2025-03-01 09:07:05,2025-03-01 09:07:05,To Instant Access Savings,4.90,0.00,EUR,COMPLETED,86650.15
Transfer,Deposit,2025-03-01 12:03:39,2025-03-01 12:03:39,To Instant Access Savings,0.25,0.00,EUR,COMPLETED,86650.40
Transfer,Deposit,2025-03-01 15:12:30,2025-03-01 15:12:30,To Instant Access Savings,2.50,0.00,EUR,COMPLETED,86652.90
Transfer,Deposit,2025-03-01 18:48:45,2025-03-01 18:48:45,To Instant Access Savings,5.00,0.00,EUR,COMPLETED,86657.90
Interest,Deposit,2025-03-02 01:00:00,2025-03-02 01:18:32,Interest earned - Instant Access Savings,4.94,1.63,EUR,COMPLETED,86661.21
Transfer,Deposit,2025-03-02 12:01:44,2025-03-02 12:01:44,To Instant Access Savings,0.35,0.00,EUR,COMPLETED,86661.56
Transfer,Deposit,2025-03-02 14:29:46,2025-03-02 14:29:46,From Instant Access Savings,-300.00,0.00,EUR,COMPLETED,86361.56
Transfer,Deposit,2025-03-02 17:40:32,2025-03-02 17:40:32,To Instant Access Savings,3.25,0.00,EUR,COMPLETED,86364.81
Interest,Deposit,2025-03-03 01:00:00,2025-03-03 01:16:30,Interest earned - Instant Access Savings,4.92,1.62,EUR,COMPLETED,86368.11
Transfer,Deposit,2025-03-03 17:21:21,2025-03-03 17:21:21,To Instant Access Savings,4.25,0.00,EUR,COMPLETED,86372.36
Interest,Deposit,2025-03-04 01:00:00,2025-03-04 01:12:03,Interest earned - Instant Access Savings,4.92,1.62,EUR,COMPLETED,86375.66
Transfer,Deposit,2025-03-04 14:55:21,2025-03-04 14:55:21,To Instant Access Savings,2.55,0.00,EUR,COMPLETED,86378.21
Transfer,Deposit,2025-03-04 19:03:47,2025-03-04 19:03:47,To Instant Access Savings,2.25,0.00,EUR,COMPLETED,86380.46
Interest,Deposit,2025-03-05 01:00:00,2025-03-05 01:16:21,Interest earned - Instant Access Savings,4.93,1.63,EUR,COMPLETED,86383.76
Transfer,Deposit,2025-03-05 08:20:00,2025-03-05 08:20:00,To Instant Access Savings,1.50,0.00,EUR,COMPLETED,86385.26
Transfer,Deposit,2025-03-05 09:10:10,2025-03-05 09:10:10,To Instant Access Savings,2.50,0.00,EUR,COMPLETED,86387.76
Transfer,Deposit,2025-03-05 12:20:12,2025-03-05 12:20:12,To Instant Access Savings,2.50,0.00,EUR,COMPLETED,86390.26
Interest,Deposit,2025-03-06 01:00:00,2025-03-06 01:16:25,Interest earned - Instant Access Savings,4.92,1.62,EUR,COMPLETED,86393.56
Transfer,Deposit,2025-03-06 20:59:28,2025-03-06 20:59:28,To Instant Access Savings,2.15,0.00,EUR,COMPLETED,86395.71
Interest,Deposit,2025-03-07 01:00:00,2025-03-07 01:16:18,Interest earned - Instant Access Savings,4.92,1.63,EUR,COMPLETED,86399.00
Transfer,Deposit,2025-03-07 08:20:09,2025-03-07 08:20:09,To Instant Access Savings,2.50,0.00,EUR,COMPLETED,86401.50
Transfer,Deposit,2025-03-07 13:44:41,2025-03-07 13:44:41,To Instant Access Savings,3.00,0.00,EUR,COMPLETED,86404.50
Transfer,Deposit,2025-03-07 14:23:05,2025-03-07 14:23:05,To Instant Access Savings,5.00,0.00,EUR,COMPLETED,86409.50
Transfer,Deposit,2025-03-07 19:26:56,2025-03-07 19:26:56,To Instant Access Savings,0.35,0.00,EUR,COMPLETED,86409.85
Interest,Deposit,2025-03-08 01:14:54,2025-03-08 01:14:54,Interest earned - Instant Access Savings,4.93,1.62,EUR,COMPLETED,86413.16
Transfer,Deposit,2025-03-08 10:29:42,2025-03-08 10:29:42,To Instant Access Savings,4.00,0.00,EUR,COMPLETED,86417.16
Transfer,Deposit,2025-03-08 10:34:37,2025-03-08 10:34:37,To Instant Access Savings,4.25,0.00,EUR,COMPLETED,86421.41
Transfer,Deposit,2025-03-08 11:35:17,2025-03-08 11:35:17,To Instant Access Savings,0.50,0.00,EUR,COMPLETED,86421.91
Transfer,Deposit,2025-03-08 13:03:12,2025-03-08 13:03:12,To Instant Access Savings,1.00,0.00,EUR,COMPLETED,86422.91
Transfer,Deposit,2025-03-08 13:07:25,2025-03-08 13:07:25,To Instant Access Savings,0.50,0.00,EUR,COMPLETED,86423.41
Transfer,Deposit,2025-03-08 13:54:21,2025-03-08 13:54:21,To Instant Access Savings,5.00,0.00,EUR,COMPLETED,86428.41
Transfer,Deposit,2025-03-08 14:50:54,2025-03-08 14:50:54,To Instant Access Savings,3.00,0.00,EUR,COMPLETED,86431.41
Transfer,Deposit,2025-03-08 15:45:05,2025-03-08 15:45:05,To Instant Access Savings,3.00,0.00,EUR,COMPLETED,86434.41
Transfer,Deposit,2025-03-08 19:25:29,2025-03-08 19:25:29,To Instant Access Savings,2.60,0.00,EUR,COMPLETED,86437.01
Interest,Deposit,2025-03-09 01:10:21,2025-03-09 01:10:21,Interest earned - Instant Access Savings,4.92,1.63,EUR,COMPLETED,86440.30
Transfer,Deposit,2025-03-09 10:57:18,2025-03-09 10:57:18,To Instant Access Savings,0.35,0.00,EUR,COMPLETED,86440.65
Transfer,Deposit,2025-03-09 11:07:23,2025-03-09 11:07:23,To Instant Access Savings,0.35,0.00,EUR,COMPLETED,86441.00
Transfer,Deposit,2025-03-09 14:28:45,2025-03-09 14:28:45,To Instant Access Savings,5.00,0.00,EUR,COMPLETED,86446.00
Transfer,Deposit,2025-03-09 17:07:06,2025-03-09 17:07:06,From Instant Access Savings,-125.00,0.00,EUR,COMPLETED,86321.00
Transfer,Deposit,2025-03-09 17:07:41,2025-03-09 17:07:41,To Instant Access Savings,0.05,0.00,EUR,COMPLETED,86321.05
Interest,Deposit,2025-03-10 01:09:39,2025-03-10 01:09:39,Interest earned - Instant Access Savings,4.92,1.62,EUR,COMPLETED,86324.35
Transfer,Deposit,2025-03-10 22:07:15,2025-03-10 22:07:15,From Instant Access Savings,-200.00,0.00,EUR,COMPLETED,86124.35
Interest,Deposit,2025-03-11 01:11:33,2025-03-11 01:11:33,Interest earned - Instant Access Savings,4.91,1.62,EUR,COMPLETED,86127.64
Transfer,Deposit,2025-03-11 12:44:18,2025-03-11 12:44:18,To Instant Access Savings,2.50,0.00,EUR,COMPLETED,86130.14
Interest,Deposit,2025-03-12 01:18:53,2025-03-12 01:18:53,Interest earned - Instant Access Savings,4.91,1.62,EUR,COMPLETED,86133.43
Transfer,Deposit,2025-03-12 13:27:10,2025-03-12 13:27:11,To Instant Access Savings,0.50,0.00,EUR,COMPLETED,86133.93
Transfer,Deposit,2025-03-12 15:09:05,2025-03-12 15:09:05,From Instant Access Savings,-133.93,0.00,EUR,COMPLETED,86000.00
Interest,Deposit,2025-03-13 01:17:05,2025-03-13 01:17:05,Interest earned - Instant Access Savings,4.90,1.62,EUR,COMPLETED,86003.28
Transfer,Deposit,2025-03-13 08:18:11,2025-03-13 08:18:11,To Instant Access Savings,0.05,0.00,EUR,COMPLETED,86003.33
Transfer,Deposit,2025-03-13 17:20:21,2025-03-13 17:20:21,To Instant Access Savings,4.60,0.00,EUR,COMPLETED,86007.93
Transfer,Deposit,2025-03-13 17:26:32,2025-03-13 17:26:32,To Instant Access Savings,3.75,0.00,EUR,COMPLETED,86011.68
Transfer,Deposit,2025-03-13 19:00:23,2025-03-13 19:00:23,To Instant Access Savings,2.50,0.00,EUR,COMPLETED,86014.18
Transfer,Deposit,2025-03-13 22:18:00,2025-03-13 22:18:00,To Instant Access Savings,5.00,0.00,EUR,COMPLETED,86019.18
Transfer,Deposit,2025-03-13 23:22:55,2025-03-13 23:22:55,To Instant Access Savings,5.00,0.00,EUR,COMPLETED,86024.18
Transfer,Deposit,2025-03-13 23:43:33,2025-03-13 23:43:33,To Instant Access Savings,5.00,0.00,EUR,COMPLETED,86029.18
Transfer,Deposit,2025-03-14 00:06:29,2025-03-14 00:06:29,To Instant Access Savings,0.75,0.00,EUR,COMPLETED,86029.93
Transfer,Deposit,2025-03-14 00:32:14,2025-03-14 00:32:14,From Instant Access Savings,-100.00,0.00,EUR,COMPLETED,85929.93
Transfer,Deposit,2025-03-14 00:32:27,2025-03-14 00:32:27,To Instant Access Savings,5.00,0.00,EUR,COMPLETED,85934.93
Transfer,Deposit,2025-03-14 01:03:36,2025-03-14 01:03:36,To Instant Access Savings,3.00,0.00,EUR,COMPLETED,85937.93
Interest,Deposit,2025-03-14 01:17:55,2025-03-14 01:17:55,Interest earned - Instant Access Savings,4.90,1.62,EUR,COMPLETED,85941.21
Transfer,Deposit,2025-03-14 11:30:30,2025-03-14 11:30:30,To Instant Access Savings,4.55,0.00,EUR,COMPLETED,85945.76
Transfer,Deposit,2025-03-14 11:41:03,2025-03-14 11:41:03,To Instant Access Savings,5.00,0.00,EUR,COMPLETED,85950.76
Transfer,Deposit,2025-03-14 19:02:23,2025-03-14 19:02:23,To Instant Access Savings,5.00,0.00,EUR,COMPLETED,85955.76
Interest,Deposit,2025-03-15 01:19:13,2025-03-15 01:19:13,Interest earned - Instant Access Savings,4.89,1.61,EUR,COMPLETED,85959.04
Transfer,Deposit,2025-03-15 08:22:01,2025-03-15 08:22:01,From Instant Access Savings,-200.00,0.00,EUR,COMPLETED,85759.04
Transfer,Deposit,2025-03-15 09:32:31,2025-03-15 09:32:31,To Instant Access Savings,5.00,0.00,EUR,COMPLETED,85764.04
Transfer,Deposit,2025-03-15 09:56:25,2025-03-15 09:56:25,To Instant Access Savings,3.50,0.00,EUR,COMPLETED,85767.54
Transfer,Deposit,2025-03-15 20:18:27,2025-03-15 20:18:27,To Instant Access Savings,2.60,0.00,EUR,COMPLETED,85770.14
Interest,Deposit,2025-03-16 01:14:38,2025-03-16 01:14:38,Interest earned - Instant Access Savings,4.89,1.61,EUR,COMPLETED,85773.42
Transfer,Deposit,2025-03-16 09:50:24,2025-03-16 09:50:24,To Instant Access Savings,4.60,0.00,EUR,COMPLETED,85778.02
Transfer,Deposit,2025-03-16 09:55:16,2025-03-16 09:55:16,To Instant Access Savings,0.05,0.00,EUR,COMPLETED,85778.07
Transfer,Deposit,2025-03-16 10:57:45,2025-03-16 10:57:45,To Instant Access Savings,2.70,0.00,EUR,COMPLETED,85780.77
Transfer,Deposit,2025-03-16 11:18:04,2025-03-16 11:18:04,To Instant Access Savings,4.00,0.00,EUR,COMPLETED,85784.77
Transfer,Deposit,2025-03-16 11:45:16,2025-03-16 11:45:16,To Instant Access Savings,5.00,0.00,EUR,COMPLETED,85789.77
Transfer,Deposit,2025-03-16 19:35:54,2025-03-16 19:35:54,To Instant Access Savings,0.50,0.00,EUR,COMPLETED,85790.27
Transfer,Deposit,2025-03-16 21:59:35,2025-03-16 21:59:35,From Instant Access Savings,-50.00,0.00,EUR,COMPLETED,85740.27
Transfer,Deposit,2025-03-16 21:59:47,2025-03-16 21:59:47,To Instant Access Savings,3.70,0.00,EUR,COMPLETED,85743.97
Interest,Deposit,2025-03-17 01:14:17,2025-03-17 01:14:18,Interest earned - Instant Access Savings,4.89,1.62,EUR,COMPLETED,85747.24
Transfer,Deposit,2025-03-17 06:02:25,2025-03-17 06:02:25,To Instant Access Savings,0.05,0.00,EUR,COMPLETED,85747.29
Transfer,Deposit,2025-03-17 06:04:51,2025-03-17 06:04:51,To Instant Access Savings,4.50,0.00,EUR,COMPLETED,85751.79
Transfer,Deposit,2025-03-17 06:41:17,2025-03-17 06:41:17,To Instant Access Savings,2.00,0.00,EUR,COMPLETED,85753.79
Transfer,Deposit,2025-03-17 15:42:34,2025-03-17 15:42:34,From Instant Access Savings,-753.00,0.00,EUR,COMPLETED,85000.79
Transfer,Deposit,2025-03-17 15:44:21,2025-03-17 15:44:21,To Instant Access Savings,2.85,0.00,EUR,COMPLETED,85003.64
Transfer,Deposit,2025-03-17 15:44:55,2025-03-17 15:44:55,To Instant Access Savings,4.50,0.00,EUR,COMPLETED,85008.14
Transfer,Deposit,2025-03-17 16:01:50,2025-03-17 16:01:50,To Instant Access Savings,3.40,0.00,EUR,COMPLETED,85011.54
Transfer,Deposit,2025-03-17 19:11:42,2025-03-17 19:11:42,To Instant Access Savings,0.85,0.00,EUR,COMPLETED,85012.39
Interest,Deposit,2025-03-18 01:14:58,2025-03-18 01:14:58,Interest earned - Instant Access Savings,4.84,1.59,EUR,COMPLETED,85015.64
Transfer,Deposit,2025-03-18 01:34:27,2025-03-18 01:34:27,To Instant Access Savings,1.20,0.00,EUR,COMPLETED,85016.84
Transfer,Deposit,2025-03-18 12:09:54,2025-03-18 12:09:54,To Instant Access Savings,4.80,0.00,EUR,COMPLETED,85021.64
Transfer,Deposit,2025-03-18 22:41:30,2025-03-18 22:41:30,To Instant Access Savings,3.15,0.00,EUR,COMPLETED,85024.79
Interest,Deposit,2025-03-19 01:16:03,2025-03-19 01:16:03,Interest earned - Instant Access Savings,4.85,1.61,EUR,COMPLETED,85028.03
Transfer,Deposit,2025-03-19 07:42:53,2025-03-19 07:42:54,To Instant Access Savings,4.00,0.00,EUR,COMPLETED,85032.03
Transfer,Deposit,2025-03-19 12:47:17,2025-03-19 12:47:17,To Instant Access Savings,1.65,0.00,EUR,COMPLETED,85033.68
Interest,Deposit,2025-03-20 01:15:27,2025-03-20 01:15:27,Interest earned - Instant Access Savings,4.84,1.59,EUR,COMPLETED,85036.93
Transfer,Deposit,2025-03-20 02:14:15,2025-03-20 02:14:15,To Instant Access Savings,1.95,0.00,EUR,COMPLETED,85038.88
Interest,Deposit,2025-03-21 01:15:42,2025-03-21 01:15:42,Interest earned - Instant Access Savings,4.85,1.60,EUR,COMPLETED,85042.13
Transfer,Deposit,2025-03-21 04:42:55,2025-03-21 04:42:55,To Instant Access Savings,2.65,0.00,EUR,COMPLETED,85044.78
Transfer,Deposit,2025-03-21 05:46:23,2025-03-21 05:46:23,To Instant Access Savings,2.25,0.00,EUR,COMPLETED,85047.03
Transfer,Deposit,2025-03-21 11:11:52,2025-03-21 11:11:53,To Instant Access Savings,0.05,0.00,EUR,COMPLETED,85047.08
Transfer,Deposit,2025-03-21 12:22:49,2025-03-21 12:22:49,To Instant Access Savings,4.65,0.00,EUR,COMPLETED,85051.73
Transfer,Deposit,2025-03-21 13:50:55,2025-03-21 13:50:55,To Instant Access Savings,0.65,0.00,EUR,COMPLETED,85052.38
Interest,Deposit,2025-03-22 01:15:57,2025-03-22 01:15:57,Interest earned - Instant Access Savings,4.85,1.60,EUR,COMPLETED,85055.63
Interest,Deposit,2025-03-23 01:18:53,2025-03-23 01:18:53,Interest earned - Instant Access Savings,4.84,1.60,EUR,COMPLETED,85058.87
Transfer,Deposit,2025-03-23 13:07:12,2025-03-23 13:07:12,To Instant Access Savings,1.50,0.00,EUR,COMPLETED,85060.37
Transfer,Deposit,2025-03-23 13:28:40,2025-03-23 13:28:40,To Instant Access Savings,2.45,0.00,EUR,COMPLETED,85062.82
Interest,Deposit,2025-03-24 01:15:43,2025-03-24 01:15:43,Interest earned - Instant Access Savings,4.85,1.60,EUR,COMPLETED,85066.07
Transfer,Deposit,2025-03-24 03:48:04,2025-03-24 03:48:04,To Instant Access Savings,4.80,0.00,EUR,COMPLETED,85070.87
Transfer,Deposit,2025-03-24 04:04:09,2025-03-24 04:04:09,To Instant Access Savings,0.50,0.00,EUR,COMPLETED,85071.37
Interest,Deposit,2025-03-25 01:24:56,2025-03-25 01:24:57,Interest earned - Instant Access Savings,4.85,1.60,EUR,COMPLETED,85074.62
Transfer,Deposit,2025-03-25 02:54:11,2025-03-25 02:54:11,To Instant Access Savings,3.60,0.00,EUR,COMPLETED,85078.22
Interest,Deposit,2025-03-26 01:14:08,2025-03-26 01:14:08,Interest earned - Instant Access Savings,4.85,1.60,EUR,COMPLETED,85081.47
Transfer,Deposit,2025-03-26 01:19:48,2025-03-26 01:19:48,To Instant Access Savings,500.00,0.00,EUR,COMPLETED,85581.47
Transfer,Deposit,2025-03-26 12:18:09,2025-03-26 12:18:09,To Instant Access Savings,3.00,0.00,EUR,COMPLETED,85584.47
Transfer,Deposit,2025-03-26 13:10:05,2025-03-26 13:10:05,To Instant Access Savings,2.40,0.00,EUR,COMPLETED,85586.87
Transfer,Deposit,2025-03-26 14:17:26,2025-03-26 14:17:26,To Instant Access Savings,4.35,0.00,EUR,COMPLETED,85591.22
Interest,Deposit,2025-03-27 01:13:03,2025-03-27 01:13:03,Interest earned - Instant Access Savings,4.87,1.61,EUR,COMPLETED,85594.48
Transfer,Deposit,2025-03-27 11:08:55,2025-03-27 11:08:55,To Instant Access Savings,3.75,0.00,EUR,COMPLETED,85598.23
Transfer,Deposit,2025-03-27 15:42:29,2025-03-27 15:42:29,To Instant Access Savings,0.10,0.00,EUR,COMPLETED,85598.33
Transfer,Deposit,2025-03-27 19:40:37,2025-03-27 19:40:37,To Instant Access Savings,3.45,0.00,EUR,COMPLETED,85601.78
Transfer,Deposit,2025-03-27 23:34:07,2025-03-27 23:34:07,To Instant Access Savings,0.05,0.00,EUR,COMPLETED,85601.83
Interest,Deposit,2025-03-28 01:10:31,2025-03-28 01:10:31,Interest earned - Instant Access Savings,4.88,1.61,EUR,COMPLETED,85605.10
Transfer,Deposit,2025-03-28 08:57:28,2025-03-28 08:57:28,To Instant Access Savings,4.75,0.00,EUR,COMPLETED,85609.85
Transfer,Deposit,2025-03-28 09:06:00,2025-03-28 09:06:00,To Instant Access Savings,0.30,0.00,EUR,COMPLETED,85610.15
Transfer,Deposit,2025-03-28 09:06:02,2025-03-28 09:06:02,To Instant Access Savings,5.00,0.00,EUR,COMPLETED,85615.15
Transfer,Deposit,2025-03-28 11:05:39,2025-03-28 11:05:40,To Instant Access Savings,1.50,0.00,EUR,COMPLETED,85616.65
Interest,Deposit,2025-03-29 01:09:03,2025-03-29 01:09:03,Interest earned - Instant Access Savings,4.87,1.61,EUR,COMPLETED,85619.91
Transfer,Deposit,2025-03-29 03:45:35,2025-03-29 03:45:36,To Instant Access Savings,3.55,0.00,EUR,COMPLETED,85623.46
Transfer,Deposit,2025-03-29 04:13:18,2025-03-29 04:13:18,To Instant Access Savings,0.90,0.00,EUR,COMPLETED,85624.36
Transfer,Deposit,2025-03-29 04:14:54,2025-03-29 04:14:54,To Instant Access Savings,3.10,0.00,EUR,COMPLETED,85627.46
Transfer,Deposit,2025-03-29 07:15:36,2025-03-29 07:15:36,To Instant Access Savings,4.90,0.00,EUR,COMPLETED,85632.36
Transfer,Deposit,2025-03-29 11:21:10,2025-03-29 11:21:10,To Instant Access Savings,1.10,0.00,EUR,COMPLETED,85633.46
Transfer,Deposit,2025-03-29 15:58:41,2025-03-29 15:58:42,To Instant Access Savings,3.35,0.00,EUR,COMPLETED,85636.81
Transfer,Deposit,2025-03-29 16:07:22,2025-03-29 16:07:22,To Instant Access Savings,1.65,0.00,EUR,COMPLETED,85638.46
Transfer,Deposit,2025-03-29 18:21:47,2025-03-29 18:21:48,To Instant Access Savings,2.95,0.00,EUR,COMPLETED,85641.41
Interest,Deposit,2025-03-30 02:09:01,2025-03-30 02:09:01,Interest earned - Instant Access Savings,4.88,1.61,EUR,COMPLETED,85644.68
Transfer,Deposit,2025-03-30 20:50:58,2025-03-30 20:50:58,To Instant Access Savings,0.60,0.00,EUR,COMPLETED,85645.28
Transfer,Deposit,2025-03-30 21:21:38,2025-03-30 21:21:38,To Instant Access Savings,0.35,0.00,EUR,COMPLETED,85645.63
Interest,Deposit,2025-03-31 02:08:49,2025-03-31 02:08:49,Interest earned - Instant Access Savings,4.88,1.61,EUR,COMPLETED,85648.90
Transfer,Deposit,2025-03-31 15:04:27,2025-03-31 15:04:28,To Instant Access Savings,3.95,0.00,EUR,COMPLETED,85652.85
Transfer,Deposit,2025-03-31 15:05:01,2025-03-31 15:05:02,To Instant Access Savings,0.80,0.00,EUR,COMPLETED,85653.65
Transfer,Deposit,2025-03-31 15:56:25,2025-03-31 15:56:57,To Instant Access Savings,0.80,0.00,EUR,COMPLETED,85654.45
Transfer,Deposit,2025-04-01 09:13:09,2025-04-01 09:13:09,To Instant Access Savings,2.55,0.00,EUR,COMPLETED,85657.00
Transfer,Deposit,2025-04-01 09:19:54,2025-04-01 09:20:00,To Instant Access Savings,2.45,0.00,EUR,COMPLETED,85659.45
Transfer,Deposit,2025-04-01 09:20:42,2025-04-01 09:20:47,To Instant Access Savings,3.10,0.00,EUR,COMPLETED,85662.55
Transfer,Deposit,2025-04-01 09:21:32,2025-04-01 09:21:32,To Instant Access Savings,3.75,0.00,EUR,COMPLETED,85666.30
Transfer,Deposit,2025-04-01 10:31:40,2025-04-01 10:31:42,From Instant Access Savings,-1600.00,0.00,EUR,COMPLETED,84066.30
Transfer,Deposit,2025-04-01 10:47:51,2025-04-01 10:47:53,To Instant Access Savings,4.80,0.00,EUR,COMPLETED,84071.10
Interest,Deposit,2025-04-01 14:55:46,2025-04-01 14:55:46,Interest earned - Instant Access Savings,4.89,1.61,EUR,COMPLETED,84074.38
Transfer,Deposit,2025-04-01 21:51:14,2025-04-01 21:51:14,To Instant Access Savings,0.85,0.00,EUR,COMPLETED,84075.23
Interest,Deposit,2025-04-02 03:32:49,2025-04-02 03:32:49,Interest earned - Instant Access Savings,4.79,1.58,EUR,COMPLETED,84078.44
Transfer,Deposit,2025-04-02 07:34:32,2025-04-02 07:34:32,To Instant Access Savings,2.50,0.00,EUR,COMPLETED,84080.94
Transfer,Deposit,2025-04-02 09:20:11,2025-04-02 09:20:12,To Instant Access Savings,0.50,0.00,EUR,COMPLETED,84081.44
Transfer,Deposit,2025-04-02 10:49:35,2025-04-02 10:49:36,To Instant Access Savings,1.80,0.00,EUR,COMPLETED,84083.24
Transfer,Deposit,2025-04-02 11:02:14,2025-04-02 11:02:14,To Instant Access Savings,4.60,0.00,EUR,COMPLETED,84087.84
Transfer,Deposit,2025-04-02 17:59:31,2025-04-02 17:59:31,To Instant Access Savings,4.60,0.00,EUR,COMPLETED,84092.44
Interest,Deposit,2025-04-03 03:25:46,2025-04-03 03:25:46,Interest earned - Instant Access Savings,4.79,1.58,EUR,COMPLETED,84095.65
Interest,Deposit,2025-04-04 03:48:36,2025-04-04 03:48:36,Interest earned - Instant Access Savings,4.79,1.58,EUR,COMPLETED,84098.86
Transfer,Deposit,2025-04-04 08:20:01,2025-04-04 08:20:02,To Instant Access Savings,4.00,0.00,EUR,COMPLETED,84102.86
Transfer,Deposit,2025-04-04 10:44:21,2025-04-04 10:44:22,To Instant Access Savings,1.60,0.00,EUR,COMPLETED,84104.46
Transfer,Deposit,2025-04-04 10:55:44,2025-04-04 10:55:44,To Instant Access Savings,0.15,0.00,EUR,COMPLETED,84104.61
Transfer,Deposit,2025-04-04 18:00:00,2025-04-04 18:00:00,To Instant Access Savings,5.00,0.00,EUR,COMPLETED,84109.61
Transfer,Deposit,2025-04-04 18:05:33,2025-04-04 18:05:33,To Instant Access Savings,4.30,0.00,EUR,COMPLETED,84113.91
Interest,Deposit,2025-04-05 03:31:23,2025-04-05 03:31:23,Interest earned - Instant Access Savings,4.80,1.59,EUR,COMPLETED,84117.12
Transfer,Deposit,2025-04-05 10:33:53,2025-04-05 10:33:54,To Instant Access Savings,5.00,0.00,EUR,COMPLETED,84122.12
Transfer,Deposit,2025-04-05 11:22:52,2025-04-05 11:22:52,To Instant Access Savings,4.00,0.00,EUR,COMPLETED,84126.12
Transfer,Deposit,2025-04-05 18:16:50,2025-04-05 18:16:50,To Instant Access Savings,2.65,0.00,EUR,COMPLETED,84128.77
Transfer,Deposit,2025-04-05 18:25:55,2025-04-05 18:25:56,To Instant Access Savings,0.05,0.00,EUR,COMPLETED,84128.82
Interest,Deposit,2025-04-06 03:27:50,2025-04-06 03:27:50,Interest earned - Instant Access Savings,4.79,1.58,EUR,COMPLETED,84132.03
Transfer,Deposit,2025-04-06 13:06:18,2025-04-06 13:06:18,To Instant Access Savings,3.90,0.00,EUR,COMPLETED,84135.93
Transfer,Deposit,2025-04-06 13:28:58,2025-04-06 13:28:58,To Instant Access Savings,2.20,0.00,EUR,COMPLETED,84138.13
Interest,Deposit,2025-04-07 02:46:32,2025-04-07 02:46:32,Interest earned - Instant Access Savings,4.79,1.58,EUR,COMPLETED,84141.34
Interest,Deposit,2025-04-08 02:46:55,2025-04-08 02:46:55,Interest earned - Instant Access Savings,4.80,1.58,EUR,COMPLETED,84144.56
Transfer,Deposit,2025-04-08 08:45:34,2025-04-08 08:45:37,To Instant Access Savings,5.00,0.00,EUR,COMPLETED,84149.56
Transfer,Deposit,2025-04-08 08:46:18,2025-04-08 08:46:18,To Instant Access Savings,5.00,0.00,EUR,COMPLETED,84154.56
Transfer,Deposit,2025-04-08 08:47:48,2025-04-08 08:47:48,To Instant Access Savings,0.05,0.00,EUR,COMPLETED,84154.61
Transfer,Deposit,2025-04-08 13:52:42,2025-04-08 13:53:28,To Instant Access Savings,3.50,0.00,EUR,COMPLETED,84158.11
Interest,Deposit,2025-04-09 02:46:04,2025-04-09 02:46:04,Interest earned - Instant Access Savings,4.79,1.58,EUR,COMPLETED,84161.32
Transfer,Deposit,2025-04-09 12:10:53,2025-04-09 12:10:53,From Instant Access Savings,-2500.00,0.00,EUR,COMPLETED,81661.32
Transfer,Deposit,2025-04-09 15:21:01,2025-04-09 15:21:01,To Instant Access Savings,10000.00,0.00,EUR,COMPLETED,91661.32
Transfer,Deposit,2025-04-09 17:58:27,2025-04-09 17:58:27,To Instant Access Savings,5.00,0.00,EUR,COMPLETED,91666.32
Transfer,Deposit,2025-04-09 19:22:26,2025-04-09 19:22:26,To Instant Access Savings,5.00,0.00,EUR,COMPLETED,91671.32
Interest,Deposit,2025-04-10 02:52:04,2025-04-10 02:52:04,Interest earned - Instant Access Savings,5.23,1.73,EUR,COMPLETED,91674.82
Transfer,Deposit,2025-04-10 19:29:19,2025-04-10 19:29:19,To Instant Access Savings,5.00,0.00,EUR,COMPLETED,91679.82
Interest,Deposit,2025-04-11 02:41:42,2025-04-11 02:41:42,Interest earned - Instant Access Savings,5.22,1.72,EUR,COMPLETED,91683.32
Transfer,Deposit,2025-04-11 08:44:16,2025-04-11 08:44:16,To Instant Access Savings,3.25,0.00,EUR,COMPLETED,91686.57
Transfer,Deposit,2025-04-11 08:50:06,2025-04-11 08:50:06,To Instant Access Savings,1.75,0.00,EUR,COMPLETED,91688.32
Exchange,Deposit,2025-04-11 18:49:35,2025-04-11 18:49:35,Exchanged to EUR,0.57,0.00,EUR,COMPLETED,91688.89
Exchange,Deposit,2025-04-11 19:09:09,2025-04-11 19:09:09,Exchanged to EUR,2.88,0.00,EUR,COMPLETED,91691.77
Exchange,Deposit,2025-04-11 20:09:11,2025-04-11 20:09:11,Exchanged to EUR,5.76,0.00,EUR,COMPLETED,91697.53
Exchange,Deposit,2025-04-11 22:15:34,2025-04-11 22:15:34,Exchanged to EUR,5.74,0.06,EUR,COMPLETED,91703.21
Exchange,Deposit,2025-04-11 22:24:59,2025-04-11 22:24:59,Exchanged to EUR,2.87,0.03,EUR,COMPLETED,91706.05
Exchange,Deposit,2025-04-11 22:43:46,2025-04-11 22:43:46,Exchanged to EUR,0.51,0.01,EUR,COMPLETED,91706.55
Exchange,Deposit,2025-04-11 23:20:26,2025-04-11 23:20:26,Exchanged to EUR,5.74,0.06,EUR,COMPLETED,91712.23
Exchange,Deposit,2025-04-11 23:21:11,2025-04-11 23:21:11,Exchanged to EUR,5.74,0.06,EUR,COMPLETED,91717.91
Interest,Deposit,2025-04-12 02:45:31,2025-04-12 02:45:31,Interest earned - Instant Access Savings,5.23,1.73,EUR,COMPLETED,91721.41
Exchange,Deposit,2025-04-12 10:13:19,2025-04-12 10:13:19,Exchanged to EUR,5.23,0.05,EUR,COMPLETED,91726.59
Transfer,Deposit,2025-04-12 10:49:01,2025-04-12 10:49:02,From Instant Access Savings,-500.00,0.00,EUR,COMPLETED,91226.59
Transfer,Deposit,2025-04-12 10:54:07,2025-04-12 10:54:07,To Instant Access Savings,5.00,0.00,EUR,COMPLETED,91231.59
Transfer,Deposit,2025-04-12 11:21:55,2025-04-12 11:21:55,To Instant Access Savings,2.00,0.00,EUR,COMPLETED,91233.59
Exchange,Deposit,2025-04-12 12:42:44,2025-04-12 12:42:48,Exchanged to EUR,5.74,0.06,EUR,COMPLETED,91239.27
Transfer,Deposit,2025-04-12 15:17:11,2025-04-12 15:17:11,To Instant Access Savings,1.25,0.00,EUR,COMPLETED,91240.52
Transfer,Deposit,2025-04-12 15:30:39,2025-04-12 15:30:39,To Instant Access Savings,1.50,0.00,EUR,COMPLETED,91242.02
Interest,Deposit,2025-04-13 02:15:16,2025-04-13 02:15:16,Interest earned - Instant Access Savings,5.20,1.71,EUR,COMPLETED,91245.51
Transfer,Deposit,2025-04-13 08:51:33,2025-04-13 08:51:33,To Instant Access Savings,3.50,0.00,EUR,COMPLETED,91249.01
Transfer,Deposit,2025-04-13 09:15:30,2025-04-13 09:15:30,To Instant Access Savings,4.00,0.00,EUR,COMPLETED,91253.01
Transfer,Deposit,2025-04-13 10:55:15,2025-04-13 10:55:15,To Instant Access Savings,0.05,0.00,EUR,COMPLETED,91253.06
Transfer,Deposit,2025-04-13 11:21:12,2025-04-13 11:21:13,From Instant Access Savings,-140.00,0.00,EUR,COMPLETED,91113.06
Transfer,Deposit,2025-04-13 17:31:29,2025-04-13 17:31:29,To Instant Access Savings,4.70,0.00,EUR,COMPLETED,91117.76
Interest,Deposit,2025-04-14 02:15:38,2025-04-14 02:15:38,Interest earned - Instant Access Savings,5.19,1.72,EUR,COMPLETED,91121.23
Transfer,Deposit,2025-04-14 10:35:31,2025-04-14 10:35:31,To Instant Access Savings,2.00,0.00,EUR,COMPLETED,91123.23
Transfer,Deposit,2025-04-14 12:25:42,2025-04-14 12:25:42,From Instant Access Savings,-200.00,0.00,EUR,COMPLETED,90923.23
Transfer,Deposit,2025-04-14 12:25:50,2025-04-14 12:25:50,To Instant Access Savings,5.00,0.00,EUR,COMPLETED,90928.23
Transfer,Deposit,2025-04-14 12:40:46,2025-04-14 12:40:49,To Instant Access Savings,4.40,0.00,EUR,COMPLETED,90932.63
Interest,Deposit,2025-04-15 02:13:45,2025-04-15 02:13:45,Interest earned - Instant Access Savings,5.18,1.71,EUR,COMPLETED,90936.10
Transfer,Deposit,2025-04-15 22:37:57,2025-04-15 22:37:57,To Instant Access Savings,0.10,0.00,EUR,COMPLETED,90936.20
Interest,Deposit,2025-04-16 02:12:45,2025-04-16 02:12:45,Interest earned - Instant Access Savings,5.19,1.71,EUR,COMPLETED,90939.68
Transfer,Deposit,2025-04-16 08:41:12,2025-04-16 08:41:12,To Instant Access Savings,1.50,0.00,EUR,COMPLETED,90941.18
Transfer,Deposit,2025-04-16 17:44:09,2025-04-16 17:44:10,To Instant Access Savings,5.00,0.00,EUR,COMPLETED,90946.18
Transfer,Deposit,2025-04-16 18:50:09,2025-04-16 18:50:09,From Instant Access Savings,-150.00,0.00,EUR,COMPLETED,90796.18
Transfer,Deposit,2025-04-16 18:50:16,2025-04-16 18:50:16,To Instant Access Savings,5.00,0.00,EUR,COMPLETED,90801.18
Interest,Deposit,2025-04-17 02:15:32,2025-04-17 02:15:32,Interest earned - Instant Access Savings,5.17,1.70,EUR,COMPLETED,90804.65
Transfer,Deposit,2025-04-17 20:04:56,2025-04-17 20:04:56,To Instant Access Savings,3.10,0.00,EUR,COMPLETED,90807.75
Interest,Deposit,2025-04-18 02:20:42,2025-04-18 02:20:42,Interest earned - Instant Access Savings,5.18,1.71,EUR,COMPLETED,90811.22
Transfer,Deposit,2025-04-18 09:36:22,2025-04-18 09:36:22,To Instant Access Savings,4.00,0.00,EUR,COMPLETED,90815.22
Transfer,Deposit,2025-04-18 13:20:37,2025-04-18 13:20:37,To Instant Access Savings,2.00,0.00,EUR,COMPLETED,90817.22
Transfer,Deposit,2025-04-18 14:10:34,2025-04-18 14:10:35,To Instant Access Savings,0.70,0.00,EUR,COMPLETED,90817.92
Transfer,Deposit,2025-04-18 14:32:38,2025-04-18 14:32:38,From Instant Access Savings,-200.00,0.00,EUR,COMPLETED,90617.92
Transfer,Deposit,2025-04-18 14:34:38,2025-04-18 14:34:39,To Instant Access Savings,1.45,0.00,EUR,COMPLETED,90619.37
Transfer,Deposit,2025-04-18 18:49:16,2025-04-18 18:53:35,To Instant Access Savings,1.00,0.00,EUR,COMPLETED,90620.37
Interest,Deposit,2025-04-19 02:21:28,2025-04-19 02:21:28,Interest earned - Instant Access Savings,5.16,1.71,EUR,COMPLETED,90623.82
Transfer,Deposit,2025-04-19 09:50:26,2025-04-19 09:50:27,To Instant Access Savings,4.25,0.00,EUR,COMPLETED,90628.07
Transfer,Deposit,2025-04-19 13:12:25,2025-04-19 13:12:25,To Instant Access Savings,5.00,0.00,EUR,COMPLETED,90633.07
Transfer,Deposit,2025-04-19 13:39:40,2025-04-19 13:39:40,To Instant Access Savings,0.05,0.00,EUR,COMPLETED,90633.12
Transfer,Deposit,2025-04-19 13:55:09,2025-04-19 13:55:09,From Instant Access Savings,-150.00,0.00,EUR,COMPLETED,90483.12
Transfer,Deposit,2025-04-19 13:55:52,2025-04-19 13:55:52,To Instant Access Savings,5.00,0.00,EUR,COMPLETED,90488.12
Transfer,Deposit,2025-04-19 14:00:42,2025-04-19 14:00:42,To Instant Access Savings,5.00,0.00,EUR,COMPLETED,90493.12
Transfer,Deposit,2025-04-19 15:37:41,2025-04-19 15:37:41,From Instant Access Savings,-150.00,0.00,EUR,COMPLETED,90343.12
Transfer,Deposit,2025-04-19 15:39:06,2025-04-19 15:39:06,To Instant Access Savings,2.10,0.00,EUR,COMPLETED,90345.22
Transfer,Deposit,2025-04-19 15:54:08,2025-04-19 15:54:08,To Instant Access Savings,3.75,0.00,EUR,COMPLETED,90348.97
Transfer,Deposit,2025-04-19 16:07:40,2025-04-19 16:07:41,To Instant Access Savings,2.00,0.00,EUR,COMPLETED,90350.97
Transfer,Deposit,2025-04-19 20:30:50,2025-04-19 20:30:50,To Instant Access Savings,3.15,0.00,EUR,COMPLETED,90354.12
Interest,Deposit,2025-04-20 02:20:06,2025-04-20 02:20:06,Interest earned - Instant Access Savings,5.15,1.70,EUR,COMPLETED,90357.57
Interest,Deposit,2025-04-21 02:16:30,2025-04-21 02:16:30,Interest earned - Instant Access Savings,4.55,1.50,EUR,COMPLETED,90360.62
Transfer,Deposit,2025-04-21 08:36:26,2025-04-21 08:36:26,To Instant Access Savings,4.00,0.00,EUR,COMPLETED,90364.62
Transfer,Deposit,2025-04-21 08:37:40,2025-04-21 08:37:40,To Instant Access Savings,3.20,0.00,EUR,COMPLETED,90367.82
Interest,Deposit,2025-04-22 02:15:52,2025-04-22 02:15:52,Interest earned - Instant Access Savings,4.56,1.50,EUR,COMPLETED,90370.88
Transfer,Deposit,2025-04-22 08:59:04,2025-04-22 08:59:04,To Instant Access Savings,1.25,0.00,EUR,COMPLETED,90372.13
Interest,Deposit,2025-04-23 02:15:58,2025-04-23 02:15:58,Interest earned - Instant Access Savings,4.55,1.50,EUR,COMPLETED,90375.18
Transfer,Deposit,2025-04-23 13:41:35,2025-04-23 13:41:35,From Instant Access Savings,-100.00,0.00,EUR,COMPLETED,90275.18
Transfer,Deposit,2025-04-23 13:41:44,2025-04-23 13:41:44,To Instant Access Savings,5.00,0.00,EUR,COMPLETED,90280.18
Transfer,Deposit,2025-04-23 17:52:43,2025-04-23 17:52:43,To Instant Access Savings,4.05,0.00,EUR,COMPLETED,90284.23
Interest,Deposit,2025-04-24 02:15:26,2025-04-24 02:15:26,Interest earned - Instant Access Savings,4.56,1.51,EUR,COMPLETED,90287.28
Interest,Deposit,2025-04-25 02:10:50,2025-04-25 02:10:50,Interest earned - Instant Access Savings,4.55,1.50,EUR,COMPLETED,90290.33
Transfer,Deposit,2025-04-25 13:08:25,2025-04-25 13:08:25,To Instant Access Savings,5.00,0.00,EUR,COMPLETED,90295.33
Transfer,Deposit,2025-04-25 16:03:54,2025-04-25 16:03:54,To Instant Access Savings,0.05,0.00,EUR,COMPLETED,90295.38
Transfer,Deposit,2025-04-25 16:07:10,2025-04-25 16:07:10,To Instant Access Savings,1000.00,0.00,EUR,COMPLETED,91295.38
Interest,Deposit,2025-04-26 02:15:56,2025-04-26 02:15:56,Interest earned - Instant Access Savings,4.60,1.52,EUR,COMPLETED,91298.46
Transfer,Deposit,2025-04-26 10:30:49,2025-04-26 10:30:50,To Instant Access Savings,5.00,0.00,EUR,COMPLETED,91303.46
Transfer,Deposit,2025-04-26 13:17:45,2025-04-26 13:17:45,To Instant Access Savings,1.25,0.00,EUR,COMPLETED,91304.71
Transfer,Deposit,2025-04-26 14:02:30,2025-04-26 14:02:30,To Instant Access Savings,1.75,0.00,EUR,COMPLETED,91306.46
Transfer,Deposit,2025-04-26 17:59:44,2025-04-26 17:59:44,To Instant Access Savings,2.65,0.00,EUR,COMPLETED,91309.11
Interest,Deposit,2025-04-27 02:16:42,2025-04-27 02:16:42,Interest earned - Instant Access Savings,4.60,1.52,EUR,COMPLETED,91312.19
Transfer,Deposit,2025-04-27 12:07:40,2025-04-27 12:07:40,To Instant Access Savings,1.50,0.00,EUR,COMPLETED,91313.69
Transfer,Deposit,2025-04-27 13:41:12,2025-04-27 13:41:12,To Instant Access Savings,5.00,0.00,EUR,COMPLETED,91318.69
Transfer,Deposit,2025-04-27 13:51:04,2025-04-27 13:51:04,To Instant Access Savings,5.00,0.00,EUR,COMPLETED,91323.69
Transfer,Deposit,2025-04-27 13:57:01,2025-04-27 13:57:01,To Instant Access Savings,5.00,0.00,EUR,COMPLETED,91328.69
Transfer,Deposit,2025-04-27 16:21:37,2025-04-27 16:21:37,To Instant Access Savings,1.90,0.00,EUR,COMPLETED,91330.59
Transfer,Deposit,2025-04-28 00:35:16,2025-04-28 00:35:16,To Instant Access Savings,0.05,0.00,EUR,COMPLETED,91330.64
Interest,Deposit,2025-04-28 02:17:15,2025-04-28 02:17:15,Interest earned - Instant Access Savings,4.61,1.52,EUR,COMPLETED,91333.73
Transfer,Deposit,2025-04-28 14:30:33,2025-04-28 14:30:33,To Instant Access Savings,1000.00,0.00,EUR,COMPLETED,92333.73
Transfer,Deposit,2025-04-28 17:58:17,2025-04-28 17:58:17,To Instant Access Savings,0.30,0.00,EUR,COMPLETED,92334.03
Transfer,Deposit,2025-04-28 18:03:34,2025-04-28 18:03:34,To Instant Access Savings,1.00,0.00,EUR,COMPLETED,92335.03
Transfer,Deposit,2025-04-28 19:43:41,2025-04-28 19:43:41,To Instant Access Savings,3.20,0.00,EUR,COMPLETED,92338.23
Interest,Deposit,2025-04-29 02:17:23,2025-04-29 02:17:23,Interest earned - Instant Access Savings,4.65,1.53,EUR,COMPLETED,92341.35
Transfer,Deposit,2025-04-29 04:05:34,2025-04-29 04:05:34,To Instant Access Savings,0.70,0.00,EUR,COMPLETED,92342.05
Transfer,Deposit,2025-04-29 07:13:01,2025-04-29 07:13:01,To Instant Access Savings,3720.00,0.00,EUR,COMPLETED,96062.05
Transfer,Deposit,2025-04-29 18:25:02,2025-04-29 18:25:02,To Instant Access Savings,0.95,0.00,EUR,COMPLETED,96063.00
Interest,Deposit,2025-04-30 02:11:59,2025-04-30 02:11:59,Interest earned - Instant Access Savings,4.84,1.60,EUR,COMPLETED,96066.24
Transfer,Deposit,2025-04-30 06:05:33,2025-04-30 06:05:33,To Instant Access Savings,1.30,0.00,EUR,COMPLETED,96067.54
Transfer,Deposit,2025-04-30 15:27:17,2025-04-30 15:27:17,To Instant Access Savings,3.20,0.00,EUR,COMPLETED,96070.74
Transfer,Deposit,2025-04-30 20:48:11,2025-04-30 20:48:12,From Instant Access Savings,-300.00,0.00,EUR,COMPLETED,95770.74
Transfer,Deposit,2025-04-30 20:48:29,2025-04-30 20:48:29,To Instant Access Savings,0.70,0.00,EUR,COMPLETED,95771.44
Transfer,Deposit,2025-04-30 20:49:17,2025-04-30 20:49:17,To Instant Access Savings,3.80,0.00,EUR,COMPLETED,95775.24
Interest,Deposit,2025-05-01 02:16:05,2025-05-01 02:16:05,Interest earned - Instant Access Savings,4.83,1.59,EUR,COMPLETED,95778.48
Transfer,Deposit,2025-05-01 09:10:42,2025-05-01 09:10:42,To Instant Access Savings,5.00,0.00,EUR,COMPLETED,95783.48
Transfer,Deposit,2025-05-01 09:14:47,2025-05-01 09:14:47,To Instant Access Savings,1.30,0.00,EUR,COMPLETED,95784.78
Interest,Deposit,2025-05-02 02:18:49,2025-05-02 02:18:49,Interest earned - Instant Access Savings,4.83,1.60,EUR,COMPLETED,95788.01
Transfer,Deposit,2025-05-02 08:20:37,2025-05-02 08:20:37,From Instant Access Savings,-250.00,0.00,EUR,COMPLETED,95538.01
Transfer,Deposit,2025-05-02 08:20:45,2025-05-02 08:20:45,To Instant Access Savings,0.15,0.00,EUR,COMPLETED,95538.16
Transfer,Deposit,2025-05-02 08:24:38,2025-05-02 08:24:39,To Instant Access Savings,1.00,0.00,EUR,COMPLETED,95539.16
Transfer,Deposit,2025-05-02 08:37:18,2025-05-02 08:37:18,To Instant Access Savings,2.55,0.00,EUR,COMPLETED,95541.71
Transfer,Deposit,2025-05-02 12:00:11,2025-05-02 12:00:11,To Instant Access Savings,999.00,0.00,EUR,COMPLETED,96540.71
Transfer,Deposit,2025-05-02 14:42:08,2025-05-02 14:42:08,From Instant Access Savings,-250.00,0.00,EUR,COMPLETED,96290.71
Interest,Deposit,2025-05-03 02:18:23,2025-05-03 02:18:23,Interest earned - Instant Access Savings,4.85,1.60,EUR,COMPLETED,96293.96
Transfer,Deposit,2025-05-03 11:19:29,2025-05-03 11:19:29,To Instant Access Savings,5.00,0.00,EUR,COMPLETED,96298.96
Transfer,Deposit,2025-05-03 12:02:55,2025-05-03 12:02:55,To Instant Access Savings,0.05,0.00,EUR,COMPLETED,96299.01
Transfer,Deposit,2025-05-03 16:57:08,2025-05-03 16:57:08,To Instant Access Savings,0.05,0.00,EUR,COMPLETED,96299.06
Interest,Deposit,2025-05-04 02:16:56,2025-05-04 02:16:56,Interest earned - Instant Access Savings,4.86,1.60,EUR,COMPLETED,96302.32
Transfer,Deposit,2025-05-04 11:34:22,2025-05-04 11:34:22,To Instant Access Savings,2.05,0.00,EUR,COMPLETED,96304.37
Transfer,Deposit,2025-05-04 15:12:27,2025-05-04 15:12:27,To Instant Access Savings,5.00,0.00,EUR,COMPLETED,96309.37
Transfer,Deposit,2025-05-04 17:07:54,2025-05-04 17:07:54,To Instant Access Savings,4.50,0.00,EUR,COMPLETED,96313.87
Transfer,Deposit,2025-05-04 18:43:09,2025-05-04 18:43:09,To Instant Access Savings,3.25,0.00,EUR,COMPLETED,96317.12
Transfer,Deposit,2025-05-04 20:01:39,2025-05-04 20:01:39,To Instant Access Savings,2.05,0.00,EUR,COMPLETED,96319.17
Interest,Deposit,2025-05-05 02:17:30,2025-05-05 02:17:30,Interest earned - Instant Access Savings,4.85,1.60,EUR,COMPLETED,96322.42
Transfer,Deposit,2025-05-05 16:27:24,2025-05-05 16:27:24,To Instant Access Savings,3600.00,0.00,EUR,COMPLETED,99922.42
Interest,Deposit,2025-05-06 02:14:18,2025-05-06 02:14:18,Interest earned - Instant Access Savings,5.04,1.67,EUR,COMPLETED,99925.79
Transfer,Deposit,2025-05-06 07:25:52,2025-05-06 07:25:52,To Instant Access Savings,0.25,0.00,EUR,COMPLETED,99926.04
Transfer,Deposit,2025-05-06 08:49:50,2025-05-06 08:49:50,To Instant Access Savings,1.50,0.00,EUR,COMPLETED,99927.54
Transfer,Deposit,2025-05-06 21:14:52,2025-05-06 21:14:52,To Instant Access Savings,3.60,0.00,EUR,COMPLETED,99931.14
Exchange,Deposit,2025-05-06 22:15:50,2025-05-06 22:15:51,Exchanged to EUR,0.05,0.00,EUR,COMPLETED,99931.19
Interest,Deposit,2025-05-07 02:14:26,2025-05-07 02:14:26,Interest earned - Instant Access Savings,5.04,1.66,EUR,COMPLETED,99934.57
Transfer,Deposit,2025-05-07 08:52:50,2025-05-07 08:52:50,To Instant Access Savings,4.10,0.00,EUR,COMPLETED,99938.67
Transfer,Deposit,2025-05-07 16:12:27,2025-05-07 16:12:27,To Instant Access Savings,2.40,0.00,EUR,COMPLETED,99941.07
Transfer,Deposit,2025-05-07 17:49:46,2025-05-07 17:49:46,To Instant Access Savings,0.90,0.00,EUR,COMPLETED,99941.97
Transfer,Deposit,2025-05-07 19:21:51,2025-05-07 19:21:51,To Instant Access Savings,1.65,0.00,EUR,COMPLETED,99943.62
Interest,Deposit,2025-05-08 02:13:40,2025-05-08 02:13:40,Interest earned - Instant Access Savings,5.04,1.66,EUR,COMPLETED,99947.00
Transfer,Deposit,2025-05-08 08:15:06,2025-05-08 08:15:06,To Instant Access Savings,0.05,0.00,EUR,COMPLETED,99947.05
Interest,Deposit,2025-05-09 02:06:32,2025-05-09 02:06:32,Interest earned - Instant Access Savings,5.04,1.66,EUR,COMPLETED,99950.43
Transfer,Deposit,2025-05-09 08:57:30,2025-05-09 08:57:30,To Instant Access Savings,2.20,0.00,EUR,COMPLETED,99952.63
Transfer,Deposit,2025-05-09 09:12:00,2025-05-09 09:12:00,To Instant Access Savings,2.75,0.00,EUR,COMPLETED,99955.38
Transfer,Deposit,2025-05-09 15:33:43,2025-05-09 15:33:43,To Instant Access Savings,4.75,0.00,EUR,COMPLETED,99960.13
Transfer,Deposit,2025-05-09 18:14:21,2025-05-09 18:14:21,To Instant Access Savings,1.50,0.00,EUR,COMPLETED,99961.63
Transfer,Deposit,2025-05-09 18:20:28,2025-05-09 18:20:28,To Instant Access Savings,2.50,0.00,EUR,COMPLETED,99964.13
Transfer,Deposit,2025-05-09 18:26:26,2025-05-09 18:26:26,To Instant Access Savings,0.05,0.00,EUR,COMPLETED,99964.18
Transfer,Deposit,2025-05-09 21:42:17,2025-05-09 21:42:17,To Instant Access Savings,1.50,0.00,EUR,COMPLETED,99965.68
Transfer,Deposit,2025-05-09 23:14:52,2025-05-09 23:14:52,To Instant Access Savings,5.00,0.00,EUR,COMPLETED,99970.68
Transfer,Deposit,2025-05-09 23:18:19,2025-05-09 23:18:19,To Instant Access Savings,2.35,0.00,EUR,COMPLETED,99973.03
Transfer,Deposit,2025-05-10 00:35:37,2025-05-10 00:35:37,To Instant Access Savings,5.00,0.00,EUR,COMPLETED,99978.03
Interest,Deposit,2025-05-10 02:05:52,2025-05-10 02:05:52,Interest earned - Instant Access Savings,5.04,1.67,EUR,COMPLETED,99981.40
Transfer,Deposit,2025-05-10 10:43:09,2025-05-10 10:43:10,To Instant Access Savings,4.25,0.00,EUR,COMPLETED,99985.65
Transfer,Deposit,2025-05-10 11:16:44,2025-05-10 11:16:44,To Instant Access Savings,4.75,0.00,EUR,COMPLETED,99990.40
Transfer,Deposit,2025-05-10 18:10:27,2025-05-10 18:10:27,To Instant Access Savings,4.50,0.00,EUR,COMPLETED,99994.90
Interest,Deposit,2025-05-11 02:03:26,2025-05-11 02:03:26,Interest earned - Instant Access Savings,5.04,1.66,EUR,COMPLETED,99998.28
Interest,Deposit,2025-05-12 02:05:00,2025-05-12 02:05:00,Interest earned - Instant Access Savings,5.04,1.66,EUR,COMPLETED,100001.66
Interest,Deposit,2025-05-13 02:04:25,2025-05-13 02:04:25,Interest earned - Instant Access Savings,5.04,1.67,EUR,COMPLETED,100005.03
Interest,Deposit,2025-05-14 02:05:43,2025-05-14 02:05:43,Interest earned - Instant Access Savings,5.04,1.66,EUR,COMPLETED,100008.41
Transfer,Deposit,2025-05-14 08:22:37,2025-05-14 08:22:37,From Instant Access Savings,-1000.00,0.00,EUR,COMPLETED,99008.41
Interest,Deposit,2025-05-15 02:04:10,2025-05-15 02:04:10,Interest earned - Instant Access Savings,4.99,1.65,EUR,COMPLETED,99011.75
Interest,Deposit,2025-05-16 02:04:29,2025-05-16 02:04:29,Interest earned - Instant Access Savings,4.99,1.64,EUR,COMPLETED,99015.10
Interest,Deposit,2025-05-17 02:04:49,2025-05-17 02:04:49,Interest earned - Instant Access Savings,4.99,1.65,EUR,COMPLETED,99018.44
Interest,Deposit,2025-05-18 02:05:16,2025-05-18 02:05:16,Interest earned - Instant Access Savings,5.00,1.65,EUR,COMPLETED,99021.79
Interest,Deposit,2025-05-19 02:05:05,2025-05-19 02:05:05,Interest earned - Instant Access Savings,4.99,1.65,EUR,COMPLETED,99025.13
Interest,Deposit,2025-05-20 02:03:27,2025-05-20 02:03:27,Interest earned - Instant Access Savings,4.99,1.64,EUR,COMPLETED,99028.48
Interest,Deposit,2025-05-21 02:02:48,2025-05-21 02:02:48,Interest earned - Instant Access Savings,4.99,1.65,EUR,COMPLETED,99031.82
Interest,Deposit,2025-05-22 02:05:02,2025-05-22 02:05:02,Interest earned - Instant Access Savings,4.99,1.65,EUR,COMPLETED,99035.16
Interest,Deposit,2025-05-23 02:05:04,2025-05-23 02:05:04,Interest earned - Instant Access Savings,5.00,1.65,EUR,COMPLETED,99038.51
Interest,Deposit,2025-05-24 02:04:27,2025-05-24 02:04:27,Interest earned - Instant Access Savings,4.99,1.64,EUR,COMPLETED,99041.86
Interest,Deposit,2025-05-25 02:05:07,2025-05-25 02:05:07,Interest earned - Instant Access Savings,4.99,1.65,EUR,COMPLETED,99045.20
Interest,Deposit,2025-05-26 02:01:25,2025-05-26 02:01:25,Interest earned - Instant Access Savings,5.00,1.65,EUR,COMPLETED,99048.55
Interest,Deposit,2025-05-27 02:02:14,2025-05-27 02:02:14,Interest earned - Instant Access Savings,4.99,1.65,EUR,COMPLETED,99051.89
Interest,Deposit,2025-05-28 02:30:43,2025-05-28 02:30:43,Interest earned - Instant Access Savings,4.99,1.64,EUR,COMPLETED,99055.24
Interest,Deposit,2025-05-29 02:04:22,2025-05-29 02:04:22,Interest earned - Instant Access Savings,5.00,1.65,EUR,COMPLETED,99058.59
Transfer,Deposit,2025-05-29 12:52:11,2025-05-29 12:52:12,From Instant Access Savings,-370.00,0.00,EUR,COMPLETED,98688.59
Transfer,Deposit,2025-05-29 14:47:47,2025-05-29 14:48:00,To Instant Access Savings,5.00,0.00,EUR,COMPLETED,98693.59
Transfer,Deposit,2025-05-29 21:44:57,2025-05-29 21:44:57,To Instant Access Savings,3.60,0.00,EUR,COMPLETED,98697.19
Interest,Deposit,2025-05-30 02:05:10,2025-05-30 02:05:10,Interest earned - Instant Access Savings,4.97,1.64,EUR,COMPLETED,98700.52
Transfer,Deposit,2025-05-30 09:04:15,2025-05-30 09:04:15,To Instant Access Savings,1.10,0.00,EUR,COMPLETED,98701.62
Transfer,Deposit,2025-05-30 09:19:43,2025-05-30 09:19:43,To Instant Access Savings,4.75,0.00,EUR,COMPLETED,98706.37
Transfer,Deposit,2025-05-30 09:57:49,2025-05-30 09:57:50,From Instant Access Savings,-150.00,0.00,EUR,COMPLETED,98556.37
Transfer,Deposit,2025-05-30 10:01:01,2025-05-30 10:01:01,To Instant Access Savings,5.00,0.00,EUR,COMPLETED,98561.37
Transfer,Deposit,2025-05-30 11:33:03,2025-05-30 11:33:03,To Instant Access Savings,4.05,0.00,EUR,COMPLETED,98565.42
Transfer,Deposit,2025-05-30 20:09:19,2025-05-30 20:09:20,To Instant Access Savings,3.00,0.00,EUR,COMPLETED,98568.42
Transfer,Deposit,2025-05-30 21:38:04,2025-05-30 21:38:04,To Instant Access Savings,4.00,0.00,EUR,COMPLETED,98572.42
Transfer,Deposit,2025-05-30 22:49:48,2025-05-30 22:49:48,To Instant Access Savings,2.50,0.00,EUR,COMPLETED,98574.92
Transfer,Deposit,2025-05-30 22:57:50,2025-05-30 22:57:50,To Instant Access Savings,2.50,0.00,EUR,COMPLETED,98577.42
Transfer,Deposit,2025-05-30 23:54:39,2025-05-30 23:54:39,From Instant Access Savings,-100.00,0.00,EUR,COMPLETED,98477.42
Transfer,Deposit,2025-05-30 23:54:56,2025-05-30 23:54:56,To Instant Access Savings,2.00,0.00,EUR,COMPLETED,98479.42
Transfer,Deposit,2025-05-31 00:26:12,2025-05-31 00:26:12,To Instant Access Savings,2.50,0.00,EUR,COMPLETED,98481.92
Transfer,Deposit,2025-05-31 00:45:39,2025-05-31 00:45:39,To Instant Access Savings,1.00,0.00,EUR,COMPLETED,98482.92
Interest,Deposit,2025-05-31 02:04:01,2025-05-31 02:04:01,Interest earned - Instant Access Savings,4.97,1.64,EUR,COMPLETED,98486.25
Transfer,Deposit,2025-05-31 02:35:04,2025-05-31 02:35:04,To Instant Access Savings,2.50,0.00,EUR,COMPLETED,98488.75
Transfer,Deposit,2025-05-31 10:13:19,2025-05-31 10:13:19,To Instant Access Savings,5.00,0.00,EUR,COMPLETED,98493.75
Transfer,Deposit,2025-05-31 14:54:59,2025-05-31 14:54:59,To Instant Access Savings,3.00,0.00,EUR,COMPLETED,98496.75
Transfer,Deposit,2025-05-31 17:03:19,2025-05-31 17:03:19,To Instant Access Savings,2.00,0.00,EUR,COMPLETED,98498.75
Transfer,Deposit,2025-05-31 17:55:09,2025-05-31 17:55:09,From Instant Access Savings,-150.00,0.00,EUR,COMPLETED,98348.75
Transfer,Deposit,2025-05-31 17:55:36,2025-05-31 17:55:36,To Instant Access Savings,2.50,0.00,EUR,COMPLETED,98351.25
Transfer,Deposit,2025-06-01 01:31:11,2025-06-01 01:31:11,To Instant Access Savings,0.60,0.00,EUR,COMPLETED,98351.85
Interest,Deposit,2025-06-01 02:03:55,2025-06-01 02:03:55,Interest earned - Instant Access Savings,4.95,1.64,EUR,COMPLETED,98355.16
Interest,Deposit,2025-06-02 02:05:18,2025-06-02 02:05:18,Interest earned - Instant Access Savings,4.96,1.63,EUR,COMPLETED,98358.49
Transfer,Deposit,2025-06-02 10:56:43,2025-06-02 10:56:44,From Instant Access Savings,-200.00,0.00,EUR,COMPLETED,98158.49
Transfer,Deposit,2025-06-02 10:56:55,2025-06-02 10:56:55,To Instant Access Savings,3.60,0.00,EUR,COMPLETED,98162.09
Transfer,Deposit,2025-06-02 11:36:13,2025-06-02 11:36:13,To Instant Access Savings,0.25,0.00,EUR,COMPLETED,98162.34
Transfer,Deposit,2025-06-02 12:34:32,2025-06-02 12:34:32,To Instant Access Savings,3.50,0.00,EUR,COMPLETED,98165.84
Transfer,Deposit,2025-06-02 22:27:51,2025-06-02 22:27:51,To Instant Access Savings,4.90,0.00,EUR,COMPLETED,98170.74
Interest,Deposit,2025-06-03 02:04:47,2025-06-03 02:04:47,Interest earned - Instant Access Savings,4.95,1.64,EUR,COMPLETED,98174.05
Transfer,Deposit,2025-06-03 03:36:24,2025-06-03 03:36:25,To Instant Access Savings,0.05,0.00,EUR,COMPLETED,98174.10
Transfer,Deposit,2025-06-03 08:53:52,2025-06-03 08:53:52,To Instant Access Savings,4.35,0.00,EUR,COMPLETED,98178.45
Transfer,Deposit,2025-06-03 13:53:28,2025-06-03 13:53:28,To Instant Access Savings,1.55,0.00,EUR,COMPLETED,98180.00
Transfer,Deposit,2025-06-03 20:17:13,2025-06-03 20:17:13,To Instant Access Savings,5.00,0.00,EUR,COMPLETED,98185.00
Interest,Deposit,2025-06-04 02:05:11,2025-06-04 02:05:11,Interest earned - Instant Access Savings,4.95,1.63,EUR,COMPLETED,98188.32
Transfer,Deposit,2025-06-04 11:39:28,2025-06-04 11:39:28,To Instant Access Savings,1.35,0.00,EUR,COMPLETED,98189.67
Interest,Deposit,2025-06-05 02:03:35,2025-06-05 02:03:35,Interest earned - Instant Access Savings,4.95,1.64,EUR,COMPLETED,98192.98
Transfer,Deposit,2025-06-05 17:57:22,2025-06-05 17:57:22,To Instant Access Savings,5.00,0.00,EUR,COMPLETED,98197.98
Interest,Deposit,2025-06-06 02:04:41,2025-06-06 02:04:41,Interest earned - Instant Access Savings,4.95,1.63,EUR,COMPLETED,98201.30
Transfer,Deposit,2025-06-06 05:55:50,2025-06-06 05:55:50,To Instant Access Savings,1.05,0.00,EUR,COMPLETED,98202.35
Transfer,Deposit,2025-06-06 08:18:39,2025-06-06 08:18:39,To Instant Access Savings,5.00,0.00,EUR,COMPLETED,98207.35
Transfer,Deposit,2025-06-06 08:32:40,2025-06-06 08:32:40,To Instant Access Savings,0.50,0.00,EUR,COMPLETED,98207.85
Transfer,Deposit,2025-06-06 10:34:47,2025-06-06 10:34:48,To Instant Access Savings,2.55,0.00,EUR,COMPLETED,98210.40
Transfer,Deposit,2025-06-06 11:28:26,2025-06-06 11:28:26,To Instant Access Savings,5.00,0.00,EUR,COMPLETED,98215.40
Transfer,Deposit,2025-06-06 11:33:48,2025-06-06 11:33:48,To Instant Access Savings,0.05,0.00,EUR,COMPLETED,98215.45
Transfer,Deposit,2025-06-06 18:12:47,2025-06-06 18:12:48,To Instant Access Savings,5.00,0.00,EUR,COMPLETED,98220.45
Transfer,Deposit,2025-06-06 18:24:09,2025-06-06 18:24:09,To Instant Access Savings,5.00,0.00,EUR,COMPLETED,98225.45
Transfer,Deposit,2025-06-06 19:21:16,2025-06-06 19:21:16,To Instant Access Savings,5.00,0.00,EUR,COMPLETED,98230.45
Transfer,Deposit,2025-06-06 19:36:04,2025-06-06 19:36:04,To Instant Access Savings,4.00,0.00,EUR,COMPLETED,98234.45
Transfer,Deposit,2025-06-06 20:03:01,2025-06-06 20:03:01,To Instant Access Savings,4.05,0.00,EUR,COMPLETED,98238.50
Transfer,Deposit,2025-06-06 20:11:07,2025-06-06 20:11:08,To Instant Access Savings,5.00,0.00,EUR,COMPLETED,98243.50
Transfer,Deposit,2025-06-06 21:34:24,2025-06-06 21:34:24,To Instant Access Savings,0.15,0.00,EUR,COMPLETED,98243.65
Interest,Deposit,2025-06-07 02:04:24,2025-06-07 02:04:24,Interest earned - Instant Access Savings,4.95,1.63,EUR,COMPLETED,98246.97
Transfer,Deposit,2025-06-07 09:02:32,2025-06-07 09:02:33,To Instant Access Savings,0.05,0.00,EUR,COMPLETED,98247.02
Transfer,Deposit,2025-06-07 15:22:58,2025-06-07 15:22:58,To Instant Access Savings,5.00,0.00,EUR,COMPLETED,98252.02
Transfer,Deposit,2025-06-07 16:06:41,2025-06-07 16:06:41,To Instant Access Savings,2.60,0.00,EUR,COMPLETED,98254.62
Transfer,Deposit,2025-06-07 16:28:47,2025-06-07 16:28:47,To Instant Access Savings,4.05,0.00,EUR,COMPLETED,98258.67
Interest,Deposit,2025-06-08 02:05:01,2025-06-08 02:05:01,Interest earned - Instant Access Savings,4.96,1.64,EUR,COMPLETED,98261.99
Transfer,Deposit,2025-06-08 10:48:35,2025-06-08 10:48:35,To Instant Access Savings,3.30,0.00,EUR,COMPLETED,98265.29
Transfer,Deposit,2025-06-08 10:55:23,2025-06-08 10:55:23,To Instant Access Savings,0.05,0.00,EUR,COMPLETED,98265.34
Transfer,Deposit,2025-06-08 15:02:04,2025-06-08 15:02:04,To Instant Access Savings,4.70,0.00,EUR,COMPLETED,98270.04
Interest,Deposit,2025-06-09 02:03:47,2025-06-09 02:03:47,Interest earned - Instant Access Savings,4.95,1.63,EUR,COMPLETED,98273.36
Transfer,Deposit,2025-06-09 12:41:01,2025-06-09 12:41:01,To Instant Access Savings,5.00,0.00,EUR,COMPLETED,98278.36
Transfer,Deposit,2025-06-09 15:10:51,2025-06-09 15:10:51,To Instant Access Savings,2.90,0.00,EUR,COMPLETED,98281.26
Transfer,Deposit,2025-06-09 15:20:45,2025-06-09 15:20:45,To Instant Access Savings,3.00,0.00,EUR,COMPLETED,98284.26
Transfer,Deposit,2025-06-09 15:31:48,2025-06-09 15:31:48,To Instant Access Savings,3.55,0.00,EUR,COMPLETED,98287.81
Transfer,Deposit,2025-06-09 17:41:43,2025-06-09 17:41:43,To Instant Access Savings,3.80,0.00,EUR,COMPLETED,98291.61
Transfer,Deposit,2025-06-09 21:14:19,2025-06-09 21:14:19,To Instant Access Savings,2.15,0.00,EUR,COMPLETED,98293.76
Transfer,Deposit,2025-06-09 22:06:47,2025-06-09 22:06:47,To Instant Access Savings,0.75,0.00,EUR,COMPLETED,98294.51
Interest,Deposit,2025-06-10 02:05:15,2025-06-10 02:05:15,Interest earned - Instant Access Savings,4.95,1.64,EUR,COMPLETED,98297.82
Transfer,Deposit,2025-06-10 09:18:37,2025-06-10 09:18:37,To Instant Access Savings,3.05,0.00,EUR,COMPLETED,98300.87
Transfer,Deposit,2025-06-10 10:11:56,2025-06-10 10:11:57,To Instant Access Savings,1000.00,0.00,EUR,COMPLETED,99300.87
Transfer,Deposit,2025-06-10 10:12:13,2025-06-10 10:12:14,To Instant Access Savings,500.00,0.00,EUR,COMPLETED,99800.87
Transfer,Deposit,2025-06-10 10:22:32,2025-06-10 10:22:32,To Instant Access Savings,1.85,0.00,EUR,COMPLETED,99802.72
Transfer,Deposit,2025-06-10 19:47:26,2025-06-10 19:47:26,To Instant Access Savings,4.00,0.00,EUR,COMPLETED,99806.72
Interest,Deposit,2025-06-11 02:04:17,2025-06-11 02:04:17,Interest earned - Instant Access Savings,5.04,1.66,EUR,COMPLETED,99810.10
Interest,Deposit,2025-06-12 02:04:08,2025-06-12 02:04:08,Interest earned - Instant Access Savings,5.03,1.66,EUR,COMPLETED,99813.47
Interest,Deposit,2025-06-13 02:01:19,2025-06-13 02:01:19,Interest earned - Instant Access Savings,5.03,1.66,EUR,COMPLETED,99816.84
Transfer,Deposit,2025-06-13 08:42:42,2025-06-13 08:42:42,To Instant Access Savings,0.80,0.00,EUR,COMPLETED,99817.64
Transfer,Deposit,2025-06-13 09:00:28,2025-06-13 09:00:28,To Instant Access Savings,2.90,0.00,EUR,COMPLETED,99820.54
Transfer,Deposit,2025-06-13 21:19:11,2025-06-13 21:19:12,To Instant Access Savings,5.00,0.00,EUR,COMPLETED,99825.54
Transfer,Deposit,2025-06-13 21:34:19,2025-06-13 21:34:19,To Instant Access Savings,4.50,0.00,EUR,COMPLETED,99830.04
Transfer,Deposit,2025-06-13 22:35:31,2025-06-13 22:35:32,To Instant Access Savings,2.00,0.00,EUR,COMPLETED,99832.04
Transfer,Deposit,2025-06-13 23:22:45,2025-06-13 23:22:45,To Instant Access Savings,4.50,0.00,EUR,COMPLETED,99836.54
Transfer,Deposit,2025-06-14 00:43:04,2025-06-14 00:43:04,To Instant Access Savings,3.00,0.00,EUR,COMPLETED,99839.54
Interest,Deposit,2025-06-14 02:00:53,2025-06-14 02:00:53,Interest earned - Instant Access Savings,5.03,1.66,EUR,COMPLETED,99842.91
Transfer,Deposit,2025-06-14 15:03:44,2025-06-14 15:03:44,To Instant Access Savings,0.35,0.00,EUR,COMPLETED,99843.26
Transfer,Deposit,2025-06-14 18:59:13,2025-06-14 18:59:13,To Instant Access Savings,2.70,0.00,EUR,COMPLETED,99845.96
Interest,Deposit,2025-06-15 02:04:32,2025-06-15 02:04:32,Interest earned - Instant Access Savings,5.04,1.66,EUR,COMPLETED,99849.34
Transfer,Deposit,2025-06-15 11:55:36,2025-06-15 11:55:36,To Instant Access Savings,0.25,0.00,EUR,COMPLETED,99849.59
Transfer,Deposit,2025-06-15 12:09:00,2025-06-15 12:09:00,To Instant Access Savings,0.80,0.00,EUR,COMPLETED,99850.39
Transfer,Deposit,2025-06-15 12:19:23,2025-06-15 12:19:24,To Instant Access Savings,5.00,0.00,EUR,COMPLETED,99855.39
Interest,Deposit,2025-06-16 02:02:56,2025-06-16 02:02:56,Interest earned - Instant Access Savings,5.03,1.66,EUR,COMPLETED,99858.76
Transfer,Deposit,2025-06-16 09:11:07,2025-06-16 09:11:08,To Instant Access Savings,2.75,0.00,EUR,COMPLETED,99861.51
Transfer,Deposit,2025-06-16 09:11:52,2025-06-16 09:11:52,To Instant Access Savings,5.00,0.00,EUR,COMPLETED,99866.51
Transfer,Deposit,2025-06-16 09:51:45,2025-06-16 09:51:45,To Instant Access Savings,0.75,0.00,EUR,COMPLETED,99867.26
Transfer,Deposit,2025-06-16 11:34:49,2025-06-16 11:34:49,To Instant Access Savings,4.50,0.00,EUR,COMPLETED,99871.76
Transfer,Deposit,2025-06-16 15:05:21,2025-06-16 15:05:22,From Instant Access Savings,-200.00,0.00,EUR,COMPLETED,99671.76
Transfer,Deposit,2025-06-16 19:26:34,2025-06-16 19:26:35,To Instant Access Savings,4.05,0.00,EUR,COMPLETED,99675.81
Interest,Deposit,2025-06-17 02:01:59,2025-06-17 02:01:59,Interest earned - Instant Access Savings,5.02,1.66,EUR,COMPLETED,99679.17
Interest,Deposit,2025-06-18 02:03:44,2025-06-18 02:03:44,Interest earned - Instant Access Savings,5.03,1.66,EUR,COMPLETED,99682.54
Transfer,Deposit,2025-06-18 20:34:11,2025-06-18 20:34:11,To Instant Access Savings,3.95,0.00,EUR,COMPLETED,99686.49
Transfer,Deposit,2025-06-18 20:47:24,2025-06-18 20:47:24,To Instant Access Savings,1.60,0.00,EUR,COMPLETED,99688.09
Interest,Deposit,2025-06-19 02:01:21,2025-06-19 02:01:21,Interest earned - Instant Access Savings,5.02,1.66,EUR,COMPLETED,99691.45
Transfer,Deposit,2025-06-19 11:05:53,2025-06-19 11:05:53,To Instant Access Savings,3.00,0.00,EUR,COMPLETED,99694.45
Transfer,Deposit,2025-06-19 12:16:11,2025-06-19 12:16:11,To Instant Access Savings,5.00,0.00,EUR,COMPLETED,99699.45
Transfer,Deposit,2025-06-19 13:14:57,2025-06-19 13:14:58,To Instant Access Savings,2.60,0.00,EUR,COMPLETED,99702.05
Transfer,Deposit,2025-06-19 19:15:12,2025-06-19 19:15:12,From Instant Access Savings,-100.00,0.00,EUR,COMPLETED,99602.05
Transfer,Deposit,2025-06-19 19:16:22,2025-06-19 19:16:22,To Instant Access Savings,5.00,0.00,EUR,COMPLETED,99607.05
Transfer,Deposit,2025-06-19 19:34:26,2025-06-19 19:34:27,To Instant Access Savings,4.35,0.00,EUR,COMPLETED,99611.40
Interest,Deposit,2025-06-20 02:01:20,2025-06-20 02:01:20,Interest earned - Instant Access Savings,5.03,1.66,EUR,COMPLETED,99614.77
Transfer,Deposit,2025-06-20 16:43:07,2025-06-20 16:43:07,To Instant Access Savings,5.00,0.00,EUR,COMPLETED,99619.77
Interest,Deposit,2025-06-21 02:03:17,2025-06-21 02:03:17,Interest earned - Instant Access Savings,5.02,1.65,EUR,COMPLETED,99623.14
Transfer,Deposit,2025-06-21 12:14:53,2025-06-21 12:14:53,To Instant Access Savings,5.00,0.00,EUR,COMPLETED,99628.14
Transfer,Deposit,2025-06-21 12:57:05,2025-06-21 12:57:05,To Instant Access Savings,2.00,0.00,EUR,COMPLETED,99630.14
Interest,Deposit,2025-06-22 02:02:27,2025-06-22 02:02:27,Interest earned - Instant Access Savings,5.02,1.66,EUR,COMPLETED,99633.50
Transfer,Deposit,2025-06-22 09:43:52,2025-06-22 09:43:52,To Instant Access Savings,5.00,0.00,EUR,COMPLETED,99638.50
Interest,Deposit,2025-06-23 02:04:04,2025-06-23 02:04:04,Interest earned - Instant Access Savings,5.02,1.66,EUR,COMPLETED,99641.86
Transfer,Deposit,2025-06-23 08:53:19,2025-06-23 08:53:19,To Instant Access Savings,2.75,0.00,EUR,COMPLETED,99644.61
Transfer,Deposit,2025-06-23 17:29:29,2025-06-23 17:29:29,To Instant Access Savings,5.00,0.00,EUR,COMPLETED,99649.61
Interest,Deposit,2025-06-24 02:03:24,2025-06-24 02:03:24,Interest earned - Instant Access Savings,5.03,1.65,EUR,COMPLETED,99652.99
Interest,Deposit,2025-06-25 02:01:37,2025-06-25 02:01:37,Interest earned - Instant Access Savings,5.02,1.66,EUR,COMPLETED,99656.35
Transfer,Deposit,2025-06-25 03:00:52,2025-06-25 03:00:52,To Instant Access Savings,5.00,0.00,EUR,COMPLETED,99661.35
Transfer,Deposit,2025-06-25 08:40:38,2025-06-25 08:40:38,To Instant Access Savings,0.25,0.00,EUR,COMPLETED,99661.60
Transfer,Deposit,2025-06-25 11:55:23,2025-06-25 11:55:23,To Instant Access Savings,3.75,0.00,EUR,COMPLETED,99665.35
Transfer,Deposit,2025-06-25 18:04:29,2025-06-25 18:04:29,To Instant Access Savings,3.75,0.00,EUR,COMPLETED,99669.10
Interest,Deposit,2025-06-26 02:04:16,2025-06-26 02:04:16,Interest earned - Instant Access Savings,5.02,1.66,EUR,COMPLETED,99672.46
Transfer,Deposit,2025-06-26 18:43:19,2025-06-26 18:43:19,To Instant Access Savings,0.35,0.00,EUR,COMPLETED,99672.81
Transfer,Deposit,2025-06-26 20:19:02,2025-06-26 20:19:02,To Instant Access Savings,5.00,0.00,EUR,COMPLETED,99677.81
Transfer,Deposit,2025-06-26 21:29:57,2025-06-26 21:29:57,To Instant Access Savings,1.55,0.00,EUR,COMPLETED,99679.36
Interest,Deposit,2025-06-27 02:04:05,2025-06-27 02:04:05,Interest earned - Instant Access Savings,5.03,1.66,EUR,COMPLETED,99682.73
Transfer,Deposit,2025-06-27 08:48:56,2025-06-27 08:48:56,To Instant Access Savings,1.00,0.00,EUR,COMPLETED,99683.73
Transfer,Deposit,2025-06-27 09:20:11,2025-06-27 09:20:11,To Instant Access Savings,1.80,0.00,EUR,COMPLETED,99685.53
Transfer,Deposit,2025-06-27 18:57:25,2025-06-27 18:57:25,To Instant Access Savings,2.65,0.00,EUR,COMPLETED,99688.18
Transfer,Deposit,2025-06-27 19:40:37,2025-06-27 19:40:37,To Instant Access Savings,2.40,0.00,EUR,COMPLETED,99690.58
Transfer,Deposit,2025-06-28 00:35:41,2025-06-28 00:35:41,To Instant Access Savings,0.05,0.00,EUR,COMPLETED,99690.63
Interest,Deposit,2025-06-28 02:02:37,2025-06-28 02:02:37,Interest earned - Instant Access Savings,5.03,1.66,EUR,COMPLETED,99694.00
Transfer,Deposit,2025-06-28 10:25:03,2025-06-28 10:25:03,To Instant Access Savings,4.50,0.00,EUR,COMPLETED,99698.50
Transfer,Deposit,2025-06-28 13:53:32,2025-06-28 13:53:32,To Instant Access Savings,3.60,0.00,EUR,COMPLETED,99702.10
Interest,Deposit,2025-06-29 02:03:28,2025-06-29 02:03:28,Interest earned - Instant Access Savings,5.02,1.65,EUR,COMPLETED,99705.47
Transfer,Deposit,2025-06-29 12:55:19,2025-06-29 12:55:19,To Instant Access Savings,2.80,0.00,EUR,COMPLETED,99708.27
Transfer,Deposit,2025-06-29 16:53:19,2025-06-29 16:53:19,To Instant Access Savings,5.00,0.00,EUR,COMPLETED,99713.27
Interest,Deposit,2025-06-30 02:04:46,2025-06-30 02:04:46,Interest earned - Instant Access Savings,5.03,1.66,EUR,COMPLETED,99716.64
Transfer,Deposit,2025-06-30 12:06:30,2025-06-30 12:06:30,From Instant Access Savings,-1590.00,0.00,EUR,COMPLETED,98126.64
Transfer,Deposit,2025-06-30 14:31:49,2025-06-30 14:31:49,To Instant Access Savings,0.05,0.00,EUR,COMPLETED,98126.69
Interest,Deposit,2025-07-01 02:04:34,2025-07-01 02:04:34,Interest earned - Instant Access Savings,4.94,1.63,EUR,COMPLETED,98130.00
Transfer,Deposit,2025-07-01 13:04:39,2025-07-01 13:04:39,From Instant Access Savings,-380.00,0.00,EUR,COMPLETED,97750.00
Transfer,Deposit,2025-07-01 16:37:59,2025-07-01 16:38:00,To Instant Access Savings,0.05,0.00,EUR,COMPLETED,97750.05
Transfer,Deposit,2025-07-01 17:56:34,2025-07-01 17:56:34,To Instant Access Savings,0.60,0.00,EUR,COMPLETED,97750.65
Transfer,Deposit,2025-07-01 20:52:29,2025-07-01 20:52:29,To Instant Access Savings,5.00,0.00,EUR,COMPLETED,97755.65
Interest,Deposit,2025-07-02 02:04:46,2025-07-02 02:04:46,Interest earned - Instant Access Savings,4.93,1.63,EUR,COMPLETED,97758.95
Transfer,Deposit,2025-07-02 09:07:34,2025-07-02 09:07:34,To Instant Access Savings,2.70,0.00,EUR,COMPLETED,97761.65
Transfer,Deposit,2025-07-02 12:06:26,2025-07-02 12:06:26,To Instant Access Savings,1.05,0.00,EUR,COMPLETED,97762.70
Transfer,Deposit,2025-07-02 13:37:17,2025-07-02 13:37:17,To Instant Access Savings,1.45,0.00,EUR,COMPLETED,97764.15
Transfer,Deposit,2025-07-02 20:59:19,2025-07-02 20:59:19,To Instant Access Savings,0.05,0.00,EUR,COMPLETED,97764.20
Interest,Deposit,2025-07-03 02:03:43,2025-07-03 02:03:43,Interest earned - Instant Access Savings,4.93,1.63,EUR,COMPLETED,97767.50
Transfer,Deposit,2025-07-03 08:54:41,2025-07-03 08:54:41,To Instant Access Savings,1.50,0.00,EUR,COMPLETED,97769.00
Transfer,Deposit,2025-07-03 10:28:37,2025-07-03 10:28:37,From Instant Access Savings,-500.00,0.00,EUR,COMPLETED,97269.00
Transfer,Deposit,2025-07-03 12:43:23,2025-07-03 12:43:23,To Instant Access Savings,4.30,0.00,EUR,COMPLETED,97273.30
Transfer,Deposit,2025-07-03 17:04:31,2025-07-03 17:04:31,To Instant Access Savings,5.00,0.00,EUR,COMPLETED,97278.30
Transfer,Deposit,2025-07-03 18:48:00,2025-07-03 18:48:00,To Instant Access Savings,0.80,0.00,EUR,COMPLETED,97279.10
Interest,Deposit,2025-07-04 02:02:31,2025-07-04 02:02:31,Interest earned - Instant Access Savings,4.90,1.62,EUR,COMPLETED,97282.38
Transfer,Deposit,2025-07-04 08:18:18,2025-07-04 08:18:18,To Instant Access Savings,0.50,0.00,EUR,COMPLETED,97282.88
Transfer,Deposit,2025-07-04 08:32:53,2025-07-04 08:32:53,To Instant Access Savings,1.40,0.00,EUR,COMPLETED,97284.28
Transfer,Deposit,2025-07-04 10:11:48,2025-07-04 10:11:49,To Instant Access Savings,0.05,0.00,EUR,COMPLETED,97284.33
Exchange,Deposit,2025-07-04 11:11:30,2025-07-04 11:11:30,Exchanged to EUR,0.05,0.00,EUR,COMPLETED,97284.38
Transfer,Deposit,2025-07-04 12:19:03,2025-07-04 12:19:03,To Instant Access Savings,5.00,0.00,EUR,COMPLETED,97289.38
Transfer,Deposit,2025-07-04 12:47:40,2025-07-04 12:47:40,To Instant Access Savings,2.25,0.00,EUR,COMPLETED,97291.63
Transfer,Deposit,2025-07-04 14:44:29,2025-07-04 14:44:29,To Instant Access Savings,5.00,0.00,EUR,COMPLETED,97296.63
Interest,Deposit,2025-07-05 02:06:12,2025-07-05 02:06:12,Interest earned - Instant Access Savings,4.91,1.62,EUR,COMPLETED,97299.92
Transfer,Deposit,2025-07-05 16:22:12,2025-07-05 16:22:12,To Instant Access Savings,0.05,0.00,EUR,COMPLETED,97299.97
Transfer,Deposit,2025-07-05 17:12:31,2025-07-05 17:12:31,To Instant Access Savings,4.85,0.00,EUR,COMPLETED,97304.82
Transfer,Deposit,2025-07-05 21:18:12,2025-07-05 21:18:12,To Instant Access Savings,0.05,0.00,EUR,COMPLETED,97304.87
Interest,Deposit,2025-07-06 02:02:14,2025-07-06 02:02:14,Interest earned - Instant Access Savings,4.90,1.61,EUR,COMPLETED,97308.16
Transfer,Deposit,2025-07-06 09:29:20,2025-07-06 09:29:20,To Instant Access Savings,2.00,0.00,EUR,COMPLETED,97310.16
Transfer,Deposit,2025-07-06 10:55:18,2025-07-06 10:55:18,To Instant Access Savings,0.05,0.00,EUR,COMPLETED,97310.21
Transfer,Deposit,2025-07-06 11:31:02,2025-07-06 11:31:02,To Instant Access Savings,3.75,0.00,EUR,COMPLETED,97313.96
Interest,Deposit,2025-07-07 02:03:35,2025-07-07 02:03:35,Interest earned - Instant Access Savings,4.91,1.62,EUR,COMPLETED,97317.25
Transfer,Deposit,2025-07-07 14:54:02,2025-07-07 14:54:02,To Instant Access Savings,5.00,0.00,EUR,COMPLETED,97322.25
Transfer,Deposit,2025-07-07 18:25:33,2025-07-07 18:25:33,To Instant Access Savings,1.75,0.00,EUR,COMPLETED,97324.00
Interest,Deposit,2025-07-08 02:04:11,2025-07-08 02:04:11,Interest earned - Instant Access Savings,4.91,1.62,EUR,COMPLETED,97327.29
Transfer,Deposit,2025-07-08 08:50:18,2025-07-08 08:50:18,To Instant Access Savings,2.75,0.00,EUR,COMPLETED,97330.04
Interest,Deposit,2025-07-09 02:01:34,2025-07-09 02:01:34,Interest earned - Instant Access Savings,4.90,1.62,EUR,COMPLETED,97333.32
Transfer,Deposit,2025-07-09 08:21:57,2025-07-09 08:21:57,To Instant Access Savings,3.45,0.00,EUR,COMPLETED,97336.77
Transfer,Deposit,2025-07-09 12:49:27,2025-07-09 12:49:27,To Instant Access Savings,3.75,0.00,EUR,COMPLETED,97340.52
Transfer,Deposit,2025-07-09 13:41:25,2025-07-09 13:41:26,To Instant Access Savings,5.00,0.00,EUR,COMPLETED,97345.52
Interest,Deposit,2025-07-10 02:03:10,2025-07-10 02:03:10,Interest earned - Instant Access Savings,4.91,1.62,EUR,COMPLETED,97348.81
Transfer,Deposit,2025-07-10 08:37:34,2025-07-10 08:37:35,To Instant Access Savings,4.00,0.00,EUR,COMPLETED,97352.81
Transfer,Deposit,2025-07-10 12:32:12,2025-07-10 12:32:12,To Instant Access Savings,5.00,0.00,EUR,COMPLETED,97357.81
Transfer,Deposit,2025-07-10 12:38:41,2025-07-10 12:38:41,To Instant Access Savings,1.25,0.00,EUR,COMPLETED,97359.06
Transfer,Deposit,2025-07-10 18:43:15,2025-07-10 18:43:15,To Instant Access Savings,0.05,0.00,EUR,COMPLETED,97359.11
Interest,Deposit,2025-07-11 02:03:19,2025-07-11 02:03:19,Interest earned - Instant Access Savings,4.91,1.62,EUR,COMPLETED,97362.40
Transfer,Deposit,2025-07-11 09:13:26,2025-07-11 09:13:26,To Instant Access Savings,4.10,0.00,EUR,COMPLETED,97366.50
Transfer,Deposit,2025-07-11 20:33:10,2025-07-11 20:33:10,To Instant Access Savings,5.00,0.00,EUR,COMPLETED,97371.50
Interest,Deposit,2025-07-12 02:02:38,2025-07-12 02:02:38,Interest earned - Instant Access Savings,4.91,1.62,EUR,COMPLETED,97374.79
Transfer,Deposit,2025-07-12 11:46:29,2025-07-12 11:46:29,To Instant Access Savings,5.00,0.00,EUR,COMPLETED,97379.79
Transfer,Deposit,2025-07-12 11:59:27,2025-07-12 11:59:27,To Instant Access Savings,5.00,0.00,EUR,COMPLETED,97384.79
Transfer,Deposit,2025-07-12 12:12:51,2025-07-12 12:12:52,To Instant Access Savings,0.50,0.00,EUR,COMPLETED,97385.29
Transfer,Deposit,2025-07-12 12:28:53,2025-07-12 12:28:53,To Instant Access Savings,0.50,0.00,EUR,COMPLETED,97385.79
Transfer,Deposit,2025-07-12 12:45:25,2025-07-12 12:45:26,To Instant Access Savings,0.75,0.00,EUR,COMPLETED,97386.54
Transfer,Deposit,2025-07-12 13:28:11,2025-07-12 13:28:11,To Instant Access Savings,5.00,0.00,EUR,COMPLETED,97391.54
Transfer,Deposit,2025-07-12 13:35:33,2025-07-12 13:35:33,To Instant Access Savings,3.55,0.00,EUR,COMPLETED,97395.09
Transfer,Deposit,2025-07-12 13:42:55,2025-07-12 13:42:55,To Instant Access Savings,5.00,0.00,EUR,COMPLETED,97400.09
Transfer,Deposit,2025-07-12 13:44:03,2025-07-12 13:44:03,To Instant Access Savings,5.00,0.00,EUR,COMPLETED,97405.09
Transfer,Deposit,2025-07-12 19:33:54,2025-07-12 19:33:54,To Instant Access Savings,3.00,0.00,EUR,COMPLETED,97408.09
Interest,Deposit,2025-07-13 02:05:27,2025-07-13 02:05:27,Interest earned - Instant Access Savings,4.91,1.62,EUR,COMPLETED,97411.38
Transfer,Deposit,2025-07-13 09:08:12,2025-07-13 09:08:13,To Instant Access Savings,5.00,0.00,EUR,COMPLETED,97416.38
Transfer,Deposit,2025-07-13 10:10:46,2025-07-13 10:10:46,To Instant Access Savings,0.25,0.00,EUR,COMPLETED,97416.63
Transfer,Deposit,2025-07-13 10:37:20,2025-07-13 10:37:21,To Instant Access Savings,4.50,0.00,EUR,COMPLETED,97421.13
Transfer,Deposit,2025-07-13 10:42:09,2025-07-13 10:42:09,To Instant Access Savings,3.50,0.00,EUR,COMPLETED,97424.63
Transfer,Deposit,2025-07-13 14:58:33,2025-07-13 14:58:33,To Instant Access Savings,0.55,0.00,EUR,COMPLETED,97425.18
Transfer,Deposit,2025-07-13 17:42:21,2025-07-13 17:42:21,To Instant Access Savings,1.25,0.00,EUR,COMPLETED,97426.43
Interest,Deposit,2025-07-14 02:01:21,2025-07-14 02:01:21,Interest earned - Instant Access Savings,4.64,1.53,EUR,COMPLETED,97429.54
Transfer,Deposit,2025-07-14 14:12:36,2025-07-14 14:12:36,To Instant Access Savings,4.50,0.00,EUR,COMPLETED,97434.04
Transfer,Deposit,2025-07-14 20:06:02,2025-07-14 20:06:03,To Instant Access Savings,0.05,0.00,EUR,COMPLETED,97434.09
Transfer,Deposit,2025-07-14 21:01:43,2025-07-14 21:01:44,To Instant Access Savings,3.35,0.00,EUR,COMPLETED,97437.44
Interest,Deposit,2025-07-15 02:04:01,2025-07-15 02:04:01,Interest earned - Instant Access Savings,4.65,1.54,EUR,COMPLETED,97440.55
Transfer,Deposit,2025-07-15 12:29:46,2025-07-15 12:29:46,To Instant Access Savings,2.10,0.00,EUR,COMPLETED,97442.65
Interest,Deposit,2025-07-16 02:05:03,2025-07-16 02:05:03,Interest earned - Instant Access Savings,4.64,1.53,EUR,COMPLETED,97445.76
Transfer,Deposit,2025-07-16 14:38:45,2025-07-16 14:38:45,To Instant Access Savings,2.50,0.00,EUR,COMPLETED,97448.26
Transfer,Deposit,2025-07-16 16:43:09,2025-07-16 16:43:10,To Instant Access Savings,0.75,0.00,EUR,COMPLETED,97449.01
Transfer,Deposit,2025-07-16 18:24:55,2025-07-16 18:24:55,To Instant Access Savings,0.05,0.00,EUR,COMPLETED,97449.06
Transfer,Deposit,2025-07-16 20:16:31,2025-07-16 20:16:31,To Instant Access Savings,4.50,0.00,EUR,COMPLETED,97453.56
Transfer,Deposit,2025-07-16 20:19:44,2025-07-16 20:19:44,To Instant Access Savings,0.50,0.00,EUR,COMPLETED,97454.06
Transfer,Deposit,2025-07-16 21:47:53,2025-07-16 21:47:53,To Instant Access Savings,4.10,0.00,EUR,COMPLETED,97458.16
Interest,Deposit,2025-07-17 02:05:40,2025-07-17 02:05:40,Interest earned - Instant Access Savings,4.65,1.53,EUR,COMPLETED,97461.28
Interest,Deposit,2025-07-18 02:04:28,2025-07-18 02:04:28,Interest earned - Instant Access Savings,4.64,1.53,EUR,COMPLETED,97464.39
Transfer,Deposit,2025-07-18 13:28:21,2025-07-18 13:28:22,To Instant Access Savings,4.75,0.00,EUR,COMPLETED,97469.14
Transfer,Deposit,2025-07-18 15:01:39,2025-07-18 15:01:39,To Instant Access Savings,1.50,0.00,EUR,COMPLETED,97470.64
Transfer,Deposit,2025-07-18 15:20:39,2025-07-18 15:20:39,To Instant Access Savings,1.00,0.00,EUR,COMPLETED,97471.64
Transfer,Deposit,2025-07-18 16:07:15,2025-07-18 16:07:15,To Instant Access Savings,1.50,0.00,EUR,COMPLETED,97473.14
Transfer,Deposit,2025-07-18 18:02:42,2025-07-18 18:02:42,To Instant Access Savings,2.10,0.00,EUR,COMPLETED,97475.24
Transfer,Deposit,2025-07-18 20:24:13,2025-07-18 20:24:13,To Instant Access Savings,2.50,0.00,EUR,COMPLETED,97477.74
Transfer,Deposit,2025-07-18 20:30:42,2025-07-18 20:30:43,To Instant Access Savings,2.00,0.00,EUR,COMPLETED,97479.74
Interest,Deposit,2025-07-19 02:03:53,2025-07-19 02:03:53,Interest earned - Instant Access Savings,4.65,1.54,EUR,COMPLETED,97482.85
Transfer,Deposit,2025-07-19 18:20:32,2025-07-19 18:20:32,To Instant Access Savings,5.00,0.00,EUR,COMPLETED,97487.85
Transfer,Deposit,2025-07-19 18:35:37,2025-07-19 18:35:37,From Instant Access Savings,-250.00,0.00,EUR,COMPLETED,97237.85
Transfer,Deposit,2025-07-19 18:35:51,2025-07-19 18:35:51,To Instant Access Savings,4.70,0.00,EUR,COMPLETED,97242.55
Transfer,Deposit,2025-07-19 21:20:27,2025-07-19 21:20:28,To Instant Access Savings,4.55,0.00,EUR,COMPLETED,97247.10
Interest,Deposit,2025-07-20 02:03:15,2025-07-20 02:03:15,Interest earned - Instant Access Savings,4.64,1.53,EUR,COMPLETED,97250.21
Transfer,Deposit,2025-07-20 12:22:40,2025-07-20 12:22:40,To Instant Access Savings,0.10,0.00,EUR,COMPLETED,97250.31
Transfer,Deposit,2025-07-20 14:12:26,2025-07-20 14:12:26,To Instant Access Savings,0.25,0.00,EUR,COMPLETED,97250.56
Transfer,Deposit,2025-07-20 14:41:15,2025-07-20 14:41:15,To Instant Access Savings,4.00,0.00,EUR,COMPLETED,97254.56
Transfer,Deposit,2025-07-20 19:06:28,2025-07-20 19:06:28,To Instant Access Savings,3.00,0.00,EUR,COMPLETED,97257.56
Transfer,Deposit,2025-07-20 22:00:39,2025-07-20 22:00:39,To Instant Access Savings,2.55,0.00,EUR,COMPLETED,97260.11
Interest,Deposit,2025-07-21 02:04:03,2025-07-21 02:04:03,Interest earned - Instant Access Savings,4.63,1.53,EUR,COMPLETED,97263.21
Transfer,Deposit,2025-07-21 08:07:06,2025-07-21 08:07:06,To Instant Access Savings,3.50,0.00,EUR,COMPLETED,97266.71
Transfer,Deposit,2025-07-21 09:51:04,2025-07-21 09:51:05,To Instant Access Savings,3.75,0.00,EUR,COMPLETED,97270.46
Transfer,Deposit,2025-07-21 12:37:16,2025-07-21 12:37:16,To Instant Access Savings,5.00,0.00,EUR,COMPLETED,97275.46
Interest,Deposit,2025-07-22 02:01:58,2025-07-22 02:01:58,Interest earned - Instant Access Savings,4.64,1.53,EUR,COMPLETED,97278.57
Transfer,Deposit,2025-07-22 11:28:42,2025-07-22 11:28:42,To Instant Access Savings,0.05,0.00,EUR,COMPLETED,97278.62
Interest,Deposit,2025-07-23 02:03:47,2025-07-23 02:03:47,Interest earned - Instant Access Savings,4.64,1.53,EUR,COMPLETED,97281.73
Transfer,Deposit,2025-07-23 12:38:11,2025-07-23 12:38:11,To Instant Access Savings,3.75,0.00,EUR,COMPLETED,97285.48
Transfer,Deposit,2025-07-23 15:17:32,2025-07-23 15:17:32,From Instant Access Savings,-2349.03,0.00,EUR,COMPLETED,94936.45
Transfer,Deposit,2025-07-23 15:17:45,2025-07-23 15:17:45,From Instant Access Savings,-50.00,0.00,EUR,COMPLETED,94886.45
Transfer,Deposit,2025-07-23 15:18:03,2025-07-23 15:18:03,To Instant Access Savings,0.50,0.00,EUR,COMPLETED,94886.95
Transfer,Deposit,2025-07-23 17:29:03,2025-07-23 17:29:03,To Instant Access Savings,5.00,0.00,EUR,COMPLETED,94891.95
Transfer,Deposit,2025-07-23 20:31:59,2025-07-23 20:31:59,To Instant Access Savings,0.50,0.00,EUR,COMPLETED,94892.45
Transfer,Deposit,2025-07-24 00:02:06,2025-07-24 00:02:06,To Instant Access Savings,4.75,0.00,EUR,COMPLETED,94897.20
Interest,Deposit,2025-07-24 02:05:14,2025-07-24 02:05:14,Interest earned - Instant Access Savings,4.52,1.49,EUR,COMPLETED,94900.23
Transfer,Deposit,2025-07-24 08:53:06,2025-07-24 08:53:06,From Instant Access Savings,-50.00,0.00,EUR,COMPLETED,94850.23
Transfer,Deposit,2025-07-24 12:47:46,2025-07-24 12:47:46,To Instant Access Savings,2.00,0.00,EUR,COMPLETED,94852.23
Interest,Deposit,2025-07-25 02:04:15,2025-07-25 02:04:15,Interest earned - Instant Access Savings,4.52,1.49,EUR,COMPLETED,94855.26
Transfer,Deposit,2025-07-25 03:00:18,2025-07-25 03:00:19,To Instant Access Savings,5.00,0.00,EUR,COMPLETED,94860.26
Transfer,Deposit,2025-07-25 13:08:13,2025-07-25 13:08:13,To Instant Access Savings,2.75,0.00,EUR,COMPLETED,94863.01
Transfer,Deposit,2025-07-25 13:27:08,2025-07-25 13:27:08,To Instant Access Savings,4.25,0.00,EUR,COMPLETED,94867.26
Transfer,Deposit,2025-07-25 18:57:50,2025-07-25 18:57:50,To Instant Access Savings,1.00,0.00,EUR,COMPLETED,94868.26
Transfer,Deposit,2025-07-25 21:25:37,2025-07-25 21:25:37,To Instant Access Savings,3.00,0.00,EUR,COMPLETED,94871.26
Transfer,Deposit,2025-07-25 22:58:10,2025-07-25 22:58:10,To Instant Access Savings,5.00,0.00,EUR,COMPLETED,94876.26
Transfer,Deposit,2025-07-26 00:26:43,2025-07-26 00:26:44,To Instant Access Savings,5.00,0.00,EUR,COMPLETED,94881.26
Transfer,Deposit,2025-07-26 01:02:15,2025-07-26 01:02:15,To Instant Access Savings,2.00,0.00,EUR,COMPLETED,94883.26
Interest,Deposit,2025-07-26 02:04:29,2025-07-26 02:04:29,Interest earned - Instant Access Savings,4.53,1.50,EUR,COMPLETED,94886.29
Transfer,Deposit,2025-07-26 10:34:23,2025-07-26 10:34:23,To Instant Access Savings,4.25,0.00,EUR,COMPLETED,94890.54
Transfer,Deposit,2025-07-26 15:29:51,2025-07-26 15:29:51,To Instant Access Savings,0.45,0.00,EUR,COMPLETED,94890.99
Transfer,Deposit,2025-07-26 19:46:02,2025-07-26 19:46:02,To Instant Access Savings,4.45,0.00,EUR,COMPLETED,94895.44
Interest,Deposit,2025-07-27 02:03:31,2025-07-27 02:03:31,Interest earned - Instant Access Savings,4.52,1.49,EUR,COMPLETED,94898.47
Transfer,Deposit,2025-07-27 15:32:34,2025-07-27 15:32:34,To Instant Access Savings,4.00,0.00,EUR,COMPLETED,94902.47
Transfer,Deposit,2025-07-28 00:35:25,2025-07-28 00:35:25,To Instant Access Savings,0.05,0.00,EUR,COMPLETED,94902.52
Interest,Deposit,2025-07-28 02:03:45,2025-07-28 02:03:45,Interest earned - Instant Access Savings,4.52,1.49,EUR,COMPLETED,94905.55
Transfer,Deposit,2025-07-28 18:43:00,2025-07-28 18:43:00,To Instant Access Savings,4.75,0.00,EUR,COMPLETED,94910.30
Transfer,Deposit,2025-07-28 19:44:16,2025-07-28 19:44:16,To Instant Access Savings,2.05,0.00,EUR,COMPLETED,94912.35
Interest,Deposit,2025-07-29 02:04:09,2025-07-29 02:04:09,Interest earned - Instant Access Savings,4.53,1.50,EUR,COMPLETED,94915.38
Transfer,Deposit,2025-07-29 08:27:51,2025-07-29 08:27:51,To Instant Access Savings,5.00,0.00,EUR,COMPLETED,94920.38
Transfer,Deposit,2025-07-29 11:47:30,2025-07-29 11:47:31,To Instant Access Savings,1.25,0.00,EUR,COMPLETED,94921.63
Transfer,Deposit,2025-07-29 16:25:31,2025-07-29 16:25:31,To Instant Access Savings,5.00,0.00,EUR,COMPLETED,94926.63
Transfer,Deposit,2025-07-29 16:33:04,2025-07-29 16:33:04,To Instant Access Savings,5.00,0.00,EUR,COMPLETED,94931.63
Interest,Deposit,2025-07-30 02:04:53,2025-07-30 02:04:53,Interest earned - Instant Access Savings,4.53,1.49,EUR,COMPLETED,94934.67
Transfer,Deposit,2025-07-30 08:31:52,2025-07-30 08:31:53,To Instant Access Savings,2.75,0.00,EUR,COMPLETED,94937.42
Transfer,Deposit,2025-07-30 10:26:54,2025-07-30 10:26:55,From Instant Access Savings,-50.00,0.00,EUR,COMPLETED,94887.42
Transfer,Deposit,2025-07-30 12:28:45,2025-07-30 12:28:45,To Instant Access Savings,0.50,0.00,EUR,COMPLETED,94887.92
Interest,Deposit,2025-07-31 02:01:59,2025-07-31 02:01:59,Interest earned - Instant Access Savings,4.52,1.49,EUR,COMPLETED,94890.95
Transfer,Deposit,2025-07-31 08:52:31,2025-07-31 08:52:32,To Instant Access Savings,2.75,0.00,EUR,COMPLETED,94893.70
Transfer,Deposit,2025-07-31 12:15:59,2025-07-31 12:16:00,To Instant Access Savings,5.00,0.00,EUR,COMPLETED,94898.70
Interest,Deposit,2025-08-01 02:01:48,2025-08-01 02:01:48,Interest earned - Instant Access Savings,4.52,1.49,EUR,COMPLETED,94901.73
Transfer,Deposit,2025-08-01 11:43:51,2025-08-01 11:43:52,From Instant Access Savings,-100.00,0.00,EUR,COMPLETED,94801.73
Transfer,Deposit,2025-08-01 12:26:35,2025-08-01 12:26:35,To Instant Access Savings,5.00,0.00,EUR,COMPLETED,94806.73
Transfer,Deposit,2025-08-01 21:36:20,2025-08-01 21:36:21,To Instant Access Savings,1.05,0.00,EUR,COMPLETED,94807.78
Interest,Deposit,2025-08-02 02:04:57,2025-08-02 02:04:57,Interest earned - Instant Access Savings,4.52,1.50,EUR,COMPLETED,94810.80
Transfer,Deposit,2025-08-02 12:43:20,2025-08-02 12:43:20,To Instant Access Savings,0.85,0.00,EUR,COMPLETED,94811.65
Transfer,Deposit,2025-08-02 14:47:05,2025-08-02 14:47:05,To Instant Access Savings,5.00,0.00,EUR,COMPLETED,94816.65
Transfer,Deposit,2025-08-02 20:59:18,2025-08-02 20:59:18,To Instant Access Savings,0.05,0.00,EUR,COMPLETED,94816.70
Interest,Deposit,2025-08-03 02:04:06,2025-08-03 02:04:06,Interest earned - Instant Access Savings,4.52,1.49,EUR,COMPLETED,94819.73
Transfer,Deposit,2025-08-03 10:55:18,2025-08-03 10:55:18,To Instant Access Savings,0.05,0.00,EUR,COMPLETED,94819.78
Transfer,Deposit,2025-08-03 13:48:49,2025-08-03 13:48:49,To Instant Access Savings,3.50,0.00,EUR,COMPLETED,94823.28
Transfer,Deposit,2025-08-03 14:48:16,2025-08-03 14:48:16,To Instant Access Savings,1.50,0.00,EUR,COMPLETED,94824.78
Transfer,Deposit,2025-08-03 18:03:52,2025-08-03 18:03:52,From Instant Access Savings,-100.00,0.00,EUR,COMPLETED,94724.78
Transfer,Deposit,2025-08-03 18:59:44,2025-08-03 18:59:44,To Instant Access Savings,3.25,0.00,EUR,COMPLETED,94728.03
Interest,Deposit,2025-08-04 02:02:40,2025-08-04 02:02:40,Interest earned - Instant Access Savings,4.52,1.49,EUR,COMPLETED,94731.06
Transfer,Deposit,2025-08-04 10:11:48,2025-08-04 10:11:49,To Instant Access Savings,0.05,0.00,EUR,COMPLETED,94731.11
Transfer,Deposit,2025-08-04 11:01:58,2025-08-04 11:01:58,To Instant Access Savings,3.05,0.00,EUR,COMPLETED,94734.16
Transfer,Deposit,2025-08-04 11:07:56,2025-08-04 11:07:56,To Instant Access Savings,5.00,0.00,EUR,COMPLETED,94739.16
Transfer,Deposit,2025-08-04 15:36:47,2025-08-04 15:36:47,To Instant Access Savings,5.00,0.00,EUR,COMPLETED,94744.16
Exchange,Deposit,2025-08-04 16:02:40,2025-08-04 16:02:41,Exchanged to EUR,0.68,0.00,EUR,COMPLETED,94744.84
Transfer,Deposit,2025-08-04 16:13:58,2025-08-04 16:13:58,To Instant Access Savings,1.00,0.00,EUR,COMPLETED,94745.84
Interest,Deposit,2025-08-05 02:01:40,2025-08-05 02:01:40,Interest earned - Instant Access Savings,4.51,1.49,EUR,COMPLETED,94748.86
Transfer,Deposit,2025-08-05 15:06:35,2025-08-05 15:06:35,To Instant Access Savings,3.25,0.00,EUR,COMPLETED,94752.11
Interest,Deposit,2025-08-06 02:01:39,2025-08-06 02:01:39,Interest earned - Instant Access Savings,4.52,1.49,EUR,COMPLETED,94755.14
Interest,Deposit,2025-08-07 02:03:49,2025-08-07 02:03:49,Interest earned - Instant Access Savings,4.52,1.49,EUR,COMPLETED,94758.17
Interest,Deposit,2025-08-08 02:04:13,2025-08-08 02:04:13,Interest earned - Instant Access Savings,4.52,1.49,EUR,COMPLETED,94761.20
Transfer,Deposit,2025-08-08 08:18:24,2025-08-08 08:18:24,To Instant Access Savings,1.50,0.00,EUR,COMPLETED,94762.70
Transfer,Deposit,2025-08-08 23:23:39,2025-08-08 23:23:39,From Instant Access Savings,-100.00,0.00,EUR,COMPLETED,94662.70
Transfer,Deposit,2025-08-09 00:36:04,2025-08-09 00:36:04,To Instant Access Savings,1.50,0.00,EUR,COMPLETED,94664.20
Interest,Deposit,2025-08-09 02:04:01,2025-08-09 02:04:01,Interest earned - Instant Access Savings,4.51,1.49,EUR,COMPLETED,94667.22
Transfer,Deposit,2025-08-09 11:52:15,2025-08-09 11:52:15,To Instant Access Savings,0.75,0.00,EUR,COMPLETED,94667.97
Transfer,Deposit,2025-08-09 11:57:30,2025-08-09 11:57:30,To Instant Access Savings,5.00,0.00,EUR,COMPLETED,94672.97
Transfer,Deposit,2025-08-09 13:41:43,2025-08-09 13:41:44,To Instant Access Savings,5.00,0.00,EUR,COMPLETED,94677.97
Interest,Deposit,2025-08-10 02:03:05,2025-08-10 02:03:05,Interest earned - Instant Access Savings,4.51,1.49,EUR,COMPLETED,94680.99
Transfer,Deposit,2025-08-10 12:06:08,2025-08-10 12:06:08,To Instant Access Savings,2.00,0.00,EUR,COMPLETED,94682.99
Transfer,Deposit,2025-08-10 19:39:17,2025-08-10 19:39:18,From Instant Access Savings,-125.00,0.00,EUR,COMPLETED,94557.99
Transfer,Deposit,2025-08-10 19:58:05,2025-08-10 19:58:05,To Instant Access Savings,4.50,0.00,EUR,COMPLETED,94562.49
Interest,Deposit,2025-08-11 02:04:10,2025-08-11 02:04:10,Interest earned - Instant Access Savings,4.51,1.49,EUR,COMPLETED,94565.51
Transfer,Deposit,2025-08-11 23:07:13,2025-08-11 23:07:13,To Instant Access Savings,4.60,0.00,EUR,COMPLETED,94570.11
Interest,Deposit,2025-08-12 02:03:28,2025-08-12 02:03:28,Interest earned - Instant Access Savings,4.51,1.49,EUR,COMPLETED,94573.13
Transfer,Deposit,2025-08-12 15:56:34,2025-08-12 15:56:34,From Instant Access Savings,-100.00,0.00,EUR,COMPLETED,94473.13
Transfer,Deposit,2025-08-12 19:03:02,2025-08-12 19:03:02,To Instant Access Savings,2.80,0.00,EUR,COMPLETED,94475.93
Interest,Deposit,2025-08-13 02:03:04,2025-08-13 02:03:04,Interest earned - Instant Access Savings,4.50,1.48,EUR,COMPLETED,94478.95
Transfer,Deposit,2025-08-13 08:41:02,2025-08-13 08:41:02,To Instant Access Savings,5.00,0.00,EUR,COMPLETED,94483.95
Transfer,Deposit,2025-08-13 19:10:15,2025-08-13 19:10:16,To Instant Access Savings,0.25,0.00,EUR,COMPLETED,94484.20
Interest,Deposit,2025-08-14 02:01:52,2025-08-14 02:01:52,Interest earned - Instant Access Savings,4.51,1.49,EUR,COMPLETED,94487.22
Transfer,Deposit,2025-08-14 08:06:38,2025-08-14 08:06:38,From Instant Access Savings,-100.00,0.00,EUR,COMPLETED,94387.22
Transfer,Deposit,2025-08-14 08:11:59,2025-08-14 08:11:59,To Instant Access Savings,1.75,0.00,EUR,COMPLETED,94388.97
Transfer,Deposit,2025-08-14 18:25:17,2025-08-14 18:25:17,To Instant Access Savings,4.00,0.00,EUR,COMPLETED,94392.97
Transfer,Deposit,2025-08-14 19:06:48,2025-08-14 19:06:48,To Instant Access Savings,2.00,0.00,EUR,COMPLETED,94394.97
Transfer,Deposit,2025-08-14 19:11:02,2025-08-14 19:11:02,To Instant Access Savings,4.00,0.00,EUR,COMPLETED,94398.97
Transfer,Deposit,2025-08-14 19:41:15,2025-08-14 19:41:15,To Instant Access Savings,0.10,0.00,EUR,COMPLETED,94399.07
Interest,Deposit,2025-08-15 02:03:36,2025-08-15 02:03:36,Interest earned - Instant Access Savings,4.50,1.48,EUR,COMPLETED,94402.09
Transfer,Deposit,2025-08-15 10:03:36,2025-08-15 10:03:36,From Instant Access Savings,-500.00,0.00,EUR,COMPLETED,93902.09
Transfer,Deposit,2025-08-15 15:48:24,2025-08-15 15:48:24,To Instant Access Savings,3.90,0.00,EUR,COMPLETED,93905.99
Interest,Deposit,2025-08-16 02:01:41,2025-08-16 02:01:41,Interest earned - Instant Access Savings,4.47,1.48,EUR,COMPLETED,93908.98
Interest,Deposit,2025-08-17 02:03:09,2025-08-17 02:03:09,Interest earned - Instant Access Savings,4.48,1.48,EUR,COMPLETED,93911.98
Transfer,Deposit,2025-08-17 11:17:04,2025-08-17 11:17:04,To Instant Access Savings,1.65,0.00,EUR,COMPLETED,93913.63
Interest,Deposit,2025-08-18 02:01:48,2025-08-18 02:01:48,Interest earned - Instant Access Savings,4.48,1.48,EUR,COMPLETED,93916.63
Interest,Deposit,2025-08-19 02:02:12,2025-08-19 02:02:12,Interest earned - Instant Access Savings,4.47,1.47,EUR,COMPLETED,93919.63
Transfer,Deposit,2025-08-19 18:25:04,2025-08-19 18:25:04,To Instant Access Savings,5.00,0.00,EUR,COMPLETED,93924.63
Transfer,Deposit,2025-08-19 18:42:54,2025-08-19 18:42:54,To Instant Access Savings,0.60,0.00,EUR,COMPLETED,93925.23
Interest,Deposit,2025-08-20 02:01:17,2025-08-20 02:01:17,Interest earned - Instant Access Savings,4.48,1.48,EUR,COMPLETED,93928.23
Interest,Deposit,2025-08-21 02:05:15,2025-08-21 02:05:15,Interest earned - Instant Access Savings,4.48,1.48,EUR,COMPLETED,93931.23
Interest,Deposit,2025-08-22 02:05:24,2025-08-22 02:05:24,Interest earned - Instant Access Savings,4.48,1.48,EUR,COMPLETED,93934.23
Transfer,Deposit,2025-08-22 09:36:37,2025-08-22 09:36:37,To Instant Access Savings,5.00,0.00,EUR,COMPLETED,93939.23
Transfer,Deposit,2025-08-22 12:16:57,2025-08-22 12:16:57,To Instant Access Savings,3.35,0.00,EUR,COMPLETED,93942.58
Transfer,Deposit,2025-08-22 12:18:21,2025-08-22 12:18:21,To Instant Access Savings,0.20,0.00,EUR,COMPLETED,93942.78
Transfer,Deposit,2025-08-22 19:43:01,2025-08-22 19:43:01,From Instant Access Savings,-100.00,0.00,EUR,COMPLETED,93842.78
Transfer,Deposit,2025-08-22 19:43:53,2025-08-22 19:43:53,To Instant Access Savings,5.00,0.00,EUR,COMPLETED,93847.78
Transfer,Deposit,2025-08-22 19:54:41,2025-08-22 19:54:41,To Instant Access Savings,1.00,0.00,EUR,COMPLETED,93848.78
Interest,Deposit,2025-08-23 02:04:20,2025-08-23 02:04:20,Interest earned - Instant Access Savings,4.47,1.47,EUR,COMPLETED,93851.78
Transfer,Deposit,2025-08-23 14:09:24,2025-08-23 14:09:24,From Instant Access Savings,-100.00,0.00,EUR,COMPLETED,93751.78
Transfer,Deposit,2025-08-23 14:14:44,2025-08-23 14:14:44,To Instant Access Savings,0.25,0.00,EUR,COMPLETED,93752.03
Transfer,Deposit,2025-08-23 20:02:23,2025-08-23 20:02:23,To Instant Access Savings,5.00,0.00,EUR,COMPLETED,93757.03
Interest,Deposit,2025-08-24 02:02:21,2025-08-24 02:02:21,Interest earned - Instant Access Savings,4.47,1.48,EUR,COMPLETED,93760.02
Transfer,Deposit,2025-08-24 14:06:38,2025-08-24 14:06:38,To Instant Access Savings,0.05,0.00,EUR,COMPLETED,93760.07
Transfer,Deposit,2025-08-24 19:50:41,2025-08-24 19:50:42,To Instant Access Savings,5.00,0.00,EUR,COMPLETED,93765.07
Transfer,Deposit,2025-08-24 21:53:33,2025-08-24 21:53:33,To Instant Access Savings,0.50,0.00,EUR,COMPLETED,93765.57
Interest,Deposit,2025-08-25 02:04:01,2025-08-25 02:04:01,Interest earned - Instant Access Savings,4.47,1.47,EUR,COMPLETED,93768.57
Transfer,Deposit,2025-08-25 03:00:32,2025-08-25 03:00:32,To Instant Access Savings,5.00,0.00,EUR,COMPLETED,93773.57
Transfer,Deposit,2025-08-25 13:17:42,2025-08-25 13:17:42,To Instant Access Savings,1.25,0.00,EUR,COMPLETED,93774.82
Transfer,Deposit,2025-08-25 17:08:07,2025-08-25 17:08:07,To Instant Access Savings,5.00,0.00,EUR,COMPLETED,93779.82
Interest,Deposit,2025-08-26 02:05:32,2025-08-26 02:05:32,Interest earned - Instant Access Savings,4.47,1.48,EUR,COMPLETED,93782.81
Transfer,Deposit,2025-08-26 07:43:26,2025-08-26 07:43:26,To Instant Access Savings,5.00,0.00,EUR,COMPLETED,93787.81
Transfer,Deposit,2025-08-26 14:18:06,2025-08-26 14:18:06,To Instant Access Savings,2.50,0.00,EUR,COMPLETED,93790.31
Transfer,Deposit,2025-08-26 18:45:35,2025-08-26 18:45:35,To Instant Access Savings,1.25,0.00,EUR,COMPLETED,93791.56
Transfer,Deposit,2025-08-26 18:59:46,2025-08-26 18:59:46,To Instant Access Savings,2.65,0.00,EUR,COMPLETED,93794.21
Interest,Deposit,2025-08-27 02:03:23,2025-08-27 02:03:23,Interest earned - Instant Access Savings,4.47,1.47,EUR,COMPLETED,93797.21
Transfer,Deposit,2025-08-27 12:06:54,2025-08-27 12:06:54,To Instant Access Savings,1.25,0.00,EUR,COMPLETED,93798.46
Transfer,Deposit,2025-08-27 17:16:21,2025-08-27 17:16:21,To Instant Access Savings,2.50,0.00,EUR,COMPLETED,93800.96
Transfer,Deposit,2025-08-27 19:41:56,2025-08-27 19:41:56,To Instant Access Savings,4.55,0.00,EUR,COMPLETED,93805.51
Transfer,Deposit,2025-08-27 19:46:55,2025-08-27 19:46:55,To Instant Access Savings,3.00,0.00,EUR,COMPLETED,93808.51
Transfer,Deposit,2025-08-27 20:43:06,2025-08-27 20:43:07,To Instant Access Savings,3.00,0.00,EUR,COMPLETED,93811.51
Transfer,Deposit,2025-08-27 21:48:22,2025-08-27 21:48:22,To Instant Access Savings,5.00,0.00,EUR,COMPLETED,93816.51
Transfer,Deposit,2025-08-27 21:52:03,2025-08-27 21:52:03,To Instant Access Savings,4.50,0.00,EUR,COMPLETED,93821.01
Transfer,Deposit,2025-08-28 00:34:18,2025-08-28 00:34:19,To Instant Access Savings,0.05,0.00,EUR,COMPLETED,93821.06
Interest,Deposit,2025-08-28 02:05:05,2025-08-28 02:05:05,Interest earned - Instant Access Savings,4.47,1.48,EUR,COMPLETED,93824.05
Transfer,Deposit,2025-08-28 09:24:41,2025-08-28 09:24:41,To Instant Access Savings,2.80,0.00,EUR,COMPLETED,93826.85
Transfer,Deposit,2025-08-28 17:02:42,2025-08-28 17:02:42,To Instant Access Savings,4.95,0.00,EUR,COMPLETED,93831.80
Transfer,Deposit,2025-08-28 18:54:52,2025-08-28 18:54:52,To Instant Access Savings,1.05,0.00,EUR,COMPLETED,93832.85
Interest,Deposit,2025-08-29 02:05:09,2025-08-29 02:05:09,Interest earned - Instant Access Savings,4.48,1.48,EUR,COMPLETED,93835.85
Transfer,Deposit,2025-08-29 07:22:34,2025-08-29 07:22:34,To Instant Access Savings,2.00,0.00,EUR,COMPLETED,93837.85
Transfer,Deposit,2025-08-29 07:40:17,2025-08-29 07:40:17,To Instant Access Savings,1.55,0.00,EUR,COMPLETED,93839.40
Transfer,Deposit,2025-08-29 12:34:11,2025-08-29 12:34:12,To Instant Access Savings,1.00,0.00,EUR,COMPLETED,93840.40
Transfer,Deposit,2025-08-29 17:04:58,2025-08-29 17:04:58,To Instant Access Savings,3.50,0.00,EUR,COMPLETED,93843.90
Transfer,Deposit,2025-08-29 19:26:57,2025-08-29 19:26:57,To Instant Access Savings,1.00,0.00,EUR,COMPLETED,93844.90
Transfer,Deposit,2025-08-30 00:19:55,2025-08-30 00:19:56,To Instant Access Savings,3.50,0.00,EUR,COMPLETED,93848.40
Interest,Deposit,2025-08-30 02:03:46,2025-08-30 02:03:46,Interest earned - Instant Access Savings,4.47,1.47,EUR,COMPLETED,93851.40
Transfer,Deposit,2025-08-30 07:32:46,2025-08-30 07:32:47,To Instant Access Savings,2.50,0.00,EUR,COMPLETED,93853.90
Transfer,Deposit,2025-08-30 17:16:47,2025-08-30 17:16:47,To Instant Access Savings,5.00,0.00,EUR,COMPLETED,93858.90
Transfer,Deposit,2025-08-30 21:46:24,2025-08-30 21:46:24,To Instant Access Savings,0.75,0.00,EUR,COMPLETED,93859.65
Interest,Deposit,2025-08-31 02:03:24,2025-08-31 02:03:24,Interest earned - Instant Access Savings,4.48,1.48,EUR,COMPLETED,93862.65
Transfer,Deposit,2025-08-31 03:14:05,2025-08-31 03:14:05,To Instant Access Savings,5.00,0.00,EUR,COMPLETED,93867.65
Transfer,Deposit,2025-08-31 10:55:18,2025-08-31 10:55:18,To Instant Access Savings,0.05,0.00,EUR,COMPLETED,93867.70
Transfer,Deposit,2025-08-31 12:23:54,2025-08-31 12:23:54,To Instant Access Savings,4.00,0.00,EUR,COMPLETED,93871.70
Interest,Deposit,2025-09-01 02:02:56,2025-09-01 02:02:56,Interest earned - Instant Access Savings,4.47,1.47,EUR,COMPLETED,93874.70
Transfer,Deposit,2025-09-01 11:46:36,2025-09-01 11:46:36,To Instant Access Savings,1.25,0.00,EUR,COMPLETED,93875.95
Transfer,Deposit,2025-09-01 12:05:02,2025-09-01 12:05:02,To Instant Access Savings,1.05,0.00,EUR,COMPLETED,93877.00
Transfer,Deposit,2025-09-01 15:14:33,2025-09-01 15:14:33,To Instant Access Savings,0.50,0.00,EUR,COMPLETED,93877.50
Interest,Deposit,2025-09-02 02:01:54,2025-09-02 02:01:54,Interest earned - Instant Access Savings,4.48,1.48,EUR,COMPLETED,93880.50
Transfer,Deposit,2025-09-02 13:20:04,2025-09-02 13:20:04,To Instant Access Savings,3.10,0.00,EUR,COMPLETED,93883.60
Transfer,Deposit,2025-09-02 20:59:16,2025-09-02 20:59:17,To Instant Access Savings,0.05,0.00,EUR,COMPLETED,93883.65
Interest,Deposit,2025-09-03 02:05:29,2025-09-03 02:05:29,Interest earned - Instant Access Savings,4.47,1.48,EUR,COMPLETED,93886.64
Transfer,Deposit,2025-09-03 18:39:56,2025-09-03 18:39:57,To Instant Access Savings,2.55,0.00,EUR,COMPLETED,93889.19
Interest,Deposit,2025-09-04 02:05:10,2025-09-04 02:05:11,Interest earned - Instant Access Savings,4.48,1.48,EUR,COMPLETED,93892.19
Transfer,Deposit,2025-09-04 10:11:48,2025-09-04 10:11:49,To Instant Access Savings,0.05,0.00,EUR,COMPLETED,93892.24
Transfer,Deposit,2025-09-04 10:19:26,2025-09-04 10:19:26,To Instant Access Savings,1.00,0.00,EUR,COMPLETED,93893.24
Transfer,Deposit,2025-09-04 11:05:35,2025-09-04 11:05:35,To Instant Access Savings,2.85,0.00,EUR,COMPLETED,93896.09
Transfer,Deposit,2025-09-04 17:43:11,2025-09-04 17:43:11,To Instant Access Savings,4.50,0.00,EUR,COMPLETED,93900.59
Transfer,Deposit,2025-09-04 18:33:24,2025-09-04 18:33:25,To Instant Access Savings,1.65,0.00,EUR,COMPLETED,93902.24
Interest,Deposit,2025-09-05 02:05:36,2025-09-05 02:05:36,Interest earned - Instant Access Savings,4.47,1.47,EUR,COMPLETED,93905.24
Transfer,Deposit,2025-09-05 08:17:36,2025-09-05 08:17:36,To Instant Access Savings,1.75,0.00,EUR,COMPLETED,93906.99
Transfer,Deposit,2025-09-05 17:11:43,2025-09-05 17:11:43,To Instant Access Savings,3.25,0.00,EUR,COMPLETED,93910.24
Interest,Deposit,2025-09-06 02:03:18,2025-09-06 02:03:18,Interest earned - Instant Access Savings,4.48,1.48,EUR,COMPLETED,93913.24
Transfer,Deposit,2025-09-06 11:18:51,2025-09-06 11:18:51,To Instant Access Savings,5.00,0.00,EUR,COMPLETED,93918.24
Interest,Deposit,2025-09-07 02:03:15,2025-09-07 02:03:15,Interest earned - Instant Access Savings,4.48,1.48,EUR,COMPLETED,93921.24
Transfer,Deposit,2025-09-07 11:41:03,2025-09-07 11:41:03,To Instant Access Savings,0.50,0.00,EUR,COMPLETED,93921.74
Transfer,Deposit,2025-09-07 16:10:55,2025-09-07 16:10:55,To Instant Access Savings,3.75,0.00,EUR,COMPLETED,93925.49
Interest,Deposit,2025-09-08 02:04:01,2025-09-08 02:04:01,Interest earned - Instant Access Savings,4.48,1.48,EUR,COMPLETED,93928.49
Transfer,Deposit,2025-09-08 13:08:40,2025-09-08 13:08:40,To Instant Access Savings,5.00,0.00,EUR,COMPLETED,93933.49
Transfer,Deposit,2025-09-08 13:25:03,2025-09-08 13:25:03,To Instant Access Savings,2.00,0.00,EUR,COMPLETED,93935.49
Interest,Deposit,2025-09-09 02:02:16,2025-09-09 02:02:16,Interest earned - Instant Access Savings,4.47,1.47,EUR,COMPLETED,93938.49
Transfer,Deposit,2025-09-09 08:47:48,2025-09-09 08:47:48,From Instant Access Savings,-1600.00,0.00,EUR,COMPLETED,92338.49
Transfer,Deposit,2025-09-09 13:42:29,2025-09-09 13:42:29,To Instant Access Savings,5.00,0.00,EUR,COMPLETED,92343.49
Transfer,Deposit,2025-09-09 15:57:16,2025-09-09 15:57:16,To Instant Access Savings,1.90,0.00,EUR,COMPLETED,92345.39
Transfer,Deposit,2025-09-09 16:01:24,2025-09-09 16:01:24,To Instant Access Savings,5.00,0.00,EUR,COMPLETED,92350.39
Transfer,Deposit,2025-09-09 16:54:28,2025-09-09 16:54:28,To Instant Access Savings,3.20,0.00,EUR,COMPLETED,92353.59
Transfer,Deposit,2025-09-09 16:54:38,2025-09-09 16:54:38,To Instant Access Savings,5.00,0.00,EUR,COMPLETED,92358.59
Interest,Deposit,2025-09-10 02:02:58,2025-09-10 02:02:58,Interest earned - Instant Access Savings,4.41,1.46,EUR,COMPLETED,92361.54
Transfer,Deposit,2025-09-10 09:34:04,2025-09-10 09:34:04,To Instant Access Savings,0.60,0.00,EUR,COMPLETED,92362.14
Transfer,Deposit,2025-09-10 17:22:35,2025-09-10 17:22:35,To Instant Access Savings,3.60,0.00,EUR,COMPLETED,92365.74
Interest,Deposit,2025-09-11 02:05:30,2025-09-11 02:05:30,Interest earned - Instant Access Savings,4.40,1.45,EUR,COMPLETED,92368.69
Transfer,Deposit,2025-09-11 07:55:06,2025-09-11 07:55:06,To Instant Access Savings,5.00,0.00,EUR,COMPLETED,92373.69
Transfer,Deposit,2025-09-11 08:35:21,2025-09-11 08:35:21,To Instant Access Savings,2.00,0.00,EUR,COMPLETED,92375.69
Transfer,Deposit,2025-09-11 18:22:29,2025-09-11 18:22:29,To Instant Access Savings,5.00,0.00,EUR,COMPLETED,92380.69
Interest,Deposit,2025-09-12 02:06:15,2025-09-12 02:06:15,Interest earned - Instant Access Savings,4.40,1.45,EUR,COMPLETED,92383.64
Transfer,Deposit,2025-09-12 08:43:47,2025-09-12 08:43:47,To Instant Access Savings,3.00,0.00,EUR,COMPLETED,92386.64
Interest,Deposit,2025-09-13 02:05:29,2025-09-13 02:05:29,Interest earned - Instant Access Savings,4.41,1.46,EUR,COMPLETED,92389.59
Transfer,Deposit,2025-09-13 07:55:41,2025-09-13 07:55:41,To Instant Access Savings,0.05,0.00,EUR,COMPLETED,92389.64
Transfer,Deposit,2025-09-13 12:09:08,2025-09-13 12:09:08,To Instant Access Savings,1.00,0.00,EUR,COMPLETED,92390.64
Transfer,Deposit,2025-09-13 12:15:30,2025-09-13 12:15:32,To Instant Access Savings,5.00,0.00,EUR,COMPLETED,92395.64
Transfer,Deposit,2025-09-13 14:58:55,2025-09-13 14:58:56,To Instant Access Savings,2.00,0.00,EUR,COMPLETED,92397.64
Transfer,Deposit,2025-09-13 15:54:19,2025-09-13 15:54:19,From Instant Access Savings,-50.00,0.00,EUR,COMPLETED,92347.64
Transfer,Deposit,2025-09-13 15:54:36,2025-09-13 15:54:36,To Instant Access Savings,1.00,0.00,EUR,COMPLETED,92348.64
Interest,Deposit,2025-09-14 02:01:48,2025-09-14 02:01:48,Interest earned - Instant Access Savings,4.40,1.45,EUR,COMPLETED,92351.59
Transfer,Deposit,2025-09-14 10:27:24,2025-09-14 10:27:24,To Instant Access Savings,4.25,0.00,EUR,COMPLETED,92355.84
Transfer,Deposit,2025-09-14 10:52:32,2025-09-14 10:52:32,From Instant Access Savings,-70.00,0.00,EUR,COMPLETED,92285.84
Transfer,Deposit,2025-09-14 10:54:26,2025-09-14 10:54:26,To Instant Access Savings,3.60,0.00,EUR,COMPLETED,92289.44
Interest,Deposit,2025-09-15 02:03:00,2025-09-15 02:03:00,Interest earned - Instant Access Savings,4.40,1.45,EUR,COMPLETED,92292.39
Transfer,Deposit,2025-09-15 13:17:06,2025-09-15 13:17:06,To Instant Access Savings,2.45,0.00,EUR,COMPLETED,92294.84
Interest,Deposit,2025-09-16 02:05:31,2025-09-16 02:05:31,Interest earned - Instant Access Savings,4.40,1.45,EUR,COMPLETED,92297.79
Transfer,Deposit,2025-09-16 21:38:42,2025-09-16 21:38:42,From Instant Access Savings,-100.00,0.00,EUR,COMPLETED,92197.79
Transfer,Deposit,2025-09-16 21:38:55,2025-09-16 21:38:56,To Instant Access Savings,5.00,0.00,EUR,COMPLETED,92202.79
Transfer,Deposit,2025-09-16 22:16:54,2025-09-16 22:16:55,To Instant Access Savings,4.30,0.00,EUR,COMPLETED,92207.09
Transfer,Deposit,2025-09-16 23:00:06,2025-09-16 23:00:06,To Instant Access Savings,4.00,0.00,EUR,COMPLETED,92211.09
Interest,Deposit,2025-09-17 02:05:16,2025-09-17 02:05:16,Interest earned - Instant Access Savings,4.40,1.45,EUR,COMPLETED,92214.04
Interest,Deposit,2025-09-18 02:05:21,2025-09-18 02:05:21,Interest earned - Instant Access Savings,4.39,1.45,EUR,COMPLETED,92216.98
Transfer,Deposit,2025-09-18 08:28:14,2025-09-18 08:28:14,To Instant Access Savings,2.50,0.00,EUR,COMPLETED,92219.48
Transfer,Deposit,2025-09-18 19:19:34,2025-09-18 19:19:35,To Instant Access Savings,5.00,0.00,EUR,COMPLETED,92224.48
Interest,Deposit,2025-09-19 02:04:44,2025-09-19 02:04:44,Interest earned - Instant Access Savings,4.40,1.45,EUR,COMPLETED,92227.43
Transfer,Deposit,2025-09-19 08:56:38,2025-09-19 08:56:38,To Instant Access Savings,2.00,0.00,EUR,COMPLETED,92229.43
Interest,Deposit,2025-09-20 02:03:51,2025-09-20 02:03:51,Interest earned - Instant Access Savings,4.39,1.45,EUR,COMPLETED,92232.37
Transfer,Deposit,2025-09-20 11:05:34,2025-09-20 11:05:34,To Instant Access Savings,4.50,0.00,EUR,COMPLETED,92236.87
Transfer,Deposit,2025-09-20 20:52:45,2025-09-20 20:52:46,From Instant Access Savings,-71.00,0.00,EUR,COMPLETED,92165.87
Transfer,Deposit,2025-09-20 21:27:52,2025-09-20 21:27:52,To Instant Access Savings,5.00,0.00,EUR,COMPLETED,92170.87
Transfer,Deposit,2025-09-20 22:45:36,2025-09-20 22:45:36,To Instant Access Savings,2.00,0.00,EUR,COMPLETED,92172.87
Interest,Deposit,2025-09-21 02:04:18,2025-09-21 02:04:18,Interest earned - Instant Access Savings,4.40,1.45,EUR,COMPLETED,92175.82
Transfer,Deposit,2025-09-21 10:47:52,2025-09-21 10:47:52,To Instant Access Savings,1.00,0.00,EUR,COMPLETED,92176.82
Transfer,Deposit,2025-09-21 11:11:10,2025-09-21 11:11:11,To Instant Access Savings,1.85,0.00,EUR,COMPLETED,92178.67
Transfer,Deposit,2025-09-21 13:06:10,2025-09-21 13:06:10,From Instant Access Savings,-100.00,0.00,EUR,COMPLETED,92078.67
Transfer,Deposit,2025-09-21 13:06:21,2025-09-21 13:06:21,To Instant Access Savings,5.00,0.00,EUR,COMPLETED,92083.67
Transfer,Deposit,2025-09-21 15:44:41,2025-09-21 15:44:41,To Instant Access Savings,5.00,0.00,EUR,COMPLETED,92088.67
Transfer,Deposit,2025-09-21 21:58:34,2025-09-21 21:58:34,From Instant Access Savings,-88.00,0.00,EUR,COMPLETED,92000.67
Transfer,Deposit,2025-09-21 21:58:47,2025-09-21 21:58:47,To Instant Access Savings,2.40,0.00,EUR,COMPLETED,92003.07
Interest,Deposit,2025-09-22 02:04:06,2025-09-22 02:04:06,Interest earned - Instant Access Savings,4.38,1.45,EUR,COMPLETED,92006.00
Transfer,Deposit,2025-09-22 09:09:08,2025-09-22 09:09:08,To Instant Access Savings,2.00,0.00,EUR,COMPLETED,92008.00
Interest,Deposit,2025-09-23 02:05:13,2025-09-23 02:05:13,Interest earned - Instant Access Savings,4.39,1.45,EUR,COMPLETED,92010.94
Transfer,Deposit,2025-09-23 08:12:41,2025-09-23 08:12:41,To Instant Access Savings,2.00,0.00,EUR,COMPLETED,92012.94
Interest,Deposit,2025-09-24 02:06:00,2025-09-24 02:06:00,Interest earned - Instant Access Savings,4.39,1.45,EUR,COMPLETED,92015.88
Transfer,Deposit,2025-09-24 20:08:45,2025-09-24 20:08:45,To Instant Access Savings,0.10,0.00,EUR,COMPLETED,92015.98
Interest,Deposit,2025-09-25 02:03:30,2025-09-25 02:03:30,Interest earned - Instant Access Savings,4.38,1.44,EUR,COMPLETED,92018.92
Transfer,Deposit,2025-09-25 03:00:46,2025-09-25 03:00:46,To Instant Access Savings,5.00,0.00,EUR,COMPLETED,92023.92
Transfer,Deposit,2025-09-25 19:53:23,2025-09-25 19:53:23,To Instant Access Savings,1.75,0.00,EUR,COMPLETED,92025.67
Interest,Deposit,2025-09-26 02:05:15,2025-09-26 02:05:15,Interest earned - Instant Access Savings,4.39,1.45,EUR,COMPLETED,92028.61
Transfer,Deposit,2025-09-26 18:43:14,2025-09-26 18:43:14,To Instant Access Savings,0.80,0.00,EUR,COMPLETED,92029.41
Interest,Deposit,2025-09-27 02:03:08,2025-09-27 02:03:08,Interest earned - Instant Access Savings,4.39,1.45,EUR,COMPLETED,92032.35
Transfer,Deposit,2025-09-27 10:46:25,2025-09-27 10:46:25,To Instant Access Savings,5.00,0.00,EUR,COMPLETED,92037.35
Transfer,Deposit,2025-09-27 12:12:31,2025-09-27 12:12:32,To Instant Access Savings,0.25,0.00,EUR,COMPLETED,92037.60
Transfer,Deposit,2025-09-27 16:07:01,2025-09-27 16:07:01,To Instant Access Savings,0.10,0.00,EUR,COMPLETED,92037.70
Transfer,Deposit,2025-09-27 19:55:42,2025-09-27 19:55:42,To Instant Access Savings,2.50,0.00,EUR,COMPLETED,92040.20
Transfer,Deposit,2025-09-28 00:34:17,2025-09-28 00:34:17,To Instant Access Savings,0.05,0.00,EUR,COMPLETED,92040.25
Interest,Deposit,2025-09-28 02:02:30,2025-09-28 02:02:30,Interest earned - Instant Access Savings,4.39,1.45,EUR,COMPLETED,92043.19
Transfer,Deposit,2025-09-28 10:16:56,2025-09-28 10:16:56,To Instant Access Savings,1.05,0.00,EUR,COMPLETED,92044.24
Transfer,Deposit,2025-09-28 13:19:33,2025-09-28 13:19:33,To Instant Access Savings,1.75,0.00,EUR,COMPLETED,92045.99
Transfer,Deposit,2025-09-28 15:55:15,2025-09-28 15:55:16,To Instant Access Savings,1.25,0.00,EUR,COMPLETED,92047.24
Interest,Deposit,2025-09-29 02:03:37,2025-09-29 02:03:37,Interest earned - Instant Access Savings,4.38,1.44,EUR,COMPLETED,92050.18
Transfer,Deposit,2025-09-29 19:41:44,2025-09-29 19:41:44,To Instant Access Savings,0.15,0.00,EUR,COMPLETED,92050.33
Transfer,Deposit,2025-09-29 20:20:19,2025-09-29 20:20:19,To Instant Access Savings,4.70,0.00,EUR,COMPLETED,92055.03
Transfer,Deposit,2025-09-29 20:22:17,2025-09-29 20:22:17,To Instant Access Savings,5.00,0.00,EUR,COMPLETED,92060.03
Interest,Deposit,2025-09-30 02:03:02,2025-09-30 02:03:02,Interest earned - Instant Access Savings,4.39,1.45,EUR,COMPLETED,92062.97
Transfer,Deposit,2025-09-30 03:13:25,2025-09-30 03:13:25,To Instant Access Savings,5.00,0.00,EUR,COMPLETED,92067.97
Transfer,Deposit,2025-09-30 08:31:34,2025-09-30 08:31:34,To Instant Access Savings,5.00,0.00,EUR,COMPLETED,92072.97
Transfer,Deposit,2025-09-30 09:10:26,2025-09-30 09:10:26,To Instant Access Savings,0.65,0.00,EUR,COMPLETED,92073.62
Transfer,Deposit,2025-09-30 23:19:10,2025-09-30 23:19:10,From Instant Access Savings,-550.00,0.00,EUR,COMPLETED,91523.62
Interest,Deposit,2025-10-01 02:04:25,2025-10-01 02:04:25,Interest earned - Instant Access Savings,4.36,1.44,EUR,COMPLETED,91526.54
Transfer,Deposit,2025-10-01 08:53:44,2025-10-01 08:53:44,To Instant Access Savings,0.05,0.00,EUR,COMPLETED,91526.59
Transfer,Deposit,2025-10-01 09:01:00,2025-10-01 09:01:00,To Instant Access Savings,2.00,0.00,EUR,COMPLETED,91528.59
Interest,Deposit,2025-10-02 02:05:08,2025-10-02 02:05:08,Interest earned - Instant Access Savings,4.37,1.44,EUR,COMPLETED,91531.52
Transfer,Deposit,2025-10-02 08:36:53,2025-10-02 08:36:53,To Instant Access Savings,2.00,0.00,EUR,COMPLETED,91533.52
Transfer,Deposit,2025-10-02 11:48:25,2025-10-02 11:48:25,To Instant Access Savings,1.05,0.00,EUR,COMPLETED,91534.57
Transfer,Deposit,2025-10-02 17:54:09,2025-10-02 17:54:10,To Instant Access Savings,2.50,0.00,EUR,COMPLETED,91537.07
Transfer,Deposit,2025-10-02 18:01:27,2025-10-02 18:01:27,To Instant Access Savings,5.00,0.00,EUR,COMPLETED,91542.07
Transfer,Deposit,2025-10-02 20:37:49,2025-10-02 20:37:49,To Instant Access Savings,0.75,0.00,EUR,COMPLETED,91542.82
Transfer,Deposit,2025-10-02 20:59:10,2025-10-02 20:59:10,To Instant Access Savings,0.05,0.00,EUR,COMPLETED,91542.87
Interest,Deposit,2025-10-03 02:03:17,2025-10-03 02:03:17,Interest earned - Instant Access Savings,4.36,1.44,EUR,COMPLETED,91545.79
Transfer,Deposit,2025-10-03 08:35:08,2025-10-03 08:35:08,To Instant Access Savings,0.25,0.00,EUR,COMPLETED,91546.04
Transfer,Deposit,2025-10-03 16:58:03,2025-10-03 16:58:03,To Instant Access Savings,0.05,0.00,EUR,COMPLETED,91546.09
Transfer,Deposit,2025-10-03 19:12:46,2025-10-03 19:12:46,To Instant Access Savings,2.80,0.00,EUR,COMPLETED,91548.89
Interest,Deposit,2025-10-04 02:02:54,2025-10-04 02:02:54,Interest earned - Instant Access Savings,4.37,1.45,EUR,COMPLETED,91551.81
Transfer,Deposit,2025-10-04 10:11:48,2025-10-04 10:11:49,To Instant Access Savings,0.05,0.00,EUR,COMPLETED,91551.86
Transfer,Deposit,2025-10-04 10:53:52,2025-10-04 10:53:52,To Instant Access Savings,3.15,0.00,EUR,COMPLETED,91555.01
Transfer,Deposit,2025-10-04 13:58:54,2025-10-04 13:58:54,From Instant Access Savings,-100.00,0.00,EUR,COMPLETED,91455.01
Transfer,Deposit,2025-10-04 14:01:47,2025-10-04 14:01:47,To Instant Access Savings,3.25,0.00,EUR,COMPLETED,91458.26
Transfer,Deposit,2025-10-04 19:13:39,2025-10-04 19:13:39,To Instant Access Savings,3.70,0.00,EUR,COMPLETED,91461.96
Interest,Deposit,2025-10-05 02:06:16,2025-10-05 02:06:16,Interest earned - Instant Access Savings,4.36,1.43,EUR,COMPLETED,91464.89
Transfer,Deposit,2025-10-05 10:15:12,2025-10-05 10:15:12,To Instant Access Savings,5.00,0.00,EUR,COMPLETED,91469.89
Transfer,Deposit,2025-10-05 12:04:30,2025-10-05 12:04:30,To Instant Access Savings,0.80,0.00,EUR,COMPLETED,91470.69
Transfer,Deposit,2025-10-05 12:14:06,2025-10-05 12:14:06,To Instant Access Savings,1.50,0.00,EUR,COMPLETED,91472.19
Transfer,Deposit,2025-10-05 13:52:14,2025-10-05 13:52:14,To Instant Access Savings,2.80,0.00,EUR,COMPLETED,91474.99
Transfer,Deposit,2025-10-05 18:33:21,2025-10-05 18:33:21,From Instant Access Savings,-100.00,0.00,EUR,COMPLETED,91374.99
Transfer,Deposit,2025-10-05 18:34:09,2025-10-05 18:34:09,To Instant Access Savings,0.05,0.00,EUR,COMPLETED,91375.04
Interest,Deposit,2025-10-06 02:03:52,2025-10-06 02:03:52,Interest earned - Instant Access Savings,4.35,1.44,EUR,COMPLETED,91377.95
Interest,Deposit,2025-10-07 02:06:53,2025-10-07 02:06:53,Interest earned - Instant Access Savings,4.36,1.44,EUR,COMPLETED,91380.87
Transfer,Deposit,2025-10-07 16:55:11,2025-10-07 16:55:11,To Instant Access Savings,5530.00,0.00,EUR,COMPLETED,96910.87
Transfer,Deposit,2025-10-07 20:17:31,2025-10-07 20:17:31,To Instant Access Savings,4.15,0.00,EUR,COMPLETED,96915.02
Interest,Deposit,2025-10-08 02:05:48,2025-10-08 02:05:48,Interest earned - Instant Access Savings,4.62,1.52,EUR,COMPLETED,96918.12
Transfer,Deposit,2025-10-08 07:52:21,2025-10-08 07:52:21,To Instant Access Savings,5.00,0.00,EUR,COMPLETED,96923.12
Transfer,Deposit,2025-10-08 08:39:47,2025-10-08 08:39:47,To Instant Access Savings,2.00,0.00,EUR,COMPLETED,96925.12
Transfer,Deposit,2025-10-08 18:01:55,2025-10-08 18:01:55,To Instant Access Savings,2.50,0.00,EUR,COMPLETED,96927.62
Transfer,Deposit,2025-10-08 20:33:27,2025-10-08 20:33:27,From Instant Access Savings,-100.00,0.00,EUR,COMPLETED,96827.62
Transfer,Deposit,2025-10-08 20:35:09,2025-10-08 20:35:09,To Instant Access Savings,1.35,0.00,EUR,COMPLETED,96828.97
Interest,Deposit,2025-10-09 02:03:55,2025-10-09 02:03:55,Interest earned - Instant Access Savings,4.61,1.52,EUR,COMPLETED,96832.06
Transfer,Deposit,2025-10-09 08:33:55,2025-10-09 08:33:55,To Instant Access Savings,5.00,0.00,EUR,COMPLETED,96837.06
Transfer,Deposit,2025-10-09 13:44:39,2025-10-09 13:44:39,To Instant Access Savings,5.00,0.00,EUR,COMPLETED,96842.06
Transfer,Deposit,2025-10-09 16:02:27,2025-10-09 16:02:27,To Instant Access Savings,2.50,0.00,EUR,COMPLETED,96844.56
Transfer,Deposit,2024-02-28 06:54:53,2024-02-28 06:54:53,Savings Vault topup,20000.00,0.00,EUR,COMPLETED,20000.00
Transfer,Deposit,2024-02-28 06:54:53,2024-02-28 06:54:53,Saving vault topup prefunding wallet,-20000.00,0.00,EUR,COMPLETED,0.00
Transfer,Deposit,2024-02-28 08:10:55,2024-02-28 08:10:55,Savings Vault topup,4.05,0.00,EUR,COMPLETED,4.05
Transfer,Deposit,2024-02-28 08:10:55,2024-02-28 08:10:55,Saving vault topup prefunding wallet,-4.05,0.00,EUR,COMPLETED,0.00
Transfer,Deposit,2024-02-28 08:18:53,2024-02-28 08:18:53,Savings Vault topup,1.50,0.00,EUR,COMPLETED,1.50
Transfer,Deposit,2024-02-28 08:18:53,2024-02-28 08:18:53,Saving vault topup prefunding wallet,-1.50,0.00,EUR,COMPLETED,0.00
Transfer,Deposit,2024-02-28 19:45:29,2024-02-28 19:45:29,Savings Vault topup,0.75,0.00,EUR,COMPLETED,0.75
Transfer,Deposit,2024-02-28 19:45:29,2024-02-28 19:45:29,Saving vault topup prefunding wallet,-0.75,0.00,EUR,COMPLETED,0.00
Transfer,Deposit,2024-02-29 08:56:52,2024-02-29 08:56:52,Savings Vault topup,0.50,0.00,EUR,COMPLETED,0.50
Transfer,Deposit,2024-02-29 08:56:52,2024-02-29 08:56:52,Saving vault topup prefunding wallet,-0.50,0.00,EUR,COMPLETED,0.00
Transfer,Deposit,2024-02-29 20:03:44,2024-02-29 20:03:44,Savings Vault topup,2.50,0.00,EUR,COMPLETED,2.50
Transfer,Deposit,2024-02-29 20:03:44,2024-02-29 20:03:44,Saving vault topup prefunding wallet,-2.50,0.00,EUR,COMPLETED,0.00
Transfer,Deposit,2024-03-01 09:12:51,2024-03-01 09:12:51,Savings Vault topup,1.50,0.00,EUR,COMPLETED,1.50
Transfer,Deposit,2024-03-01 09:12:51,2024-03-01 09:12:51,Saving vault topup prefunding wallet,-1.50,0.00,EUR,COMPLETED,0.00
Transfer,Deposit,2024-03-01 14:25:19,2024-03-01 14:25:20,Savings Vault topup,2.15,0.00,EUR,COMPLETED,2.15
Transfer,Deposit,2024-03-01 14:25:20,2024-03-01 14:25:20,Saving vault topup prefunding wallet,-2.15,0.00,EUR,COMPLETED,0.00
Transfer,Deposit,2024-03-01 18:02:32,2024-03-01 18:02:32,Savings Vault topup,0.20,0.00,EUR,COMPLETED,0.20
Transfer,Deposit,2024-03-01 18:02:32,2024-03-01 18:02:32,Saving vault topup prefunding wallet,-0.20,0.00,EUR,COMPLETED,0.00
Transfer,Deposit,2024-03-02 10:56:28,2024-03-02 10:56:29,Savings Vault topup,3.50,0.00,EUR,COMPLETED,3.50
Transfer,Deposit,2024-03-02 10:56:29,2024-03-02 10:56:29,Saving vault topup prefunding wallet,-3.50,0.00,EUR,COMPLETED,0.00
Transfer,Deposit,2024-03-02 11:17:46,2024-03-02 11:17:46,Savings Vault topup,2.40,0.00,EUR,COMPLETED,2.40
Transfer,Deposit,2024-03-02 11:17:46,2024-03-02 11:17:46,Saving vault topup prefunding wallet,-2.40,0.00,EUR,COMPLETED,0.00
Transfer,Deposit,2024-03-02 17:13:42,2024-03-02 17:13:42,Savings Vault topup,5.00,0.00,EUR,COMPLETED,5.00
Transfer,Deposit,2024-03-02 17:13:43,2024-03-02 17:13:43,Saving vault topup prefunding wallet,-5.00,0.00,EUR,COMPLETED,0.00
Transfer,Deposit,2024-03-02 17:39:57,2024-03-02 17:39:57,Savings Vault topup,1.75,0.00,EUR,COMPLETED,1.75
Transfer,Deposit,2024-03-02 17:39:57,2024-03-02 17:39:57,Saving vault topup prefunding wallet,-1.75,0.00,EUR,COMPLETED,0.00
Transfer,Deposit,2024-03-03 07:36:40,2024-03-03 07:36:40,Savings Vault topup,2.55,0.00,EUR,COMPLETED,2.55
Transfer,Deposit,2024-03-03 07:36:40,2024-03-03 07:36:40,Saving vault topup prefunding wallet,-2.55,0.00,EUR,COMPLETED,0.00
Transfer,Deposit,2024-03-03 09:38:11,2024-03-03 09:38:11,Savings Vault topup,4.85,0.00,EUR,COMPLETED,4.85
Transfer,Deposit,2024-03-03 09:38:11,2024-03-03 09:38:11,Saving vault topup prefunding wallet,-4.85,0.00,EUR,COMPLETED,0.00
Transfer,Deposit,2024-03-03 15:32:19,2024-03-03 15:32:19,Savings Vault topup,0.60,0.00,EUR,COMPLETED,0.60
Transfer,Deposit,2024-03-03 15:32:19,2024-03-03 15:32:19,Saving vault topup prefunding wallet,-0.60,0.00,EUR,COMPLETED,0.00
Transfer,Deposit,2024-03-03 17:50:15,2024-03-03 17:50:15,Savings Vault topup,3.60,0.00,EUR,COMPLETED,3.60
Transfer,Deposit,2024-03-03 17:50:15,2024-03-03 17:50:15,Saving vault topup prefunding wallet,-3.60,0.00,EUR,COMPLETED,0.00
Transfer,Deposit,2024-03-04 02:51:37,2024-03-04 02:51:37,Savings Vault topup,0.05,0.00,EUR,COMPLETED,0.05
Transfer,Deposit,2024-03-04 02:51:38,2024-03-04 02:51:38,Saving vault topup prefunding wallet,-0.05,0.00,EUR,COMPLETED,0.00
Transfer,Deposit,2024-03-04 09:36:21,2024-03-04 09:36:21,Savings Vault topup,0.20,0.00,EUR,COMPLETED,0.20
Transfer,Deposit,2024-03-04 09:36:21,2024-03-04 09:36:21,Saving vault topup prefunding wallet,-0.20,0.00,EUR,COMPLETED,0.00
Transfer,Deposit,2024-03-05 00:01:20,2024-03-05 00:01:20,Savings Vault topup,0.25,0.00,EUR,COMPLETED,0.25
Transfer,Deposit,2024-03-05 00:01:20,2024-03-05 00:01:20,Saving vault topup prefunding wallet,-0.25,0.00,EUR,COMPLETED,0.00
Transfer,Deposit,2024-03-05 07:51:07,2024-03-05 07:51:07,Savings Vault topup,5.00,0.00,EUR,COMPLETED,5.00
Transfer,Deposit,2024-03-05 07:51:07,2024-03-05 07:51:07,Saving vault topup prefunding wallet,-5.00,0.00,EUR,COMPLETED,0.00
Transfer,Deposit,2024-03-05 08:26:20,2024-03-05 08:26:21,Savings Vault topup,5.00,0.00,EUR,COMPLETED,5.00
Transfer,Deposit,2024-03-05 08:26:21,2024-03-05 08:26:21,Saving vault topup prefunding wallet,-5.00,0.00,EUR,COMPLETED,0.00
Transfer,Deposit,2024-03-06 18:17:08,2024-03-06 18:17:08,Savings Vault topup,3.55,0.00,EUR,COMPLETED,3.55
Transfer,Deposit,2024-03-06 18:17:08,2024-03-06 18:17:08,Saving vault topup prefunding wallet,-3.55,0.00,EUR,COMPLETED,0.00
Transfer,Deposit,2024-03-06 18:36:09,2024-03-06 18:36:09,Savings Vault topup,4.50,0.00,EUR,COMPLETED,4.50
Transfer,Deposit,2024-03-06 18:36:09,2024-03-06 18:36:09,Saving vault topup prefunding wallet,-4.50,0.00,EUR,COMPLETED,0.00
Transfer,Deposit,2024-03-07 23:32:29,2024-03-07 23:32:29,Savings Vault topup,5.00,0.00,EUR,COMPLETED,5.00
Transfer,Deposit,2024-03-07 23:32:29,2024-03-07 23:32:29,Saving vault topup prefunding wallet,-5.00,0.00,EUR,COMPLETED,0.00
Transfer,Deposit,2024-03-08 11:49:56,2024-03-08 11:49:56,Savings vault withdrawal from prefunding wallet,500.00,0.00,EUR,COMPLETED,500.00
Transfer,Deposit,2024-03-08 11:49:56,2024-03-08 11:49:56,From Flexible account,-500.00,0.00,EUR,COMPLETED,0.00
Transfer,Deposit,2024-03-08 12:36:10,2024-03-08 12:36:10,Savings Vault topup,5.00,0.00,EUR,COMPLETED,5.00
Transfer,Deposit,2024-03-08 12:36:10,2024-03-08 12:36:10,Saving vault topup prefunding wallet,-5.00,0.00,EUR,COMPLETED,0.00
Transfer,Deposit,2024-03-08 13:24:12,2024-03-08 13:24:12,Savings Vault topup,0.05,0.00,EUR,COMPLETED,0.05
Transfer,Deposit,2024-03-08 13:24:12,2024-03-08 13:24:12,Saving vault topup prefunding wallet,-0.05,0.00,EUR,COMPLETED,0.00
Transfer,Deposit,2024-03-08 13:43:56,2024-03-08 13:43:56,Savings Vault topup,5.00,0.00,EUR,COMPLETED,5.00
Transfer,Deposit,2024-03-08 13:43:56,2024-03-08 13:43:56,Saving vault topup prefunding wallet,-5.00,0.00,EUR,COMPLETED,0.00
Transfer,Deposit,2024-03-08 16:42:45,2024-03-08 16:42:45,Savings Vault topup,0.05,0.00,EUR,COMPLETED,0.05
Transfer,Deposit,2024-03-08 16:42:45,2024-03-08 16:42:45,Saving vault topup prefunding wallet,-0.05,0.00,EUR,COMPLETED,0.00
Exchange,Deposit,2024-03-08 16:45:26,2024-03-08 16:45:26,Exchanged to EUR,5.04,0.00,EUR,COMPLETED,5.04
Transfer,Deposit,2024-03-08 16:45:26,2024-03-08 16:45:26,Saving vault topup prefunding wallet,-5.04,0.00,EUR,COMPLETED,0.00
Exchange,Deposit,2024-03-08 16:53:36,2024-03-08 16:53:36,Exchanged to EUR,2.69,0.00,EUR,COMPLETED,2.69
Transfer,Deposit,2024-03-08 16:53:36,2024-03-08 16:53:36,Saving vault topup prefunding wallet,-2.69,0.00,EUR,COMPLETED,0.00
Exchange,Deposit,2024-03-08 19:11:37,2024-03-08 19:11:37,Exchanged to EUR,1.75,0.00,EUR,COMPLETED,1.75
Transfer,Deposit,2024-03-08 19:11:37,2024-03-08 19:11:37,Saving vault topup prefunding wallet,-1.75,0.00,EUR,COMPLETED,0.00
Exchange,Deposit,2024-03-08 20:15:38,2024-03-08 20:15:38,Exchanged to EUR,3.51,0.00,EUR,COMPLETED,3.51
Transfer,Deposit,2024-03-08 20:15:38,2024-03-08 20:15:38,Saving vault topup prefunding wallet,-3.51,0.00,EUR,COMPLETED,0.00
Exchange,Deposit,2024-03-08 21:33:14,2024-03-08 21:33:14,Exchanged to EUR,5.86,0.00,EUR,COMPLETED,5.86
Transfer,Deposit,2024-03-08 21:33:14,2024-03-08 21:33:14,Saving vault topup prefunding wallet,-5.86,0.00,EUR,COMPLETED,0.00
Exchange,Deposit,2024-03-08 22:33:34,2024-03-08 22:33:34,Exchanged to EUR,5.86,0.00,EUR,COMPLETED,5.86
Transfer,Deposit,2024-03-08 22:33:34,2024-03-08 22:33:34,Saving vault topup prefunding wallet,-5.86,0.00,EUR,COMPLETED,0.00
Exchange,Deposit,2024-03-08 23:11:10,2024-03-08 23:11:11,Exchanged to EUR,2.93,0.00,EUR,COMPLETED,2.93
Transfer,Deposit,2024-03-08 23:11:11,2024-03-08 23:11:11,Saving vault topup prefunding wallet,-2.93,0.00,EUR,COMPLETED,0.00
Exchange,Deposit,2024-03-08 23:18:47,2024-03-08 23:18:47,Exchanged to EUR,5.86,0.00,EUR,COMPLETED,5.86
Transfer,Deposit,2024-03-08 23:18:47,2024-03-08 23:18:47,Saving vault topup prefunding wallet,-5.86,0.00,EUR,COMPLETED,0.00
Exchange,Deposit,2024-03-09 00:34:21,2024-03-09 00:34:21,Exchanged to EUR,0.58,0.00,EUR,COMPLETED,0.58
Transfer,Deposit,2024-03-09 00:34:21,2024-03-09 00:34:21,Saving vault topup prefunding wallet,-0.58,0.00,EUR,COMPLETED,0.00
Exchange,Deposit,2024-03-09 01:03:02,2024-03-09 01:03:02,Exchanged to EUR,2.93,0.00,EUR,COMPLETED,2.93
Transfer,Deposit,2024-03-09 01:03:02,2024-03-09 01:03:02,Saving vault topup prefunding wallet,-2.93,0.00,EUR,COMPLETED,0.00
Exchange,Deposit,2024-03-09 01:11:36,2024-03-09 01:11:36,Exchanged to EUR,5.86,0.00,EUR,COMPLETED,5.86
Transfer,Deposit,2024-03-09 01:11:36,2024-03-09 01:11:36,Saving vault topup prefunding wallet,-5.86,0.00,EUR,COMPLETED,0.00
Exchange,Deposit,2024-03-09 01:55:47,2024-03-09 01:55:47,Exchanged to EUR,5.86,0.00,EUR,COMPLETED,5.86
Transfer,Deposit,2024-03-09 01:55:47,2024-03-09 01:55:47,Saving vault topup prefunding wallet,-5.86,0.00,EUR,COMPLETED,0.00
Exchange,Deposit,2024-03-09 09:52:38,2024-03-09 09:52:38,Exchanged to EUR,4.69,0.00,EUR,COMPLETED,4.69
Transfer,Deposit,2024-03-09 09:52:38,2024-03-09 09:52:38,Saving vault topup prefunding wallet,-4.69,0.00,EUR,COMPLETED,0.00
Exchange,Deposit,2024-03-09 11:24:15,2024-03-09 11:24:16,Exchanged to EUR,2.34,0.00,EUR,COMPLETED,2.34
Transfer,Deposit,2024-03-09 11:24:16,2024-03-09 11:24:16,Saving vault topup prefunding wallet,-2.34,0.00,EUR,COMPLETED,0.00
Exchange,Deposit,2024-03-09 13:26:12,2024-03-09 13:26:12,Exchanged to EUR,1.17,0.00,EUR,COMPLETED,1.17
Transfer,Deposit,2024-03-09 13:26:12,2024-03-09 13:26:12,Saving vault topup prefunding wallet,-1.17,0.00,EUR,COMPLETED,0.00
Exchange,Deposit,2024-03-09 16:24:22,2024-03-09 16:24:22,Exchanged to EUR,1.17,0.00,EUR,COMPLETED,1.17
Transfer,Deposit,2024-03-09 16:24:23,2024-03-09 16:24:23,Saving vault topup prefunding wallet,-1.17,0.00,EUR,COMPLETED,0.00
Exchange,Deposit,2024-03-09 16:31:31,2024-03-09 16:31:31,Exchanged to EUR,1.75,0.00,EUR,COMPLETED,1.75
Transfer,Deposit,2024-03-09 16:31:32,2024-03-09 16:31:32,Saving vault topup prefunding wallet,-1.75,0.00,EUR,COMPLETED,0.00
Exchange,Deposit,2024-03-09 17:32:52,2024-03-09 17:32:53,Exchanged to EUR,1.75,0.00,EUR,COMPLETED,1.75
Transfer,Deposit,2024-03-09 17:32:53,2024-03-09 17:32:53,Saving vault topup prefunding wallet,-1.75,0.00,EUR,COMPLETED,0.00
Exchange,Deposit,2024-03-09 18:41:25,2024-03-09 18:41:26,Exchanged to EUR,1.75,0.00,EUR,COMPLETED,1.75
Transfer,Deposit,2024-03-09 18:41:26,2024-03-09 18:41:26,Saving vault topup prefunding wallet,-1.75,0.00,EUR,COMPLETED,0.00
Exchange,Deposit,2024-03-09 19:24:26,2024-03-09 19:24:26,Exchanged to EUR,1.75,0.00,EUR,COMPLETED,1.75
Transfer,Deposit,2024-03-09 19:24:26,2024-03-09 19:24:26,Saving vault topup prefunding wallet,-1.75,0.00,EUR,COMPLETED,0.00
Exchange,Deposit,2024-03-09 20:27:47,2024-03-09 20:27:47,Exchanged to EUR,4.69,0.00,EUR,COMPLETED,4.69
Transfer,Deposit,2024-03-09 20:27:47,2024-03-09 20:27:47,Saving vault topup prefunding wallet,-4.69,0.00,EUR,COMPLETED,0.00
Exchange,Deposit,2024-03-10 02:31:11,2024-03-10 02:31:11,Exchanged to EUR,2.93,0.00,EUR,COMPLETED,2.93
Transfer,Deposit,2024-03-10 02:31:11,2024-03-10 02:31:11,Saving vault topup prefunding wallet,-2.93,0.00,EUR,COMPLETED,0.00
Exchange,Deposit,2024-03-10 12:21:08,2024-03-10 12:21:08,Exchanged to EUR,0.58,0.00,EUR,COMPLETED,0.58
Transfer,Deposit,2024-03-10 12:21:08,2024-03-10 12:21:08,Saving vault topup prefunding wallet,-0.58,0.00,EUR,COMPLETED,0.00
Exchange,Deposit,2024-03-10 14:49:22,2024-03-10 14:49:22,Exchanged to EUR,0.87,0.00,EUR,COMPLETED,0.87
Transfer,Deposit,2024-03-10 14:49:22,2024-03-10 14:49:22,Saving vault topup prefunding wallet,-0.87,0.00,EUR,COMPLETED,0.00
Transfer,Deposit,2024-03-10 16:28:08,2024-03-10 16:28:08,Savings vault withdrawal from prefunding wallet,100.00,0.00,EUR,COMPLETED,100.00
Transfer,Deposit,2024-03-10 16:28:08,2024-03-10 16:28:08,From Flexible account,-100.00,0.00,EUR,COMPLETED,0.00
Transfer,Deposit,2024-03-10 16:28:16,2024-03-10 16:28:16,Savings Vault topup,2.60,0.00,EUR,COMPLETED,2.60
Transfer,Deposit,2024-03-10 16:28:16,2024-03-10 16:28:16,Saving vault topup prefunding wallet,-2.60,0.00,EUR,COMPLETED,0.00
Transfer,Deposit,2024-03-11 07:43:26,2024-03-11 07:43:26,Savings Vault topup,0.05,0.00,EUR,COMPLETED,0.05
Transfer,Deposit,2024-03-11 07:43:26,2024-03-11 07:43:26,Saving vault topup prefunding wallet,-0.05,0.00,EUR,COMPLETED,0.00
Transfer,Deposit,2024-03-11 08:26:07,2024-03-11 08:26:07,Savings Vault topup,1.85,0.00,EUR,COMPLETED,1.85
Transfer,Deposit,2024-03-11 08:26:07,2024-03-11 08:26:07,Saving vault topup prefunding wallet,-1.85,0.00,EUR,COMPLETED,0.00
Transfer,Deposit,2024-03-12 08:13:28,2024-03-12 08:13:28,Savings Vault topup,1.30,0.00,EUR,COMPLETED,1.30
Transfer,Deposit,2024-03-12 08:13:28,2024-03-12 08:13:28,Saving vault topup prefunding wallet,-1.30,0.00,EUR,COMPLETED,0.00
Transfer,Deposit,2024-03-13 06:46:40,2024-03-13 06:46:40,Savings Vault topup,5.00,0.00,EUR,COMPLETED,5.00
Transfer,Deposit,2024-03-13 06:46:40,2024-03-13 06:46:40,Saving vault topup prefunding wallet,-5.00,0.00,EUR,COMPLETED,0.00
Transfer,Deposit,2024-03-14 16:46:12,2024-03-14 16:46:12,Savings vault withdrawal from prefunding wallet,200.00,0.00,EUR,COMPLETED,200.00
Transfer,Deposit,2024-03-14 16:46:12,2024-03-14 16:46:12,From Flexible account,-200.00,0.00,EUR,COMPLETED,0.00
Transfer,Deposit,2024-03-15 06:10:18,2024-03-15 06:10:18,Savings Vault topup,0.15,0.00,EUR,COMPLETED,0.15
Transfer,Deposit,2024-03-15 06:10:18,2024-03-15 06:10:18,Saving vault topup prefunding wallet,-0.15,0.00,EUR,COMPLETED,0.00
Transfer,Deposit,2024-03-15 16:35:39,2024-03-15 16:35:39,Savings Vault topup,4.25,0.00,EUR,COMPLETED,4.25
Transfer,Deposit,2024-03-15 16:35:39,2024-03-15 16:35:39,Saving vault topup prefunding wallet,-4.25,0.00,EUR,COMPLETED,0.00
Transfer,Deposit,2024-03-16 10:13:40,2024-03-16 10:13:40,Savings vault withdrawal from prefunding wallet,100.00,0.00,EUR,COMPLETED,100.00
Transfer,Deposit,2024-03-16 10:13:40,2024-03-16 10:13:40,From Flexible account,-100.00,0.00,EUR,COMPLETED,0.00
Transfer,Deposit,2024-03-16 15:21:44,2024-03-16 15:21:44,Savings Vault topup,5.00,0.00,EUR,COMPLETED,5.00
Transfer,Deposit,2024-03-16 15:21:44,2024-03-16 15:21:44,Saving vault topup prefunding wallet,-5.00,0.00,EUR,COMPLETED,0.00
Transfer,Deposit,2024-03-17 08:30:33,2024-03-17 08:30:33,Savings Vault topup,4.85,0.00,EUR,COMPLETED,4.85
Transfer,Deposit,2024-03-17 08:30:33,2024-03-17 08:30:33,Saving vault topup prefunding wallet,-4.85,0.00,EUR,COMPLETED,0.00
Transfer,Deposit,2024-03-17 12:03:30,2024-03-17 12:03:30,Savings vault withdrawal from prefunding wallet,100.00,0.00,EUR,COMPLETED,100.00
Transfer,Deposit,2024-03-17 12:03:30,2024-03-17 12:03:30,From Flexible account,-100.00,0.00,EUR,COMPLETED,0.00
Transfer,Deposit,2024-03-17 12:03:47,2024-03-17 12:03:47,Savings Vault topup,4.50,0.00,EUR,COMPLETED,4.50
Transfer,Deposit,2024-03-17 12:03:47,2024-03-17 12:03:47,Saving vault topup prefunding wallet,-4.50,0.00,EUR,COMPLETED,0.00
Transfer,Deposit,2024-03-18 13:50:52,2024-03-18 13:50:52,Savings Vault topup,0.50,0.00,EUR,COMPLETED,0.50
Transfer,Deposit,2024-03-18 13:50:52,2024-03-18 13:50:52,Saving vault topup prefunding wallet,-0.50,0.00,EUR,COMPLETED,0.00
Transfer,Deposit,2024-03-18 17:58:26,2024-03-18 17:58:26,Savings Vault topup,1.75,0.00,EUR,COMPLETED,1.75
Transfer,Deposit,2024-03-18 17:58:26,2024-03-18 17:58:26,Saving vault topup prefunding wallet,-1.75,0.00,EUR,COMPLETED,0.00
Transfer,Deposit,2024-03-19 13:37:06,2024-03-19 13:37:06,Savings Vault topup,5.00,0.00,EUR,COMPLETED,5.00
Transfer,Deposit,2024-03-19 13:37:06,2024-03-19 13:37:06,Saving vault topup prefunding wallet,-5.00,0.00,EUR,COMPLETED,0.00
Transfer,Deposit,2024-03-19 17:02:28,2024-03-19 17:02:29,Savings Vault topup,0.05,0.00,EUR,COMPLETED,0.05
Transfer,Deposit,2024-03-19 17:02:29,2024-03-19 17:02:29,Saving vault topup prefunding wallet,-0.05,0.00,EUR,COMPLETED,0.00
Transfer,Deposit,2024-03-20 07:26:00,2024-03-20 07:26:00,Savings Vault topup,4.25,0.00,EUR,COMPLETED,4.25
Transfer,Deposit,2024-03-20 07:26:00,2024-03-20 07:26:00,Saving vault topup prefunding wallet,-4.25,0.00,EUR,COMPLETED,0.00
Transfer,Deposit,2024-03-20 07:27:11,2024-03-20 07:27:11,Savings Vault topup,1.45,0.00,EUR,COMPLETED,1.45
Transfer,Deposit,2024-03-20 07:27:11,2024-03-20 07:27:11,Saving vault topup prefunding wallet,-1.45,0.00,EUR,COMPLETED,0.00
Transfer,Deposit,2024-03-20 16:46:38,2024-03-20 16:46:38,Savings Vault topup,2.50,0.00,EUR,COMPLETED,2.50
Transfer,Deposit,2024-03-20 16:46:38,2024-03-20 16:46:38,Saving vault topup prefunding wallet,-2.50,0.00,EUR,COMPLETED,0.00
Transfer,Deposit,2024-03-20 18:20:20,2024-03-20 18:20:20,Savings Vault topup,3.30,0.00,EUR,COMPLETED,3.30
Transfer,Deposit,2024-03-20 18:20:20,2024-03-20 18:20:20,Saving vault topup prefunding wallet,-3.30,0.00,EUR,COMPLETED,0.00
Transfer,Deposit,2024-03-21 18:57:03,2024-03-21 18:57:03,Savings Vault topup,2.50,0.00,EUR,COMPLETED,2.50
Transfer,Deposit,2024-03-21 18:57:03,2024-03-21 18:57:03,Saving vault topup prefunding wallet,-2.50,0.00,EUR,COMPLETED,0.00
Transfer,Deposit,2024-03-22 09:54:07,2024-03-22 09:54:07,Savings Vault topup,5.00,0.00,EUR,COMPLETED,5.00
Transfer,Deposit,2024-03-22 09:54:07,2024-03-22 09:54:07,Saving vault topup prefunding wallet,-5.00,0.00,EUR,COMPLETED,0.00
Transfer,Deposit,2024-03-22 14:46:43,2024-03-22 14:46:43,Savings Vault topup,3.90,0.00,EUR,COMPLETED,3.90
Transfer,Deposit,2024-03-22 14:46:43,2024-03-22 14:46:43,Saving vault topup prefunding wallet,-3.90,0.00,EUR,COMPLETED,0.00
Transfer,Deposit,2024-03-22 17:13:04,2024-03-22 17:13:04,Savings vault withdrawal from prefunding wallet,605.00,0.00,EUR,COMPLETED,605.00
Transfer,Deposit,2024-03-22 17:13:04,2024-03-22 17:13:04,From Flexible account,-605.00,0.00,EUR,COMPLETED,0.00
Transfer,Deposit,2024-03-23 11:00:39,2024-03-23 11:00:39,Savings Vault topup,0.05,0.00,EUR,COMPLETED,0.05
Transfer,Deposit,2024-03-23 11:00:39,2024-03-23 11:00:39,Saving vault topup prefunding wallet,-0.05,0.00,EUR,COMPLETED,0.00
Transfer,Deposit,2024-03-23 11:53:58,2024-03-23 11:53:59,Savings Vault topup,4.25,0.00,EUR,COMPLETED,4.25
Transfer,Deposit,2024-03-23 11:53:59,2024-03-23 11:53:59,Saving vault topup prefunding wallet,-4.25,0.00,EUR,COMPLETED,0.00
Transfer,Deposit,2024-03-23 13:26:19,2024-03-23 13:26:19,Savings Vault topup,4.25,0.00,EUR,COMPLETED,4.25
Transfer,Deposit,2024-03-23 13:26:19,2024-03-23 13:26:19,Saving vault topup prefunding wallet,-4.25,0.00,EUR,COMPLETED,0.00
Transfer,Deposit,2024-03-23 14:51:02,2024-03-23 14:51:02,Savings Vault topup,2.50,0.00,EUR,COMPLETED,2.50
Transfer,Deposit,2024-03-23 14:51:02,2024-03-23 14:51:02,Saving vault topup prefunding wallet,-2.50,0.00,EUR,COMPLETED,0.00
Transfer,Deposit,2024-03-23 14:59:49,2024-03-23 14:59:49,Savings Vault topup,3.05,0.00,EUR,COMPLETED,3.05
Transfer,Deposit,2024-03-23 14:59:49,2024-03-23 14:59:49,Saving vault topup prefunding wallet,-3.05,0.00,EUR,COMPLETED,0.00
Transfer,Deposit,2024-03-23 20:48:20,2024-03-23 20:48:20,Savings Vault topup,1.75,0.00,EUR,COMPLETED,1.75
Transfer,Deposit,2024-03-23 20:48:20,2024-03-23 20:48:20,Saving vault topup prefunding wallet,-1.75,0.00,EUR,COMPLETED,0.00
Transfer,Deposit,2024-03-23 20:53:44,2024-03-23 20:53:44,Savings Vault topup,5.00,0.00,EUR,COMPLETED,5.00
Transfer,Deposit,2024-03-23 20:53:44,2024-03-23 20:53:44,Saving vault topup prefunding wallet,-5.00,0.00,EUR,COMPLETED,0.00
Transfer,Deposit,2024-03-24 16:29:17,2024-03-24 16:29:17,Savings Vault topup,4.90,0.00,EUR,COMPLETED,4.90
Transfer,Deposit,2024-03-24 16:29:17,2024-03-24 16:29:17,Saving vault topup prefunding wallet,-4.90,0.00,EUR,COMPLETED,0.00
Transfer,Deposit,2024-03-25 17:12:27,2024-03-25 17:12:27,Savings Vault topup,2.65,0.00,EUR,COMPLETED,2.65
Transfer,Deposit,2024-03-25 17:12:27,2024-03-25 17:12:27,Saving vault topup prefunding wallet,-2.65,0.00,EUR,COMPLETED,0.00
Transfer,Deposit,2024-03-25 21:20:48,2024-03-25 21:20:48,Savings Vault topup,0.05,0.00,EUR,COMPLETED,0.05
Transfer,Deposit,2024-03-25 21:20:48,2024-03-25 21:20:48,Saving vault topup prefunding wallet,-0.05,0.00,EUR,COMPLETED,0.00
Transfer,Deposit,2024-03-26 08:50:52,2024-03-26 08:50:53,Savings Vault topup,4.00,0.00,EUR,COMPLETED,4.00
Transfer,Deposit,2024-03-26 08:50:53,2024-03-26 08:50:53,Saving vault topup prefunding wallet,-4.00,0.00,EUR,COMPLETED,0.00
Transfer,Deposit,2024-03-26 14:35:32,2024-03-26 14:35:33,Savings Vault topup,5.00,0.00,EUR,COMPLETED,5.00
Transfer,Deposit,2024-03-26 14:35:33,2024-03-26 14:35:33,Saving vault topup prefunding wallet,-5.00,0.00,EUR,COMPLETED,0.00
Transfer,Deposit,2024-03-26 17:41:46,2024-03-26 17:41:46,Savings Vault topup,5.00,0.00,EUR,COMPLETED,5.00
Transfer,Deposit,2024-03-26 17:41:46,2024-03-26 17:41:46,Saving vault topup prefunding wallet,-5.00,0.00,EUR,COMPLETED,0.00
Transfer,Deposit,2024-03-27 19:37:41,2024-03-27 19:37:41,Savings Vault topup,5.00,0.00,EUR,COMPLETED,5.00
Transfer,Deposit,2024-03-27 19:37:41,2024-03-27 19:37:41,Saving vault topup prefunding wallet,-5.00,0.00,EUR,COMPLETED,0.00
Transfer,Deposit,2024-03-27 20:15:31,2024-03-27 20:15:31,Savings Vault topup,0.50,0.00,EUR,COMPLETED,0.50
Transfer,Deposit,2024-03-27 20:15:31,2024-03-27 20:15:31,Saving vault topup prefunding wallet,-0.50,0.00,EUR,COMPLETED,0.00
Transfer,Deposit,2024-03-27 21:14:45,2024-03-27 21:14:45,Savings Vault topup,5.00,0.00,EUR,COMPLETED,5.00
Transfer,Deposit,2024-03-27 21:14:45,2024-03-27 21:14:45,Saving vault topup prefunding wallet,-5.00,0.00,EUR,COMPLETED,0.00
Transfer,Deposit,2024-03-28 08:32:01,2024-03-28 08:32:01,Savings Vault topup,2.80,0.00,EUR,COMPLETED,2.80
Transfer,Deposit,2024-03-28 08:32:01,2024-03-28 08:32:01,Saving vault topup prefunding wallet,-2.80,0.00,EUR,COMPLETED,0.00
Transfer,Deposit,2024-03-28 12:46:04,2024-03-28 12:46:04,Savings Vault topup,750.00,0.00,EUR,COMPLETED,750.00
Transfer,Deposit,2024-03-28 12:46:04,2024-03-28 12:46:04,Saving vault topup prefunding wallet,-750.00,0.00,EUR,COMPLETED,0.00
Transfer,Deposit,2024-03-28 19:06:31,2024-03-28 19:06:31,Savings Vault topup,1.00,0.00,EUR,COMPLETED,1.00
Transfer,Deposit,2024-03-28 19:06:31,2024-03-28 19:06:31,Saving vault topup prefunding wallet,-1.00,0.00,EUR,COMPLETED,0.00
Transfer,Deposit,2024-03-29 09:17:25,2024-03-29 09:17:25,Savings Vault topup,5.00,0.00,EUR,COMPLETED,5.00
Transfer,Deposit,2024-03-29 09:17:25,2024-03-29 09:17:25,Saving vault topup prefunding wallet,-5.00,0.00,EUR,COMPLETED,0.00
Transfer,Deposit,2024-03-29 17:27:57,2024-03-29 17:27:57,Savings Vault topup,5.00,0.00,EUR,COMPLETED,5.00
Transfer,Deposit,2024-03-29 17:27:57,2024-03-29 17:27:57,Saving vault topup prefunding wallet,-5.00,0.00,EUR,COMPLETED,0.00
Transfer,Deposit,2024-03-29 23:32:27,2024-03-29 23:32:27,Savings Vault topup,2.50,0.00,EUR,COMPLETED,2.50
Transfer,Deposit,2024-03-29 23:32:27,2024-03-29 23:32:27,Saving vault topup prefunding wallet,-2.50,0.00,EUR,COMPLETED,0.00
Transfer,Deposit,2024-03-30 01:53:45,2024-03-30 01:53:45,Savings Vault topup,1.00,0.00,EUR,COMPLETED,1.00
Transfer,Deposit,2024-03-30 01:53:45,2024-03-30 01:53:45,Saving vault topup prefunding wallet,-1.00,0.00,EUR,COMPLETED,0.00
Transfer,Deposit,2024-03-30 14:12:15,2024-03-30 14:12:15,Savings Vault topup,2.40,0.00,EUR,COMPLETED,2.40
Transfer,Deposit,2024-03-30 14:12:15,2024-03-30 14:12:15,Saving vault topup prefunding wallet,-2.40,0.00,EUR,COMPLETED,0.00
Transfer,Deposit,2024-03-30 16:01:38,2024-03-30 16:01:38,Savings Vault topup,5.00,0.00,EUR,COMPLETED,5.00
Transfer,Deposit,2024-03-30 16:01:38,2024-03-30 16:01:38,Saving vault topup prefunding wallet,-5.00,0.00,EUR,COMPLETED,0.00
Transfer,Deposit,2024-03-30 18:55:01,2024-03-30 18:55:01,Savings vault withdrawal from prefunding wallet,200.00,0.00,EUR,COMPLETED,200.00
Transfer,Deposit,2024-03-30 18:55:01,2024-03-30 18:55:01,From Flexible account,-200.00,0.00,EUR,COMPLETED,0.00
Transfer,Deposit,2024-03-30 19:11:46,2024-03-30 19:11:46,Savings Vault topup,5.00,0.00,EUR,COMPLETED,5.00
Transfer,Deposit,2024-03-30 19:11:46,2024-03-30 19:11:46,Saving vault topup prefunding wallet,-5.00,0.00,EUR,COMPLETED,0.00
Transfer,Deposit,2024-03-31 12:03:26,2024-03-31 12:03:26,Savings Vault topup,5.00,0.00,EUR,COMPLETED,5.00
Transfer,Deposit,2024-03-31 12:03:26,2024-03-31 12:03:26,Saving vault topup prefunding wallet,-5.00,0.00,EUR,COMPLETED,0.00
Transfer,Deposit,2024-03-31 13:55:59,2024-03-31 13:56:00,Savings Vault topup,2.50,0.00,EUR,COMPLETED,2.50
Transfer,Deposit,2024-03-31 13:56:00,2024-03-31 13:56:00,Saving vault topup prefunding wallet,-2.50,0.00,EUR,COMPLETED,0.00
Transfer,Deposit,2024-03-31 14:55:15,2024-03-31 14:55:15,Savings Vault topup,1.00,0.00,EUR,COMPLETED,1.00
Transfer,Deposit,2024-03-31 14:55:15,2024-03-31 14:55:15,Saving vault topup prefunding wallet,-1.00,0.00,EUR,COMPLETED,0.00
Transfer,Deposit,2024-03-31 20:38:50,2024-03-31 20:38:50,Savings Vault topup,5.00,0.00,EUR,COMPLETED,5.00
Transfer,Deposit,2024-03-31 20:38:50,2024-03-31 20:38:50,Saving vault topup prefunding wallet,-5.00,0.00,EUR,COMPLETED,0.00
Transfer,Deposit,2024-03-31 20:50:06,2024-03-31 20:50:06,Savings Vault topup,1.25,0.00,EUR,COMPLETED,1.25
Transfer,Deposit,2024-03-31 20:50:06,2024-03-31 20:50:06,Saving vault topup prefunding wallet,-1.25,0.00,EUR,COMPLETED,0.00
Transfer,Deposit,2024-04-01 08:34:08,2024-04-01 08:34:08,Savings Vault topup,2.55,0.00,EUR,COMPLETED,2.55
Transfer,Deposit,2024-04-01 08:34:08,2024-04-01 08:34:08,Saving vault topup prefunding wallet,-2.55,0.00,EUR,COMPLETED,0.00
Transfer,Deposit,2024-04-01 17:39:14,2024-04-01 17:39:14,Savings Vault topup,5.00,0.00,EUR,COMPLETED,5.00
Transfer,Deposit,2024-04-01 17:39:14,2024-04-01 17:39:14,Saving vault topup prefunding wallet,-5.00,0.00,EUR,COMPLETED,0.00
Transfer,Deposit,2024-04-02 12:52:48,2024-04-02 12:52:48,Savings Vault topup,2.30,0.00,EUR,COMPLETED,2.30
Transfer,Deposit,2024-04-02 12:52:48,2024-04-02 12:52:48,Saving vault topup prefunding wallet,-2.30,0.00,EUR,COMPLETED,0.00
Transfer,Deposit,2024-04-02 19:10:00,2024-04-02 19:10:00,Savings Vault topup,3.50,0.00,EUR,COMPLETED,3.50
Transfer,Deposit,2024-04-02 19:10:00,2024-04-02 19:10:00,Saving vault topup prefunding wallet,-3.50,0.00,EUR,COMPLETED,0.00
Transfer,Deposit,2024-04-03 09:27:26,2024-04-03 09:27:26,Savings Vault topup,1.50,0.00,EUR,COMPLETED,1.50
Transfer,Deposit,2024-04-03 09:27:26,2024-04-03 09:27:26,Saving vault topup prefunding wallet,-1.50,0.00,EUR,COMPLETED,0.00
Transfer,Deposit,2024-04-03 12:40:16,2024-04-03 12:40:16,Savings Vault topup,2.50,0.00,EUR,COMPLETED,2.50
Transfer,Deposit,2024-04-03 12:40:16,2024-04-03 12:40:16,Saving vault topup prefunding wallet,-2.50,0.00,EUR,COMPLETED,0.00
Transfer,Deposit,2024-04-03 12:47:03,2024-04-03 12:47:03,Savings Vault topup,0.75,0.00,EUR,COMPLETED,0.75
Transfer,Deposit,2024-04-03 12:47:03,2024-04-03 12:47:03,Saving vault topup prefunding wallet,-0.75,0.00,EUR,COMPLETED,0.00
Transfer,Deposit,2024-04-03 12:56:20,2024-04-03 12:56:20,Savings Vault topup,5.00,0.00,EUR,COMPLETED,5.00
Transfer,Deposit,2024-04-03 12:56:20,2024-04-03 12:56:20,Saving vault topup prefunding wallet,-5.00,0.00,EUR,COMPLETED,0.00
Transfer,Deposit,2024-04-03 19:39:14,2024-04-03 19:39:14,Savings Vault topup,3.10,0.00,EUR,COMPLETED,3.10
Transfer,Deposit,2024-04-03 19:39:14,2024-04-03 19:39:14,Saving vault topup prefunding wallet,-3.10,0.00,EUR,COMPLETED,0.00
Transfer,Deposit,2024-04-04 02:51:34,2024-04-04 02:51:34,Savings Vault topup,0.05,0.00,EUR,COMPLETED,0.05
Transfer,Deposit,2024-04-04 02:51:34,2024-04-04 02:51:34,Saving vault topup prefunding wallet,-0.05,0.00,EUR,COMPLETED,0.00
Transfer,Deposit,2024-04-04 09:36:20,2024-04-04 09:36:20,Savings Vault topup,0.30,0.00,EUR,COMPLETED,0.30
Transfer,Deposit,2024-04-04 09:36:20,2024-04-04 09:36:20,Saving vault topup prefunding wallet,-0.30,0.00,EUR,COMPLETED,0.00
Transfer,Deposit,2024-04-04 16:32:36,2024-04-04 16:32:36,Savings Vault topup,5.00,0.00,EUR,COMPLETED,5.00
Transfer,Deposit,2024-04-04 16:32:36,2024-04-04 16:32:36,Saving vault topup prefunding wallet,-5.00,0.00,EUR,COMPLETED,0.00
Transfer,Deposit,2024-04-04 16:32:56,2024-04-04 16:32:56,Savings Vault topup,5.00,0.00,EUR,COMPLETED,5.00
Transfer,Deposit,2024-04-04 16:32:56,2024-04-04 16:32:56,Saving vault topup prefunding wallet,-5.00,0.00,EUR,COMPLETED,0.00
Transfer,Deposit,2024-04-04 20:31:55,2024-04-04 20:31:55,Savings Vault topup,1.20,0.00,EUR,COMPLETED,1.20
Transfer,Deposit,2024-04-04 20:31:55,2024-04-04 20:31:55,Saving vault topup prefunding wallet,-1.20,0.00,EUR,COMPLETED,0.00
Transfer,Deposit,2024-04-05 08:13:25,2024-04-05 08:13:25,Savings Vault topup,2.00,0.00,EUR,COMPLETED,2.00
Transfer,Deposit,2024-04-05 08:13:25,2024-04-05 08:13:25,Saving vault topup prefunding wallet,-2.00,0.00,EUR,COMPLETED,0.00
Transfer,Deposit,2024-04-05 18:12:45,2024-04-05 18:12:45,Savings Vault topup,0.10,0.00,EUR,COMPLETED,0.10
Transfer,Deposit,2024-04-05 18:12:45,2024-04-05 18:12:45,Saving vault topup prefunding wallet,-0.10,0.00,EUR,COMPLETED,0.00
Transfer,Deposit,2024-04-06 15:40:06,2024-04-06 15:40:06,Savings vault withdrawal from prefunding wallet,50.00,0.00,EUR,COMPLETED,50.00
Transfer,Deposit,2024-04-06 15:40:06,2024-04-06 15:40:06,From Flexible account,-50.00,0.00,EUR,COMPLETED,0.00
Transfer,Deposit,2024-04-06 15:41:56,2024-04-06 15:41:56,Savings Vault topup,4.50,0.00,EUR,COMPLETED,4.50
Transfer,Deposit,2024-04-06 15:41:56,2024-04-06 15:41:56,Saving vault topup prefunding wallet,-4.50,0.00,EUR,COMPLETED,0.00
Transfer,Deposit,2024-04-06 16:23:42,2024-04-06 16:23:42,Savings Vault topup,4.50,0.00,EUR,COMPLETED,4.50
Transfer,Deposit,2024-04-06 16:23:42,2024-04-06 16:23:42,Saving vault topup prefunding wallet,-4.50,0.00,EUR,COMPLETED,0.00
Transfer,Deposit,2024-04-06 16:58:10,2024-04-06 16:58:10,Savings Vault topup,2.70,0.00,EUR,COMPLETED,2.70
Transfer,Deposit,2024-04-06 16:58:10,2024-04-06 16:58:10,Saving vault topup prefunding wallet,-2.70,0.00,EUR,COMPLETED,0.00
Transfer,Deposit,2024-04-07 17:10:08,2024-04-07 17:10:08,Savings Vault topup,5.00,0.00,EUR,COMPLETED,5.00
Transfer,Deposit,2024-04-07 17:10:08,2024-04-07 17:10:08,Saving vault topup prefunding wallet,-5.00,0.00,EUR,COMPLETED,0.00
Transfer,Deposit,2024-04-07 17:10:54,2024-04-07 17:10:54,Savings vault withdrawal from prefunding wallet,100.00,0.00,EUR,COMPLETED,100.00
Transfer,Deposit,2024-04-07 17:10:54,2024-04-07 17:10:54,From Flexible account,-100.00,0.00,EUR,COMPLETED,0.00
Transfer,Deposit,2024-04-07 17:57:04,2024-04-07 17:57:04,Savings Vault topup,1.70,0.00,EUR,COMPLETED,1.70
Transfer,Deposit,2024-04-07 17:57:04,2024-04-07 17:57:04,Saving vault topup prefunding wallet,-1.70,0.00,EUR,COMPLETED,0.00
Transfer,Deposit,2024-04-08 09:10:06,2024-04-08 09:10:06,Savings Vault topup,1.50,0.00,EUR,COMPLETED,1.50
Transfer,Deposit,2024-04-08 09:10:06,2024-04-08 09:10:06,Saving vault topup prefunding wallet,-1.50,0.00,EUR,COMPLETED,0.00
Transfer,Deposit,2024-04-08 17:13:24,2024-04-08 17:13:24,Savings Vault topup,2.50,0.00,EUR,COMPLETED,2.50
Transfer,Deposit,2024-04-08 17:13:24,2024-04-08 17:13:24,Saving vault topup prefunding wallet,-2.50,0.00,EUR,COMPLETED,0.00
Transfer,Deposit,2024-04-09 08:34:20,2024-04-09 08:34:21,Savings Vault topup,1.50,0.00,EUR,COMPLETED,1.50
Transfer,Deposit,2024-04-09 08:34:21,2024-04-09 08:34:21,Saving vault topup prefunding wallet,-1.50,0.00,EUR,COMPLETED,0.00
Transfer,Deposit,2024-04-10 17:19:35,2024-04-10 17:19:35,Savings Vault topup,4.00,0.00,EUR,COMPLETED,4.00
Transfer,Deposit,2024-04-10 17:19:35,2024-04-10 17:19:35,Saving vault topup prefunding wallet,-4.00,0.00,EUR,COMPLETED,0.00
Transfer,Deposit,2024-04-11 08:44:00,2024-04-11 08:44:00,Savings vault withdrawal from prefunding wallet,200.00,0.00,EUR,COMPLETED,200.00
Transfer,Deposit,2024-04-11 08:44:00,2024-04-11 08:44:00,From Flexible account,-200.00,0.00,EUR,COMPLETED,0.00
Transfer,Deposit,2024-04-11 17:35:14,2024-04-11 17:35:15,Savings Vault topup,0.05,0.00,EUR,COMPLETED,0.05
Transfer,Deposit,2024-04-11 17:35:15,2024-04-11 17:35:15,Saving vault topup prefunding wallet,-0.05,0.00,EUR,COMPLETED,0.00
Transfer,Deposit,2024-04-12 18:07:06,2024-04-12 18:07:06,Savings Vault topup,5.00,0.00,EUR,COMPLETED,5.00
Transfer,Deposit,2024-04-12 18:07:06,2024-04-12 18:07:06,Saving vault topup prefunding wallet,-5.00,0.00,EUR,COMPLETED,0.00
Transfer,Deposit,2024-04-12 18:08:58,2024-04-12 18:08:58,Savings Vault topup,0.05,0.00,EUR,COMPLETED,0.05
Transfer,Deposit,2024-04-12 18:08:58,2024-04-12 18:08:58,Saving vault topup prefunding wallet,-0.05,0.00,EUR,COMPLETED,0.00
Transfer,Deposit,2024-04-12 19:25:42,2024-04-12 19:25:42,Savings Vault topup,0.05,0.00,EUR,COMPLETED,0.05
Transfer,Deposit,2024-04-12 19:25:42,2024-04-12 19:25:42,Saving vault topup prefunding wallet,-0.05,0.00,EUR,COMPLETED,0.00
Transfer,Deposit,2024-04-12 20:48:18,2024-04-12 20:48:18,Savings Vault topup,3.00,0.00,EUR,COMPLETED,3.00
Transfer,Deposit,2024-04-12 20:48:18,2024-04-12 20:48:18,Saving vault topup prefunding wallet,-3.00,0.00,EUR,COMPLETED,0.00
Transfer,Deposit,2024-04-13 20:47:32,2024-04-13 20:47:32,Savings Vault topup,2.50,0.00,EUR,COMPLETED,2.50
Transfer,Deposit,2024-04-13 20:47:32,2024-04-13 20:47:32,Saving vault topup prefunding wallet,-2.50,0.00,EUR,COMPLETED,0.00
Transfer,Deposit,2024-04-13 22:06:12,2024-04-13 22:06:12,Savings Vault topup,2.50,0.00,EUR,COMPLETED,2.50
Transfer,Deposit,2024-04-13 22:06:12,2024-04-13 22:06:12,Saving vault topup prefunding wallet,-2.50,0.00,EUR,COMPLETED,0.00
Transfer,Deposit,2024-04-14 10:42:30,2024-04-14 10:42:30,Savings vault withdrawal from prefunding wallet,100.00,0.00,EUR,COMPLETED,100.00
Transfer,Deposit,2024-04-14 10:42:30,2024-04-14 10:42:30,From Flexible account,-100.00,0.00,EUR,COMPLETED,0.00
Transfer,Deposit,2024-04-14 10:43:24,2024-04-14 10:43:24,Savings Vault topup,0.75,0.00,EUR,COMPLETED,0.75
Transfer,Deposit,2024-04-14 10:43:24,2024-04-14 10:43:24,Saving vault topup prefunding wallet,-0.75,0.00,EUR,COMPLETED,0.00
Transfer,Deposit,2024-04-14 16:59:03,2024-04-14 16:59:03,Savings Vault topup,1.55,0.00,EUR,COMPLETED,1.55
Transfer,Deposit,2024-04-14 16:59:03,2024-04-14 16:59:03,Saving vault topup prefunding wallet,-1.55,0.00,EUR,COMPLETED,0.00
Transfer,Deposit,2024-04-15 09:06:15,2024-04-15 09:06:15,Savings Vault topup,1.50,0.00,EUR,COMPLETED,1.50
Transfer,Deposit,2024-04-15 09:06:15,2024-04-15 09:06:15,Saving vault topup prefunding wallet,-1.50,0.00,EUR,COMPLETED,0.00
Transfer,Deposit,2024-04-16 09:05:51,2024-04-16 09:05:51,Savings Vault topup,1.50,0.00,EUR,COMPLETED,1.50
Transfer,Deposit,2024-04-16 09:05:51,2024-04-16 09:05:51,Saving vault topup prefunding wallet,-1.50,0.00,EUR,COMPLETED,0.00
Transfer,Deposit,2024-04-16 17:10:05,2024-04-16 17:10:06,Savings Vault topup,2.50,0.00,EUR,COMPLETED,2.50
Transfer,Deposit,2024-04-16 17:10:06,2024-04-16 17:10:06,Saving vault topup prefunding wallet,-2.50,0.00,EUR,COMPLETED,0.00
Transfer,Deposit,2024-04-16 17:13:59,2024-04-16 17:13:59,Savings Vault topup,5.00,0.00,EUR,COMPLETED,5.00
Transfer,Deposit,2024-04-16 17:13:59,2024-04-16 17:13:59,Saving vault topup prefunding wallet,-5.00,0.00,EUR,COMPLETED,0.00
Transfer,Deposit,2024-04-17 18:02:14,2024-04-17 18:02:14,Savings Vault topup,0.40,0.00,EUR,COMPLETED,0.40
Transfer,Deposit,2024-04-17 18:02:14,2024-04-17 18:02:14,Saving vault topup prefunding wallet,-0.40,0.00,EUR,COMPLETED,0.00
Transfer,Deposit,2024-04-17 19:55:14,2024-04-17 19:55:14,Savings vault withdrawal from prefunding wallet,200.00,0.00,EUR,COMPLETED,200.00
Transfer,Deposit,2024-04-17 19:55:14,2024-04-17 19:55:14,From Flexible account,-200.00,0.00,EUR,COMPLETED,0.00
Transfer,Deposit,2024-04-17 21:14:22,2024-04-17 21:14:22,Savings Vault topup,0.75,0.00,EUR,COMPLETED,0.75
Transfer,Deposit,2024-04-17 21:14:22,2024-04-17 21:14:22,Saving vault topup prefunding wallet,-0.75,0.00,EUR,COMPLETED,0.00
Transfer,Deposit,2024-04-18 17:51:40,2024-04-18 17:51:40,Savings Vault topup,4.50,0.00,EUR,COMPLETED,4.50
Transfer,Deposit,2024-04-18 17:51:40,2024-04-18 17:51:40,Saving vault topup prefunding wallet,-4.50,0.00,EUR,COMPLETED,0.00
Transfer,Deposit,2024-04-18 19:23:54,2024-04-18 19:23:54,Savings Vault topup,0.30,0.00,EUR,COMPLETED,0.30
Transfer,Deposit,2024-04-18 19:23:54,2024-04-18 19:23:54,Saving vault topup prefunding wallet,-0.30,0.00,EUR,COMPLETED,0.00
Transfer,Deposit,2024-04-19 08:41:09,2024-04-19 08:41:09,Savings Vault topup,5.00,0.00,EUR,COMPLETED,5.00
Transfer,Deposit,2024-04-19 08:41:09,2024-04-19 08:41:09,Saving vault topup prefunding wallet,-5.00,0.00,EUR,COMPLETED,0.00
Transfer,Deposit,2024-04-20 07:58:39,2024-04-20 07:58:39,Savings Vault topup,5.00,0.00,EUR,COMPLETED,5.00
Transfer,Deposit,2024-04-20 07:58:39,2024-04-20 07:58:39,Saving vault topup prefunding wallet,-5.00,0.00,EUR,COMPLETED,0.00
Transfer,Deposit,2024-04-20 08:01:19,2024-04-20 08:01:19,Savings vault withdrawal from prefunding wallet,100.00,0.00,EUR,COMPLETED,100.00
Transfer,Deposit,2024-04-20 08:01:19,2024-04-20 08:01:19,From Flexible account,-100.00,0.00,EUR,COMPLETED,0.00
Transfer,Deposit,2024-04-20 14:37:24,2024-04-20 14:37:24,Savings Vault topup,1.85,0.00,EUR,COMPLETED,1.85
Transfer,Deposit,2024-04-20 14:37:24,2024-04-20 14:37:24,Saving vault topup prefunding wallet,-1.85,0.00,EUR,COMPLETED,0.00
Transfer,Deposit,2024-04-20 16:39:37,2024-04-20 16:39:37,Savings Vault topup,5.00,0.00,EUR,COMPLETED,5.00
Transfer,Deposit,2024-04-20 16:39:37,2024-04-20 16:39:37,Saving vault topup prefunding wallet,-5.00,0.00,EUR,COMPLETED,0.00
Transfer,Deposit,2024-04-20 18:17:34,2024-04-20 18:17:34,Savings vault withdrawal from prefunding wallet,100.00,0.00,EUR,COMPLETED,100.00
Transfer,Deposit,2024-04-20 18:17:34,2024-04-20 18:17:34,From Flexible account,-100.00,0.00,EUR,COMPLETED,0.00
Transfer,Deposit,2024-04-20 18:18:05,2024-04-20 18:18:05,Savings Vault topup,3.90,0.00,EUR,COMPLETED,3.90
Transfer,Deposit,2024-04-20 18:18:05,2024-04-20 18:18:05,Saving vault topup prefunding wallet,-3.90,0.00,EUR,COMPLETED,0.00
Transfer,Deposit,2024-04-21 14:19:12,2024-04-21 14:19:12,Savings Vault topup,4.50,0.00,EUR,COMPLETED,4.50
Transfer,Deposit,2024-04-21 14:19:12,2024-04-21 14:19:12,Saving vault topup prefunding wallet,-4.50,0.00,EUR,COMPLETED,0.00
Transfer,Deposit,2024-04-21 15:49:43,2024-04-21 15:49:43,Savings Vault topup,3.30,0.00,EUR,COMPLETED,3.30
Transfer,Deposit,2024-04-21 15:49:43,2024-04-21 15:49:43,Saving vault topup prefunding wallet,-3.30,0.00,EUR,COMPLETED,0.00
Transfer,Deposit,2024-04-21 19:17:00,2024-04-21 19:17:00,Savings Vault topup,3.90,0.00,EUR,COMPLETED,3.90
Transfer,Deposit,2024-04-21 19:17:00,2024-04-21 19:17:00,Saving vault topup prefunding wallet,-3.90,0.00,EUR,COMPLETED,0.00
Transfer,Deposit,2024-04-21 19:17:17,2024-04-21 19:17:17,Savings vault withdrawal from prefunding wallet,100.00,0.00,EUR,COMPLETED,100.00
Transfer,Deposit,2024-04-21 19:17:17,2024-04-21 19:17:17,From Flexible account,-100.00,0.00,EUR,COMPLETED,0.00
Transfer,Deposit,2024-04-22 06:42:50,2024-04-22 06:42:50,Savings Vault topup,2.50,0.00,EUR,COMPLETED,2.50
Transfer,Deposit,2024-04-22 06:42:50,2024-04-22 06:42:50,Saving vault topup prefunding wallet,-2.50,0.00,EUR,COMPLETED,0.00
Transfer,Deposit,2024-04-22 19:46:58,2024-04-22 19:46:58,Savings Vault topup,4.00,0.00,EUR,COMPLETED,4.00
Transfer,Deposit,2024-04-22 19:46:58,2024-04-22 19:46:58,Saving vault topup prefunding wallet,-4.00,0.00,EUR,COMPLETED,0.00
Transfer,Deposit,2024-04-23 17:02:48,2024-04-23 17:02:48,Savings Vault topup,2.50,0.00,EUR,COMPLETED,2.50
Transfer,Deposit,2024-04-23 17:02:48,2024-04-23 17:02:48,Saving vault topup prefunding wallet,-2.50,0.00,EUR,COMPLETED,0.00
Transfer,Deposit,2024-04-23 21:12:43,2024-04-23 21:12:43,Savings Vault topup,3.40,0.00,EUR,COMPLETED,3.40
Transfer,Deposit,2024-04-23 21:12:43,2024-04-23 21:12:43,Saving vault topup prefunding wallet,-3.40,0.00,EUR,COMPLETED,0.00
Transfer,Deposit,2024-04-23 21:34:53,2024-04-23 21:34:53,Savings Vault topup,4.25,0.00,EUR,COMPLETED,4.25
Transfer,Deposit,2024-04-23 21:34:53,2024-04-23 21:34:53,Saving vault topup prefunding wallet,-4.25,0.00,EUR,COMPLETED,0.00
Transfer,Deposit,2024-04-24 15:20:46,2024-04-24 15:20:46,Savings Vault topup,3.65,0.00,EUR,COMPLETED,3.65
Transfer,Deposit,2024-04-24 15:20:46,2024-04-24 15:20:46,Saving vault topup prefunding wallet,-3.65,0.00,EUR,COMPLETED,0.00
Transfer,Deposit,2024-04-24 19:33:27,2024-04-24 19:33:27,Savings vault withdrawal from prefunding wallet,1500.00,0.00,EUR,COMPLETED,1500.00
Transfer,Deposit,2024-04-24 19:33:26,2024-04-24 19:33:27,From Flexible account,-1500.00,0.00,EUR,COMPLETED,0.00
Transfer,Deposit,2024-04-25 08:08:11,2024-04-25 08:08:11,Savings Vault topup,4.00,0.00,EUR,COMPLETED,4.00
Transfer,Deposit,2024-04-25 08:08:11,2024-04-25 08:08:11,Saving vault topup prefunding wallet,-4.00,0.00,EUR,COMPLETED,0.00
Transfer,Deposit,2024-04-25 08:09:02,2024-04-25 08:09:02,Savings Vault topup,5500.00,0.00,EUR,COMPLETED,5500.00
Transfer,Deposit,2024-04-25 08:09:02,2024-04-25 08:09:02,Saving vault topup prefunding wallet,-5500.00,0.00,EUR,COMPLETED,0.00
Transfer,Deposit,2024-04-25 08:25:51,2024-04-25 08:25:51,Savings Vault topup,2.75,0.00,EUR,COMPLETED,2.75
Transfer,Deposit,2024-04-25 08:25:51,2024-04-25 08:25:51,Saving vault topup prefunding wallet,-2.75,0.00,EUR,COMPLETED,0.00
Transfer,Deposit,2024-04-25 11:31:18,2024-04-25 11:31:18,Savings Vault topup,3.75,0.00,EUR,COMPLETED,3.75
Transfer,Deposit,2024-04-25 11:31:18,2024-04-25 11:31:18,Saving vault topup prefunding wallet,-3.75,0.00,EUR,COMPLETED,0.00
Transfer,Deposit,2024-04-26 20:33:18,2024-04-26 20:33:18,Savings Vault topup,3.85,0.00,EUR,COMPLETED,3.85
Transfer,Deposit,2024-04-26 20:33:18,2024-04-26 20:33:18,Saving vault topup prefunding wallet,-3.85,0.00,EUR,COMPLETED,0.00
Transfer,Deposit,2024-04-26 21:43:02,2024-04-26 21:43:02,Savings Vault topup,5.00,0.00,EUR,COMPLETED,5.00
Transfer,Deposit,2024-04-26 21:43:02,2024-04-26 21:43:02,Saving vault topup prefunding wallet,-5.00,0.00,EUR,COMPLETED,0.00
Transfer,Deposit,2024-04-26 21:57:32,2024-04-26 21:57:32,Savings Vault topup,2.50,0.00,EUR,COMPLETED,2.50
Transfer,Deposit,2024-04-26 21:57:32,2024-04-26 21:57:32,Saving vault topup prefunding wallet,-2.50,0.00,EUR,COMPLETED,0.00
Transfer,Deposit,2024-04-26 22:34:31,2024-04-26 22:34:31,Savings Vault topup,3.85,0.00,EUR,COMPLETED,3.85
Transfer,Deposit,2024-04-26 22:34:31,2024-04-26 22:34:31,Saving vault topup prefunding wallet,-3.85,0.00,EUR,COMPLETED,0.00
Transfer,Deposit,2024-04-26 22:44:08,2024-04-26 22:44:08,Savings Vault topup,5.00,0.00,EUR,COMPLETED,5.00
Transfer,Deposit,2024-04-26 22:44:08,2024-04-26 22:44:08,Saving vault topup prefunding wallet,-5.00,0.00,EUR,COMPLETED,0.00
Transfer,Deposit,2024-04-26 23:33:01,2024-04-26 23:33:01,Savings vault withdrawal from prefunding wallet,200.00,0.00,EUR,COMPLETED,200.00
Transfer,Deposit,2024-04-26 23:33:01,2024-04-26 23:33:01,From Flexible account,-200.00,0.00,EUR,COMPLETED,0.00
Transfer,Deposit,2024-04-26 23:51:21,2024-04-26 23:51:21,Savings Vault topup,5.00,0.00,EUR,COMPLETED,5.00
Transfer,Deposit,2024-04-26 23:51:21,2024-04-26 23:51:21,Saving vault topup prefunding wallet,-5.00,0.00,EUR,COMPLETED,0.00
Transfer,Deposit,2024-04-27 03:09:05,2024-04-27 03:09:05,Savings Vault topup,1.00,0.00,EUR,COMPLETED,1.00
Transfer,Deposit,2024-04-27 03:09:05,2024-04-27 03:09:05,Saving vault topup prefunding wallet,-1.00,0.00,EUR,COMPLETED,0.00
Transfer,Deposit,2024-04-27 03:31:36,2024-04-27 03:31:36,Savings Vault topup,5.00,0.00,EUR,COMPLETED,5.00
Transfer,Deposit,2024-04-27 03:31:36,2024-04-27 03:31:36,Saving vault topup prefunding wallet,-5.00,0.00,EUR,COMPLETED,0.00
Transfer,Deposit,2024-04-27 10:19:02,2024-04-27 10:19:02,Savings Vault topup,3.00,0.00,EUR,COMPLETED,3.00
Transfer,Deposit,2024-04-27 10:19:02,2024-04-27 10:19:02,Saving vault topup prefunding wallet,-3.00,0.00,EUR,COMPLETED,0.00
Transfer,Deposit,2024-04-27 11:16:51,2024-04-27 11:16:51,Savings Vault topup,0.05,0.00,EUR,COMPLETED,0.05
Transfer,Deposit,2024-04-27 11:16:51,2024-04-27 11:16:51,Saving vault topup prefunding wallet,-0.05,0.00,EUR,COMPLETED,0.00
Transfer,Deposit,2024-04-27 19:19:14,2024-04-27 19:19:14,Savings Vault topup,5.00,0.00,EUR,COMPLETED,5.00
Transfer,Deposit,2024-04-27 19:19:14,2024-04-27 19:19:14,Saving vault topup prefunding wallet,-5.00,0.00,EUR,COMPLETED,0.00
Transfer,Deposit,2024-04-27 19:29:14,2024-04-27 19:29:14,Savings Vault topup,0.10,0.00,EUR,COMPLETED,0.10
Transfer,Deposit,2024-04-27 19:29:14,2024-04-27 19:29:14,Saving vault topup prefunding wallet,-0.10,0.00,EUR,COMPLETED,0.00
Transfer,Deposit,2024-04-28 11:34:07,2024-04-28 11:34:07,Savings Vault topup,4.80,0.00,EUR,COMPLETED,4.80
Transfer,Deposit,2024-04-28 11:34:07,2024-04-28 11:34:07,Saving vault topup prefunding wallet,-4.80,0.00,EUR,COMPLETED,0.00
Transfer,Deposit,2024-04-29 15:49:53,2024-04-29 15:49:53,Savings vault withdrawal from prefunding wallet,1000.00,0.00,EUR,COMPLETED,1000.00
Transfer,Deposit,2024-04-29 15:49:53,2024-04-29 15:49:53,From Flexible account,-1000.00,0.00,EUR,COMPLETED,0.00
Transfer,Deposit,2024-04-29 19:15:55,2024-04-29 19:15:55,Savings Vault topup,4.40,0.00,EUR,COMPLETED,4.40
Transfer,Deposit,2024-04-29 19:15:55,2024-04-29 19:15:55,Saving vault topup prefunding wallet,-4.40,0.00,EUR,COMPLETED,0.00
Transfer,Deposit,2024-04-30 07:46:38,2024-04-30 07:46:38,Savings Vault topup,2.00,0.00,EUR,COMPLETED,2.00
Transfer,Deposit,2024-04-30 07:46:38,2024-04-30 07:46:38,Saving vault topup prefunding wallet,-2.00,0.00,EUR,COMPLETED,0.00
Transfer,Deposit,2024-04-30 19:21:01,2024-04-30 19:21:01,Savings Vault topup,3.95,0.00,EUR,COMPLETED,3.95
Transfer,Deposit,2024-04-30 19:21:01,2024-04-30 19:21:01,Saving vault topup prefunding wallet,-3.95,0.00,EUR,COMPLETED,0.00
Transfer,Deposit,2024-05-01 16:57:04,2024-05-01 16:57:04,Savings Vault topup,2.50,0.00,EUR,COMPLETED,2.50
Transfer,Deposit,2024-05-01 16:57:04,2024-05-01 16:57:04,Saving vault topup prefunding wallet,-2.50,0.00,EUR,COMPLETED,0.00
Transfer,Deposit,2024-05-01 18:34:23,2024-05-01 18:34:24,Savings Vault topup,5.00,0.00,EUR,COMPLETED,5.00
Transfer,Deposit,2024-05-01 18:34:24,2024-05-01 18:34:24,Saving vault topup prefunding wallet,-5.00,0.00,EUR,COMPLETED,0.00
Transfer,Deposit,2024-05-01 18:34:45,2024-05-01 18:34:45,Savings Vault topup,3.20,0.00,EUR,COMPLETED,3.20
Transfer,Deposit,2024-05-01 18:34:45,2024-05-01 18:34:45,Saving vault topup prefunding wallet,-3.20,0.00,EUR,COMPLETED,0.00
Transfer,Deposit,2024-05-02 08:51:22,2024-05-02 08:51:22,Savings Vault topup,2.55,0.00,EUR,COMPLETED,2.55
Transfer,Deposit,2024-05-02 08:51:22,2024-05-02 08:51:22,Saving vault topup prefunding wallet,-2.55,0.00,EUR,COMPLETED,0.00
Transfer,Deposit,2024-05-02 12:13:51,2024-05-02 12:13:51,Savings Vault topup,2.35,0.00,EUR,COMPLETED,2.35
Transfer,Deposit,2024-05-02 12:13:51,2024-05-02 12:13:51,Saving vault topup prefunding wallet,-2.35,0.00,EUR,COMPLETED,0.00
Transfer,Deposit,2024-05-02 19:25:20,2024-05-02 19:25:20,Savings Vault topup,3.75,0.00,EUR,COMPLETED,3.75
Transfer,Deposit,2024-05-02 19:25:20,2024-05-02 19:25:20,Saving vault topup prefunding wallet,-3.75,0.00,EUR,COMPLETED,0.00
Transfer,Deposit,2024-05-02 20:40:33,2024-05-02 20:40:34,Savings Vault topup,5.00,0.00,EUR,COMPLETED,5.00
Transfer,Deposit,2024-05-02 20:40:34,2024-05-02 20:40:34,Saving vault topup prefunding wallet,-5.00,0.00,EUR,COMPLETED,0.00
Transfer,Deposit,2024-05-03 07:52:08,2024-05-03 07:52:08,Savings Vault topup,5.00,0.00,EUR,COMPLETED,5.00
Transfer,Deposit,2024-05-03 07:52:08,2024-05-03 07:52:08,Saving vault topup prefunding wallet,-5.00,0.00,EUR,COMPLETED,0.00
Transfer,Deposit,2024-05-03 07:55:57,2024-05-03 07:55:57,Savings Vault topup,2.25,0.00,EUR,COMPLETED,2.25
Transfer,Deposit,2024-05-03 07:55:57,2024-05-03 07:55:57,Saving vault topup prefunding wallet,-2.25,0.00,EUR,COMPLETED,0.00
Transfer,Deposit,2024-05-03 23:02:35,2024-05-03 23:02:35,Savings Vault topup,0.05,0.00,EUR,COMPLETED,0.05
Transfer,Deposit,2024-05-03 23:02:35,2024-05-03 23:02:35,Saving vault topup prefunding wallet,-0.05,0.00,EUR,COMPLETED,0.00
Transfer,Deposit,2024-05-04 02:51:40,2024-05-04 02:51:40,Savings Vault topup,0.05,0.00,EUR,COMPLETED,0.05
Transfer,Deposit,2024-05-04 02:51:40,2024-05-04 02:51:40,Saving vault topup prefunding wallet,-0.05,0.00,EUR,COMPLETED,0.00
Transfer,Deposit,2024-05-04 08:20:34,2024-05-04 08:20:34,Savings vault withdrawal from prefunding wallet,400.00,0.00,EUR,COMPLETED,400.00
Transfer,Deposit,2024-05-04 08:20:33,2024-05-04 08:20:34,From Flexible account,-400.00,0.00,EUR,COMPLETED,0.00
Transfer,Deposit,2024-05-04 08:20:40,2024-05-04 08:20:40,Savings Vault topup,3.50,0.00,EUR,COMPLETED,3.50
Transfer,Deposit,2024-05-04 08:20:40,2024-05-04 08:20:40,Saving vault topup prefunding wallet,-3.50,0.00,EUR,COMPLETED,0.00
Transfer,Deposit,2024-05-04 09:36:27,2024-05-04 09:36:27,Savings Vault topup,0.35,0.00,EUR,COMPLETED,0.35
Transfer,Deposit,2024-05-04 09:36:27,2024-05-04 09:36:27,Saving vault topup prefunding wallet,-0.35,0.00,EUR,COMPLETED,0.00
Transfer,Deposit,2024-05-04 10:11:41,2024-05-04 10:11:41,Savings Vault topup,0.75,0.00,EUR,COMPLETED,0.75
Transfer,Deposit,2024-05-04 10:11:41,2024-05-04 10:11:41,Saving vault topup prefunding wallet,-0.75,0.00,EUR,COMPLETED,0.00
Transfer,Deposit,2024-05-04 10:23:11,2024-05-04 10:23:11,Savings Vault topup,0.25,0.00,EUR,COMPLETED,0.25
Transfer,Deposit,2024-05-04 10:23:11,2024-05-04 10:23:11,Saving vault topup prefunding wallet,-0.25,0.00,EUR,COMPLETED,0.00
Transfer,Deposit,2024-05-04 10:40:49,2024-05-04 10:40:49,Savings Vault topup,5.00,0.00,EUR,COMPLETED,5.00
Transfer,Deposit,2024-05-04 10:40:49,2024-05-04 10:40:49,Saving vault topup prefunding wallet,-5.00,0.00,EUR,COMPLETED,0.00
Transfer,Deposit,2024-05-04 12:35:54,2024-05-04 12:35:54,Savings vault withdrawal from prefunding wallet,500.00,0.00,EUR,COMPLETED,500.00
Transfer,Deposit,2024-05-04 12:35:53,2024-05-04 12:35:54,From Flexible account,-500.00,0.00,EUR,COMPLETED,0.00
Transfer,Deposit,2024-05-04 12:36:26,2024-05-04 12:36:26,Savings Vault topup,0.95,0.00,EUR,COMPLETED,0.95
Transfer,Deposit,2024-05-04 12:36:26,2024-05-04 12:36:26,Saving vault topup prefunding wallet,-0.95,0.00,EUR,COMPLETED,0.00
Transfer,Deposit,2024-05-04 13:27:55,2024-05-04 13:27:55,Savings Vault topup,5.00,0.00,EUR,COMPLETED,5.00
Transfer,Deposit,2024-05-04 13:27:55,2024-05-04 13:27:55,Saving vault topup prefunding wallet,-5.00,0.00,EUR,COMPLETED,0.00
Transfer,Deposit,2024-05-04 13:36:41,2024-05-04 13:36:41,Savings Vault topup,1.75,0.00,EUR,COMPLETED,1.75
Transfer,Deposit,2024-05-04 13:36:41,2024-05-04 13:36:41,Saving vault topup prefunding wallet,-1.75,0.00,EUR,COMPLETED,0.00
Transfer,Deposit,2024-05-04 13:38:02,2024-05-04 13:38:02,Savings Vault topup,3.00,0.00,EUR,COMPLETED,3.00
Transfer,Deposit,2024-05-04 13:38:02,2024-05-04 13:38:02,Saving vault topup prefunding wallet,-3.00,0.00,EUR,COMPLETED,0.00
Transfer,Deposit,2024-05-04 13:52:30,2024-05-04 13:52:30,Savings Vault topup,0.05,0.00,EUR,COMPLETED,0.05
Transfer,Deposit,2024-05-04 13:52:30,2024-05-04 13:52:30,Saving vault topup prefunding wallet,-0.05,0.00,EUR,COMPLETED,0.00
Transfer,Deposit,2024-05-04 14:22:44,2024-05-04 14:22:44,Savings Vault topup,1.00,0.00,EUR,COMPLETED,1.00
Transfer,Deposit,2024-05-04 14:22:44,2024-05-04 14:22:44,Saving vault topup prefunding wallet,-1.00,0.00,EUR,COMPLETED,0.00
Transfer,Deposit,2024-05-04 18:44:00,2024-05-04 18:44:00,Savings Vault topup,3.50,0.00,EUR,COMPLETED,3.50
Transfer,Deposit,2024-05-04 18:44:00,2024-05-04 18:44:00,Saving vault topup prefunding wallet,-3.50,0.00,EUR,COMPLETED,0.00
Transfer,Deposit,2024-05-04 21:24:00,2024-05-04 21:24:00,Savings Vault topup,1.75,0.00,EUR,COMPLETED,1.75
Transfer,Deposit,2024-05-04 21:24:00,2024-05-04 21:24:00,Saving vault topup prefunding wallet,-1.75,0.00,EUR,COMPLETED,0.00
Transfer,Deposit,2024-05-05 09:08:06,2024-05-05 09:08:06,Savings Vault topup,2.00,0.00,EUR,COMPLETED,2.00
Transfer,Deposit,2024-05-05 09:08:06,2024-05-05 09:08:06,Saving vault topup prefunding wallet,-2.00,0.00,EUR,COMPLETED,0.00
Transfer,Deposit,2024-05-05 11:06:37,2024-05-05 11:06:37,Savings Vault topup,5.00,0.00,EUR,COMPLETED,5.00
Transfer,Deposit,2024-05-05 11:06:37,2024-05-05 11:06:37,Saving vault topup prefunding wallet,-5.00,0.00,EUR,COMPLETED,0.00
Transfer,Deposit,2024-05-05 11:25:46,2024-05-05 11:25:47,Savings Vault topup,3.00,0.00,EUR,COMPLETED,3.00
Transfer,Deposit,2024-05-05 11:25:47,2024-05-05 11:25:47,Saving vault topup prefunding wallet,-3.00,0.00,EUR,COMPLETED,0.00
Transfer,Deposit,2024-05-05 11:29:19,2024-05-05 11:29:19,Savings Vault topup,5.00,0.00,EUR,COMPLETED,5.00
Transfer,Deposit,2024-05-05 11:29:19,2024-05-05 11:29:19,Saving vault topup prefunding wallet,-5.00,0.00,EUR,COMPLETED,0.00
Transfer,Deposit,2024-05-05 13:30:31,2024-05-05 13:30:31,Savings Vault topup,0.25,0.00,EUR,COMPLETED,0.25
Transfer,Deposit,2024-05-05 13:30:31,2024-05-05 13:30:31,Saving vault topup prefunding wallet,-0.25,0.00,EUR,COMPLETED,0.00
Transfer,Deposit,2024-05-05 13:40:52,2024-05-05 13:40:52,Savings Vault topup,0.05,0.00,EUR,COMPLETED,0.05
Transfer,Deposit,2024-05-05 13:40:52,2024-05-05 13:40:52,Saving vault topup prefunding wallet,-0.05,0.00,EUR,COMPLETED,0.00
Transfer,Deposit,2024-05-05 13:43:41,2024-05-05 13:43:41,Savings Vault topup,2.55,0.00,EUR,COMPLETED,2.55
Transfer,Deposit,2024-05-05 13:43:41,2024-05-05 13:43:41,Saving vault topup prefunding wallet,-2.55,0.00,EUR,COMPLETED,0.00
Transfer,Deposit,2024-05-05 13:50:55,2024-05-05 13:50:56,Savings Vault topup,3.25,0.00,EUR,COMPLETED,3.25
Transfer,Deposit,2024-05-05 13:50:56,2024-05-05 13:50:56,Saving vault topup prefunding wallet,-3.25,0.00,EUR,COMPLETED,0.00
Transfer,Deposit,2024-05-05 14:06:33,2024-05-05 14:06:33,Savings Vault topup,0.25,0.00,EUR,COMPLETED,0.25
Transfer,Deposit,2024-05-05 14:06:33,2024-05-05 14:06:33,Saving vault topup prefunding wallet,-0.25,0.00,EUR,COMPLETED,0.00
Transfer,Deposit,2024-05-05 14:43:34,2024-05-05 14:43:34,Savings Vault topup,2.50,0.00,EUR,COMPLETED,2.50
Transfer,Deposit,2024-05-05 14:43:34,2024-05-05 14:43:34,Saving vault topup prefunding wallet,-2.50,0.00,EUR,COMPLETED,0.00
Transfer,Deposit,2024-05-06 01:03:23,2024-05-06 01:03:23,Savings Vault topup,3.50,0.00,EUR,COMPLETED,3.50
Transfer,Deposit,2024-05-06 01:03:23,2024-05-06 01:03:23,Saving vault topup prefunding wallet,-3.50,0.00,EUR,COMPLETED,0.00
Transfer,Deposit,2024-05-06 11:35:05,2024-05-06 11:35:05,Savings Vault topup,4.25,0.00,EUR,COMPLETED,4.25
Transfer,Deposit,2024-05-06 11:35:05,2024-05-06 11:35:05,Saving vault topup prefunding wallet,-4.25,0.00,EUR,COMPLETED,0.00
Transfer,Deposit,2024-05-06 11:58:25,2024-05-06 11:58:25,Savings Vault topup,2.50,0.00,EUR,COMPLETED,2.50
Transfer,Deposit,2024-05-06 11:58:25,2024-05-06 11:58:25,Saving vault topup prefunding wallet,-2.50,0.00,EUR,COMPLETED,0.00
Transfer,Deposit,2024-05-06 13:28:29,2024-05-06 13:28:29,Savings Vault topup,5.00,0.00,EUR,COMPLETED,5.00
Transfer,Deposit,2024-05-06 13:28:29,2024-05-06 13:28:29,Saving vault topup prefunding wallet,-5.00,0.00,EUR,COMPLETED,0.00
Transfer,Deposit,2024-05-06 14:15:44,2024-05-06 14:15:44,Savings Vault topup,3.50,0.00,EUR,COMPLETED,3.50
Transfer,Deposit,2024-05-06 14:15:44,2024-05-06 14:15:44,Saving vault topup prefunding wallet,-3.50,0.00,EUR,COMPLETED,0.00
Transfer,Deposit,2024-05-06 17:16:32,2024-05-06 17:16:32,Savings Vault topup,4.25,0.00,EUR,COMPLETED,4.25
Transfer,Deposit,2024-05-06 17:16:32,2024-05-06 17:16:32,Saving vault topup prefunding wallet,-4.25,0.00,EUR,COMPLETED,0.00
Transfer,Deposit,2024-05-06 19:33:49,2024-05-06 19:33:49,Savings Vault topup,2.50,0.00,EUR,COMPLETED,2.50
Transfer,Deposit,2024-05-06 19:33:49,2024-05-06 19:33:49,Saving vault topup prefunding wallet,-2.50,0.00,EUR,COMPLETED,0.00
Transfer,Deposit,2024-05-06 20:08:06,2024-05-06 20:08:07,Savings Vault topup,5.00,0.00,EUR,COMPLETED,5.00
Transfer,Deposit,2024-05-06 20:08:07,2024-05-06 20:08:07,Saving vault topup prefunding wallet,-5.00,0.00,EUR,COMPLETED,0.00
Transfer,Deposit,2024-05-06 21:54:14,2024-05-06 21:54:14,Savings Vault topup,5.00,0.00,EUR,COMPLETED,5.00
Transfer,Deposit,2024-05-06 21:54:14,2024-05-06 21:54:14,Saving vault topup prefunding wallet,-5.00,0.00,EUR,COMPLETED,0.00
Transfer,Deposit,2024-05-06 22:40:03,2024-05-06 22:40:03,Savings Vault topup,5.00,0.00,EUR,COMPLETED,5.00
Transfer,Deposit,2024-05-06 22:40:03,2024-05-06 22:40:03,Saving vault topup prefunding wallet,-5.00,0.00,EUR,COMPLETED,0.00
Transfer,Deposit,2024-05-07 00:05:21,2024-05-07 00:05:21,Savings Vault topup,5.00,0.00,EUR,COMPLETED,5.00
Transfer,Deposit,2024-05-07 00:05:21,2024-05-07 00:05:21,Saving vault topup prefunding wallet,-5.00,0.00,EUR,COMPLETED,0.00
Transfer,Deposit,2024-05-07 00:40:30,2024-05-07 00:40:30,Savings Vault topup,5.00,0.00,EUR,COMPLETED,5.00
Transfer,Deposit,2024-05-07 00:40:30,2024-05-07 00:40:30,Saving vault topup prefunding wallet,-5.00,0.00,EUR,COMPLETED,0.00
Transfer,Deposit,2024-05-07 09:47:36,2024-05-07 09:47:36,Savings Vault topup,3.00,0.00,EUR,COMPLETED,3.00
Transfer,Deposit,2024-05-07 09:47:36,2024-05-07 09:47:36,Saving vault topup prefunding wallet,-3.00,0.00,EUR,COMPLETED,0.00
Transfer,Deposit,2024-05-07 12:21:44,2024-05-07 12:21:44,Savings Vault topup,3.75,0.00,EUR,COMPLETED,3.75
Transfer,Deposit,2024-05-07 12:21:44,2024-05-07 12:21:44,Saving vault topup prefunding wallet,-3.75,0.00,EUR,COMPLETED,0.00
Transfer,Deposit,2024-05-07 12:59:10,2024-05-07 12:59:10,Savings Vault topup,2.20,0.00,EUR,COMPLETED,2.20
Transfer,Deposit,2024-05-07 12:59:10,2024-05-07 12:59:10,Saving vault topup prefunding wallet,-2.20,0.00,EUR,COMPLETED,0.00
Transfer,Deposit,2024-05-07 18:37:22,2024-05-07 18:37:22,Savings vault withdrawal from prefunding wallet,170.00,0.00,EUR,COMPLETED,170.00
Transfer,Deposit,2024-05-07 18:37:22,2024-05-07 18:37:22,From Flexible account,-170.00,0.00,EUR,COMPLETED,0.00
Transfer,Deposit,2024-05-07 18:40:34,2024-05-07 18:40:34,Savings Vault topup,3.50,0.00,EUR,COMPLETED,3.50
Transfer,Deposit,2024-05-07 18:40:34,2024-05-07 18:40:34,Saving vault topup prefunding wallet,-3.50,0.00,EUR,COMPLETED,0.00
Transfer,Deposit,2024-05-07 18:45:19,2024-05-07 18:45:19,Savings Vault topup,3.95,0.00,EUR,COMPLETED,3.95
Transfer,Deposit,2024-05-07 18:45:19,2024-05-07 18:45:19,Saving vault topup prefunding wallet,-3.95,0.00,EUR,COMPLETED,0.00
Transfer,Deposit,2024-05-08 08:11:33,2024-05-08 08:11:33,Savings Vault topup,5.00,0.00,EUR,COMPLETED,5.00
Transfer,Deposit,2024-05-08 08:11:33,2024-05-08 08:11:33,Saving vault topup prefunding wallet,-5.00,0.00,EUR,COMPLETED,0.00
Transfer,Deposit,2024-05-08 09:00:56,2024-05-08 09:00:56,Savings Vault topup,0.55,0.00,EUR,COMPLETED,0.55
Transfer,Deposit,2024-05-08 09:00:56,2024-05-08 09:00:56,Saving vault topup prefunding wallet,-0.55,0.00,EUR,COMPLETED,0.00
Transfer,Deposit,2024-05-08 17:05:45,2024-05-08 17:05:45,Savings vault withdrawal from prefunding wallet,200.00,0.00,EUR,COMPLETED,200.00
Transfer,Deposit,2024-05-08 17:05:45,2024-05-08 17:05:45,From Flexible account,-200.00,0.00,EUR,COMPLETED,0.00
Exchange,Deposit,2024-05-08 17:07:27,2024-05-08 17:07:28,Exchanged to EUR,0.11,0.00,EUR,COMPLETED,0.11
Transfer,Deposit,2024-05-08 17:07:28,2024-05-08 17:07:28,Saving vault topup prefunding wallet,-0.11,0.00,EUR,COMPLETED,0.00
Transfer,Deposit,2024-05-08 17:38:23,2024-05-08 17:38:23,Savings Vault topup,0.65,0.00,EUR,COMPLETED,0.65
Transfer,Deposit,2024-05-08 17:38:23,2024-05-08 17:38:23,Saving vault topup prefunding wallet,-0.65,0.00,EUR,COMPLETED,0.00
Transfer,Deposit,2024-05-09 09:03:02,2024-05-09 09:03:02,Savings Vault topup,1.50,0.00,EUR,COMPLETED,1.50
Transfer,Deposit,2024-05-09 09:03:02,2024-05-09 09:03:02,Saving vault topup prefunding wallet,-1.50,0.00,EUR,COMPLETED,0.00
Transfer,Deposit,2024-05-10 20:17:11,2024-05-10 20:17:11,Savings Vault topup,5.00,0.00,EUR,COMPLETED,5.00
Transfer,Deposit,2024-05-10 20:17:11,2024-05-10 20:17:11,Saving vault topup prefunding wallet,-5.00,0.00,EUR,COMPLETED,0.00
Transfer,Deposit,2024-05-11 08:45:09,2024-05-11 08:45:09,Savings Vault topup,0.05,0.00,EUR,COMPLETED,0.05
Transfer,Deposit,2024-05-11 08:45:09,2024-05-11 08:45:09,Saving vault topup prefunding wallet,-0.05,0.00,EUR,COMPLETED,0.00
Transfer,Deposit,2024-05-11 09:21:17,2024-05-11 09:21:17,Savings Vault topup,5.00,0.00,EUR,COMPLETED,5.00
Transfer,Deposit,2024-05-11 09:21:17,2024-05-11 09:21:17,Saving vault topup prefunding wallet,-5.00,0.00,EUR,COMPLETED,0.00
Transfer,Deposit,2024-05-11 10:11:18,2024-05-11 10:11:18,Savings vault withdrawal from prefunding wallet,200.00,0.00,EUR,COMPLETED,200.00
Transfer,Deposit,2024-05-11 10:11:17,2024-05-11 10:11:18,From Flexible account,-200.00,0.00,EUR,COMPLETED,0.00
Transfer,Deposit,2024-05-11 10:11:23,2024-05-11 10:11:23,Savings Vault topup,2.35,0.00,EUR,COMPLETED,2.35
Transfer,Deposit,2024-05-11 10:11:23,2024-05-11 10:11:23,Saving vault topup prefunding wallet,-2.35,0.00,EUR,COMPLETED,0.00
Transfer,Deposit,2024-05-11 10:12:22,2024-05-11 10:12:22,Savings Vault topup,0.05,0.00,EUR,COMPLETED,0.05
Transfer,Deposit,2024-05-11 10:12:22,2024-05-11 10:12:22,Saving vault topup prefunding wallet,-0.05,0.00,EUR,COMPLETED,0.00
Transfer,Deposit,2024-05-11 15:36:47,2024-05-11 15:36:47,Savings Vault topup,4.75,0.00,EUR,COMPLETED,4.75
Transfer,Deposit,2024-05-11 15:36:47,2024-05-11 15:36:47,Saving vault topup prefunding wallet,-4.75,0.00,EUR,COMPLETED,0.00
Transfer,Deposit,2024-05-11 16:25:08,2024-05-11 16:25:08,Savings Vault topup,3.25,0.00,EUR,COMPLETED,3.25
Transfer,Deposit,2024-05-11 16:25:08,2024-05-11 16:25:08,Saving vault topup prefunding wallet,-3.25,0.00,EUR,COMPLETED,0.00
Transfer,Deposit,2024-05-12 11:09:55,2024-05-12 11:09:55,Savings Vault topup,2.50,0.00,EUR,COMPLETED,2.50
Transfer,Deposit,2024-05-12 11:09:55,2024-05-12 11:09:55,Saving vault topup prefunding wallet,-2.50,0.00,EUR,COMPLETED,0.00
Transfer,Deposit,2024-05-12 12:44:41,2024-05-12 12:44:41,Savings Vault topup,0.25,0.00,EUR,COMPLETED,0.25
Transfer,Deposit,2024-05-12 12:44:41,2024-05-12 12:44:41,Saving vault topup prefunding wallet,-0.25,0.00,EUR,COMPLETED,0.00
Transfer,Deposit,2024-05-12 13:33:17,2024-05-12 13:33:17,Savings Vault topup,5.00,0.00,EUR,COMPLETED,5.00
Transfer,Deposit,2024-05-12 13:33:17,2024-05-12 13:33:17,Saving vault topup prefunding wallet,-5.00,0.00,EUR,COMPLETED,0.00
Transfer,Deposit,2024-05-12 14:46:51,2024-05-12 14:46:51,Savings Vault topup,5.00,0.00,EUR,COMPLETED,5.00
Transfer,Deposit,2024-05-12 14:46:51,2024-05-12 14:46:51,Saving vault topup prefunding wallet,-5.00,0.00,EUR,COMPLETED,0.00
Transfer,Deposit,2024-05-12 17:20:23,2024-05-12 17:20:23,Savings Vault topup,3.80,0.00,EUR,COMPLETED,3.80
Transfer,Deposit,2024-05-12 17:20:23,2024-05-12 17:20:23,Saving vault topup prefunding wallet,-3.80,0.00,EUR,COMPLETED,0.00
Transfer,Deposit,2024-05-12 17:28:00,2024-05-12 17:28:01,Savings Vault topup,5.00,0.00,EUR,COMPLETED,5.00
Transfer,Deposit,2024-05-12 17:28:01,2024-05-12 17:28:01,Saving vault topup prefunding wallet,-5.00,0.00,EUR,COMPLETED,0.00
Transfer,Deposit,2024-05-13 08:28:31,2024-05-13 08:28:31,Savings Vault topup,1.50,0.00,EUR,COMPLETED,1.50
Transfer,Deposit,2024-05-13 08:28:31,2024-05-13 08:28:31,Saving vault topup prefunding wallet,-1.50,0.00,EUR,COMPLETED,0.00
Transfer,Deposit,2024-05-13 13:01:00,2024-05-13 13:01:00,Savings Vault topup,0.75,0.00,EUR,COMPLETED,0.75
Transfer,Deposit,2024-05-13 13:01:00,2024-05-13 13:01:00,Saving vault topup prefunding wallet,-0.75,0.00,EUR,COMPLETED,0.00
Transfer,Deposit,2024-05-13 20:34:07,2024-05-13 20:34:07,Savings vault withdrawal from prefunding wallet,100.00,0.00,EUR,COMPLETED,100.00
Transfer,Deposit,2024-05-13 20:34:07,2024-05-13 20:34:07,From Flexible account,-100.00,0.00,EUR,COMPLETED,0.00
Transfer,Deposit,2024-05-14 08:45:27,2024-05-14 08:45:27,Savings Vault topup,1.50,0.00,EUR,COMPLETED,1.50
Transfer,Deposit,2024-05-14 08:45:27,2024-05-14 08:45:27,Saving vault topup prefunding wallet,-1.50,0.00,EUR,COMPLETED,0.00
Transfer,Deposit,2024-05-14 13:29:21,2024-05-14 13:29:21,Savings Vault topup,1.25,0.00,EUR,COMPLETED,1.25
Transfer,Deposit,2024-05-14 13:29:21,2024-05-14 13:29:21,Saving vault topup prefunding wallet,-1.25,0.00,EUR,COMPLETED,0.00
Transfer,Deposit,2024-05-14 20:18:48,2024-05-14 20:18:48,Savings vault withdrawal from prefunding wallet,1000.00,0.00,EUR,COMPLETED,1000.00
Transfer,Deposit,2024-05-14 20:18:48,2024-05-14 20:18:48,From Flexible account,-1000.00,0.00,EUR,COMPLETED,0.00
Exchange,Deposit,2024-05-15 21:59:48,2024-05-15 21:59:48,Exchanged to EUR,5.17,0.00,EUR,COMPLETED,5.17
Transfer,Deposit,2024-05-15 21:59:48,2024-05-15 21:59:48,Saving vault topup prefunding wallet,-5.17,0.00,EUR,COMPLETED,0.00
Transfer,Deposit,2024-05-16 08:56:43,2024-05-16 08:56:43,Savings Vault topup,1.50,0.00,EUR,COMPLETED,1.50
Transfer,Deposit,2024-05-16 08:56:43,2024-05-16 08:56:43,Saving vault topup prefunding wallet,-1.50,0.00,EUR,COMPLETED,0.00
Transfer,Deposit,2024-05-16 18:00:15,2024-05-16 18:00:15,Savings Vault topup,2.50,0.00,EUR,COMPLETED,2.50
Transfer,Deposit,2024-05-16 18:00:15,2024-05-16 18:00:15,Saving vault topup prefunding wallet,-2.50,0.00,EUR,COMPLETED,0.00
Transfer,Deposit,2024-05-16 20:21:59,2024-05-16 20:21:59,Savings Vault topup,0.60,0.00,EUR,COMPLETED,0.60
Transfer,Deposit,2024-05-16 20:21:59,2024-05-16 20:21:59,Saving vault topup prefunding wallet,-0.60,0.00,EUR,COMPLETED,0.00
Transfer,Deposit,2024-05-17 08:00:06,2024-05-17 08:00:06,Savings vault withdrawal from prefunding wallet,250.00,0.00,EUR,COMPLETED,250.00
Transfer,Deposit,2024-05-17 08:00:06,2024-05-17 08:00:06,From Flexible account,-250.00,0.00,EUR,COMPLETED,0.00
Transfer,Deposit,2024-05-17 14:01:22,2024-05-17 14:01:22,Savings Vault topup,5.00,0.00,EUR,COMPLETED,5.00
Transfer,Deposit,2024-05-17 14:01:22,2024-05-17 14:01:22,Saving vault topup prefunding wallet,-5.00,0.00,EUR,COMPLETED,0.00
Transfer,Deposit,2024-05-17 14:14:29,2024-05-17 14:14:29,Savings Vault topup,1.50,0.00,EUR,COMPLETED,1.50
Transfer,Deposit,2024-05-17 14:14:29,2024-05-17 14:14:29,Saving vault topup prefunding wallet,-1.50,0.00,EUR,COMPLETED,0.00
Transfer,Deposit,2024-05-17 20:31:50,2024-05-17 20:31:50,Savings Vault topup,5.00,0.00,EUR,COMPLETED,5.00
Transfer,Deposit,2024-05-17 20:31:50,2024-05-17 20:31:50,Saving vault topup prefunding wallet,-5.00,0.00,EUR,COMPLETED,0.00
Transfer,Deposit,2024-05-18 10:25:59,2024-05-18 10:25:59,Savings Vault topup,3.00,0.00,EUR,COMPLETED,3.00
Transfer,Deposit,2024-05-18 10:25:59,2024-05-18 10:25:59,Saving vault topup prefunding wallet,-3.00,0.00,EUR,COMPLETED,0.00
Transfer,Deposit,2024-05-18 11:32:25,2024-05-18 11:32:25,Savings vault withdrawal from prefunding wallet,200.00,0.00,EUR,COMPLETED,200.00
Transfer,Deposit,2024-05-18 11:32:25,2024-05-18 11:32:25,From Flexible account,-200.00,0.00,EUR,COMPLETED,0.00
Transfer,Deposit,2024-05-18 11:32:27,2024-05-18 11:32:27,Savings vault withdrawal from prefunding wallet,200.00,0.00,EUR,COMPLETED,200.00
Transfer,Deposit,2024-05-18 11:32:26,2024-05-18 11:32:27,From Flexible account,-200.00,0.00,EUR,COMPLETED,0.00
Transfer,Deposit,2024-05-18 11:33:48,2024-05-18 11:33:48,Savings Vault topup,4.85,0.00,EUR,COMPLETED,4.85
Transfer,Deposit,2024-05-18 11:33:48,2024-05-18 11:33:48,Saving vault topup prefunding wallet,-4.85,0.00,EUR,COMPLETED,0.00
Transfer,Deposit,2024-05-18 11:35:27,2024-05-18 11:35:27,Savings Vault topup,2.80,0.00,EUR,COMPLETED,2.80
Transfer,Deposit,2024-05-18 11:35:27,2024-05-18 11:35:27,Saving vault topup prefunding wallet,-2.80,0.00,EUR,COMPLETED,0.00
Transfer,Deposit,2024-05-18 15:32:19,2024-05-18 15:32:19,Savings Vault topup,2.50,0.00,EUR,COMPLETED,2.50
Transfer,Deposit,2024-05-18 15:32:19,2024-05-18 15:32:19,Saving vault topup prefunding wallet,-2.50,0.00,EUR,COMPLETED,0.00
Transfer,Deposit,2024-05-19 00:22:12,2024-05-19 00:22:13,Savings Vault topup,5.00,0.00,EUR,COMPLETED,5.00
Transfer,Deposit,2024-05-19 00:22:13,2024-05-19 00:22:13,Saving vault topup prefunding wallet,-5.00,0.00,EUR,COMPLETED,0.00
Transfer,Deposit,2024-05-19 00:51:20,2024-05-19 00:51:20,Savings Vault topup,5.00,0.00,EUR,COMPLETED,5.00
Transfer,Deposit,2024-05-19 00:51:20,2024-05-19 00:51:20,Saving vault topup prefunding wallet,-5.00,0.00,EUR,COMPLETED,0.00
Transfer,Deposit,2024-05-19 01:44:16,2024-05-19 01:44:16,Savings Vault topup,5.00,0.00,EUR,COMPLETED,5.00
Transfer,Deposit,2024-05-19 01:44:16,2024-05-19 01:44:16,Saving vault topup prefunding wallet,-5.00,0.00,EUR,COMPLETED,0.00
Transfer,Deposit,2024-05-19 16:56:06,2024-05-19 16:56:06,Savings Vault topup,2.90,0.00,EUR,COMPLETED,2.90
Transfer,Deposit,2024-05-19 16:56:06,2024-05-19 16:56:06,Saving vault topup prefunding wallet,-2.90,0.00,EUR,COMPLETED,0.00
Transfer,Deposit,2024-05-19 16:59:53,2024-05-19 16:59:53,Savings Vault topup,1.25,0.00,EUR,COMPLETED,1.25
Transfer,Deposit,2024-05-19 16:59:53,2024-05-19 16:59:53,Saving vault topup prefunding wallet,-1.25,0.00,EUR,COMPLETED,0.00
Transfer,Deposit,2024-05-20 09:56:40,2024-05-20 09:56:40,Savings Vault topup,5.00,0.00,EUR,COMPLETED,5.00
Transfer,Deposit,2024-05-20 09:56:40,2024-05-20 09:56:40,Saving vault topup prefunding wallet,-5.00,0.00,EUR,COMPLETED,0.00
Transfer,Deposit,2024-05-20 10:25:03,2024-05-20 10:25:03,Savings Vault topup,2.00,0.00,EUR,COMPLETED,2.00
Transfer,Deposit,2024-05-20 10:25:03,2024-05-20 10:25:03,Saving vault topup prefunding wallet,-2.00,0.00,EUR,COMPLETED,0.00
Transfer,Deposit,2024-05-20 11:02:03,2024-05-20 11:02:03,Savings Vault topup,3.30,0.00,EUR,COMPLETED,3.30
Transfer,Deposit,2024-05-20 11:02:03,2024-05-20 11:02:03,Saving vault topup prefunding wallet,-3.30,0.00,EUR,COMPLETED,0.00
Transfer,Deposit,2024-05-20 11:06:41,2024-05-20 11:06:41,Savings Vault topup,1.25,0.00,EUR,COMPLETED,1.25
Transfer,Deposit,2024-05-20 11:06:41,2024-05-20 11:06:41,Saving vault topup prefunding wallet,-1.25,0.00,EUR,COMPLETED,0.00
Exchange,Deposit,2024-05-20 15:31:33,2024-05-20 15:31:33,Exchanged to EUR,4.14,0.00,EUR,COMPLETED,4.14
Transfer,Deposit,2024-05-20 15:31:33,2024-05-20 15:31:33,Saving vault topup prefunding wallet,-4.14,0.00,EUR,COMPLETED,0.00
Transfer,Deposit,2024-05-20 20:44:16,2024-05-20 20:44:16,Savings Vault topup,4.90,0.00,EUR,COMPLETED,4.90
Transfer,Deposit,2024-05-20 20:44:16,2024-05-20 20:44:16,Saving vault topup prefunding wallet,-4.90,0.00,EUR,COMPLETED,0.00
Transfer,Deposit,2024-05-21 09:12:51,2024-05-21 09:12:52,Savings Vault topup,1.50,0.00,EUR,COMPLETED,1.50
Transfer,Deposit,2024-05-21 09:12:52,2024-05-21 09:12:52,Saving vault topup prefunding wallet,-1.50,0.00,EUR,COMPLETED,0.00
Transfer,Deposit,2024-05-21 18:51:15,2024-05-21 18:51:15,Savings Vault topup,5.00,0.00,EUR,COMPLETED,5.00
Transfer,Deposit,2024-05-21 18:51:15,2024-05-21 18:51:15,Saving vault topup prefunding wallet,-5.00,0.00,EUR,COMPLETED,0.00
Transfer,Deposit,2024-05-22 09:00:39,2024-05-22 09:00:39,Savings Vault topup,2.50,0.00,EUR,COMPLETED,2.50
Transfer,Deposit,2024-05-22 09:00:39,2024-05-22 09:00:39,Saving vault topup prefunding wallet,-2.50,0.00,EUR,COMPLETED,0.00
Transfer,Deposit,2024-05-22 17:10:21,2024-05-22 17:10:21,Savings Vault topup,2.50,0.00,EUR,COMPLETED,2.50
Transfer,Deposit,2024-05-22 17:10:21,2024-05-22 17:10:21,Saving vault topup prefunding wallet,-2.50,0.00,EUR,COMPLETED,0.00
Transfer,Deposit,2024-05-23 18:03:19,2024-05-23 18:03:19,Savings Vault topup,0.25,0.00,EUR,COMPLETED,0.25
Transfer,Deposit,2024-05-23 18:03:19,2024-05-23 18:03:19,Saving vault topup prefunding wallet,-0.25,0.00,EUR,COMPLETED,0.00
Transfer,Deposit,2024-05-23 21:30:41,2024-05-23 21:30:41,Savings Vault topup,4.85,0.00,EUR,COMPLETED,4.85
Transfer,Deposit,2024-05-23 21:30:41,2024-05-23 21:30:41,Saving vault topup prefunding wallet,-4.85,0.00,EUR,COMPLETED,0.00
Transfer,Deposit,2024-05-24 08:30:35,2024-05-24 08:30:35,Savings Vault topup,4.70,0.00,EUR,COMPLETED,4.70
Transfer,Deposit,2024-05-24 08:30:35,2024-05-24 08:30:35,Saving vault topup prefunding wallet,-4.70,0.00,EUR,COMPLETED,0.00
Transfer,Deposit,2024-05-24 19:08:19,2024-05-24 19:08:19,Savings Vault topup,5.00,0.00,EUR,COMPLETED,5.00
Transfer,Deposit,2024-05-24 19:08:19,2024-05-24 19:08:19,Saving vault topup prefunding wallet,-5.00,0.00,EUR,COMPLETED,0.00
Transfer,Deposit,2024-05-24 19:18:05,2024-05-24 19:18:05,Savings Vault topup,3.50,0.00,EUR,COMPLETED,3.50
Transfer,Deposit,2024-05-24 19:18:05,2024-05-24 19:18:05,Saving vault topup prefunding wallet,-3.50,0.00,EUR,COMPLETED,0.00
Transfer,Deposit,2024-05-24 19:20:30,2024-05-24 19:20:30,Savings Vault topup,5.00,0.00,EUR,COMPLETED,5.00
Transfer,Deposit,2024-05-24 19:20:30,2024-05-24 19:20:30,Saving vault topup prefunding wallet,-5.00,0.00,EUR,COMPLETED,0.00
Transfer,Deposit,2024-05-25 11:56:48,2024-05-25 11:56:48,Savings Vault topup,4.50,0.00,EUR,COMPLETED,4.50
Transfer,Deposit,2024-05-25 11:56:48,2024-05-25 11:56:48,Saving vault topup prefunding wallet,-4.50,0.00,EUR,COMPLETED,0.00
Transfer,Deposit,2024-05-25 13:47:32,2024-05-25 13:47:32,Savings Vault topup,1.25,0.00,EUR,COMPLETED,1.25
Transfer,Deposit,2024-05-25 13:47:32,2024-05-25 13:47:32,Saving vault topup prefunding wallet,-1.25,0.00,EUR,COMPLETED,0.00
Transfer,Deposit,2024-05-25 15:18:23,2024-05-25 15:18:23,Savings Vault topup,5.00,0.00,EUR,COMPLETED,5.00
Transfer,Deposit,2024-05-25 15:18:23,2024-05-25 15:18:23,Saving vault topup prefunding wallet,-5.00,0.00,EUR,COMPLETED,0.00
Transfer,Deposit,2024-05-25 16:20:46,2024-05-25 16:20:46,Savings Vault topup,3.00,0.00,EUR,COMPLETED,3.00
Transfer,Deposit,2024-05-25 16:20:46,2024-05-25 16:20:46,Saving vault topup prefunding wallet,-3.00,0.00,EUR,COMPLETED,0.00
Transfer,Deposit,2024-05-25 16:55:36,2024-05-25 16:55:36,Savings Vault topup,5.00,0.00,EUR,COMPLETED,5.00
Transfer,Deposit,2024-05-25 16:55:36,2024-05-25 16:55:36,Saving vault topup prefunding wallet,-5.00,0.00,EUR,COMPLETED,0.00
Transfer,Deposit,2024-05-26 11:54:40,2024-05-26 11:54:40,Savings Vault topup,2.80,0.00,EUR,COMPLETED,2.80
Transfer,Deposit,2024-05-26 11:54:40,2024-05-26 11:54:40,Saving vault topup prefunding wallet,-2.80,0.00,EUR,COMPLETED,0.00
Transfer,Deposit,2024-05-26 12:40:46,2024-05-26 12:40:46,Savings Vault topup,5.00,0.00,EUR,COMPLETED,5.00
Transfer,Deposit,2024-05-26 12:40:46,2024-05-26 12:40:46,Saving vault topup prefunding wallet,-5.00,0.00,EUR,COMPLETED,0.00
Transfer,Deposit,2024-05-26 13:51:37,2024-05-26 13:51:37,Savings Vault topup,0.25,0.00,EUR,COMPLETED,0.25
Transfer,Deposit,2024-05-26 13:51:37,2024-05-26 13:51:37,Saving vault topup prefunding wallet,-0.25,0.00,EUR,COMPLETED,0.00
Transfer,Deposit,2024-05-26 16:15:32,2024-05-26 16:15:32,Savings Vault topup,5.00,0.00,EUR,COMPLETED,5.00
Transfer,Deposit,2024-05-26 16:15:32,2024-05-26 16:15:32,Saving vault topup prefunding wallet,-5.00,0.00,EUR,COMPLETED,0.00
Transfer,Deposit,2024-05-26 17:33:08,2024-05-26 17:33:08,Savings Vault topup,2.50,0.00,EUR,COMPLETED,2.50
Transfer,Deposit,2024-05-26 17:33:08,2024-05-26 17:33:08,Saving vault topup prefunding wallet,-2.50,0.00,EUR,COMPLETED,0.00
Transfer,Deposit,2024-05-26 18:49:44,2024-05-26 18:49:44,Savings Vault topup,0.80,0.00,EUR,COMPLETED,0.80
Transfer,Deposit,2024-05-26 18:49:44,2024-05-26 18:49:44,Saving vault topup prefunding wallet,-0.80,0.00,EUR,COMPLETED,0.00
Transfer,Deposit,2024-05-27 14:37:56,2024-05-27 14:37:56,Savings Vault topup,3.50,0.00,EUR,COMPLETED,3.50
Transfer,Deposit,2024-05-27 14:37:56,2024-05-27 14:37:56,Saving vault topup prefunding wallet,-3.50,0.00,EUR,COMPLETED,0.00
Transfer,Deposit,2024-05-27 18:34:44,2024-05-27 18:34:45,Savings Vault topup,1.85,0.00,EUR,COMPLETED,1.85
Transfer,Deposit,2024-05-27 18:34:45,2024-05-27 18:34:45,Saving vault topup prefunding wallet,-1.85,0.00,EUR,COMPLETED,0.00
Transfer,Deposit,2024-05-28 09:23:26,2024-05-28 09:23:26,Savings Vault topup,1.50,0.00,EUR,COMPLETED,1.50
Transfer,Deposit,2024-05-28 09:23:26,2024-05-28 09:23:26,Saving vault topup prefunding wallet,-1.50,0.00,EUR,COMPLETED,0.00
Transfer,Deposit,2024-05-28 17:28:04,2024-05-28 17:28:04,Savings Vault topup,5.00,0.00,EUR,COMPLETED,5.00
Transfer,Deposit,2024-05-28 17:28:04,2024-05-28 17:28:04,Saving vault topup prefunding wallet,-5.00,0.00,EUR,COMPLETED,0.00
Transfer,Deposit,2024-05-28 19:44:48,2024-05-28 19:44:48,Savings Vault topup,1.45,0.00,EUR,COMPLETED,1.45
Transfer,Deposit,2024-05-28 19:44:48,2024-05-28 19:44:48,Saving vault topup prefunding wallet,-1.45,0.00,EUR,COMPLETED,0.00
Transfer,Deposit,2024-05-29 20:15:29,2024-05-29 20:15:29,Savings Vault topup,5.00,0.00,EUR,COMPLETED,5.00
Transfer,Deposit,2024-05-29 20:15:29,2024-05-29 20:15:29,Saving vault topup prefunding wallet,-5.00,0.00,EUR,COMPLETED,0.00
Transfer,Deposit,2024-05-29 20:34:21,2024-05-29 20:34:21,Savings Vault topup,3.50,0.00,EUR,COMPLETED,3.50
Transfer,Deposit,2024-05-29 20:34:21,2024-05-29 20:34:21,Saving vault topup prefunding wallet,-3.50,0.00,EUR,COMPLETED,0.00
Transfer,Deposit,2024-05-29 22:45:35,2024-05-29 22:45:35,Savings Vault topup,2.50,0.00,EUR,COMPLETED,2.50
Transfer,Deposit,2024-05-29 22:45:35,2024-05-29 22:45:35,Saving vault topup prefunding wallet,-2.50,0.00,EUR,COMPLETED,0.00
Transfer,Deposit,2024-05-30 01:08:04,2024-05-30 01:08:04,Savings Vault topup,5.00,0.00,EUR,COMPLETED,5.00
Transfer,Deposit,2024-05-30 01:08:04,2024-05-30 01:08:04,Saving vault topup prefunding wallet,-5.00,0.00,EUR,COMPLETED,0.00
Transfer,Deposit,2024-05-31 12:17:37,2024-05-31 12:17:37,Savings Vault topup,0.05,0.00,EUR,COMPLETED,0.05
Transfer,Deposit,2024-05-31 12:17:37,2024-05-31 12:17:37,Saving vault topup prefunding wallet,-0.05,0.00,EUR,COMPLETED,0.00
Transfer,Deposit,2024-05-31 18:12:47,2024-05-31 18:12:47,Savings Vault topup,2.40,0.00,EUR,COMPLETED,2.40
Transfer,Deposit,2024-05-31 18:12:47,2024-05-31 18:12:47,Saving vault topup prefunding wallet,-2.40,0.00,EUR,COMPLETED,0.00
Transfer,Deposit,2024-05-31 18:57:40,2024-05-31 18:57:40,Savings Vault topup,1.75,0.00,EUR,COMPLETED,1.75
Transfer,Deposit,2024-05-31 18:57:40,2024-05-31 18:57:40,Saving vault topup prefunding wallet,-1.75,0.00,EUR,COMPLETED,0.00
Transfer,Deposit,2024-05-31 19:20:50,2024-05-31 19:20:50,Savings Vault topup,1.05,0.00,EUR,COMPLETED,1.05
Transfer,Deposit,2024-05-31 19:20:50,2024-05-31 19:20:50,Saving vault topup prefunding wallet,-1.05,0.00,EUR,COMPLETED,0.00
Transfer,Deposit,2024-06-01 01:55:42,2024-06-01 01:55:42,Savings Vault topup,0.60,0.00,EUR,COMPLETED,0.60
Transfer,Deposit,2024-06-01 01:55:42,2024-06-01 01:55:42,Saving vault topup prefunding wallet,-0.60,0.00,EUR,COMPLETED,0.00
Transfer,Deposit,2024-06-01 08:19:14,2024-06-01 08:19:14,Savings Vault topup,2.55,0.00,EUR,COMPLETED,2.55
Transfer,Deposit,2024-06-01 08:19:14,2024-06-01 08:19:14,Saving vault topup prefunding wallet,-2.55,0.00,EUR,COMPLETED,0.00
Transfer,Deposit,2024-06-01 10:40:21,2024-06-01 10:40:21,Savings Vault topup,0.50,0.00,EUR,COMPLETED,0.50
Transfer,Deposit,2024-06-01 10:40:21,2024-06-01 10:40:21,Saving vault topup prefunding wallet,-0.50,0.00,EUR,COMPLETED,0.00
Transfer,Deposit,2024-06-01 10:42:58,2024-06-01 10:42:58,Savings Vault topup,0.05,0.00,EUR,COMPLETED,0.05
Transfer,Deposit,2024-06-01 10:42:58,2024-06-01 10:42:58,Saving vault topup prefunding wallet,-0.05,0.00,EUR,COMPLETED,0.00
Transfer,Deposit,2024-06-01 10:45:58,2024-06-01 10:45:58,Savings Vault topup,5.00,0.00,EUR,COMPLETED,5.00
Transfer,Deposit,2024-06-01 10:45:58,2024-06-01 10:45:58,Saving vault topup prefunding wallet,-5.00,0.00,EUR,COMPLETED,0.00
Transfer,Deposit,2024-06-01 10:56:14,2024-06-01 10:56:14,Savings Vault topup,3.75,0.00,EUR,COMPLETED,3.75
Transfer,Deposit,2024-06-01 10:56:14,2024-06-01 10:56:14,Saving vault topup prefunding wallet,-3.75,0.00,EUR,COMPLETED,0.00
Transfer,Deposit,2024-06-01 11:07:01,2024-06-01 11:07:01,Savings Vault topup,0.05,0.00,EUR,COMPLETED,0.05
Transfer,Deposit,2024-06-01 11:07:01,2024-06-01 11:07:01,Saving vault topup prefunding wallet,-0.05,0.00,EUR,COMPLETED,0.00
Transfer,Deposit,2024-06-01 11:15:27,2024-06-01 11:15:27,Savings Vault topup,5.00,0.00,EUR,COMPLETED,5.00
Transfer,Deposit,2024-06-01 11:15:27,2024-06-01 11:15:27,Saving vault topup prefunding wallet,-5.00,0.00,EUR,COMPLETED,0.00
Transfer,Deposit,2024-06-01 14:03:58,2024-06-01 14:03:58,Savings Vault topup,4.00,0.00,EUR,COMPLETED,4.00
Transfer,Deposit,2024-06-01 14:03:58,2024-06-01 14:03:58,Saving vault topup prefunding wallet,-4.00,0.00,EUR,COMPLETED,0.00
Transfer,Deposit,2024-06-01 14:22:37,2024-06-01 14:22:37,Savings Vault topup,0.50,0.00,EUR,COMPLETED,0.50
Transfer,Deposit,2024-06-01 14:22:37,2024-06-01 14:22:37,Saving vault topup prefunding wallet,-0.50,0.00,EUR,COMPLETED,0.00
Transfer,Deposit,2024-06-01 14:43:08,2024-06-01 14:43:08,Savings Vault topup,2.50,0.00,EUR,COMPLETED,2.50
Transfer,Deposit,2024-06-01 14:43:08,2024-06-01 14:43:08,Saving vault topup prefunding wallet,-2.50,0.00,EUR,COMPLETED,0.00
Transfer,Deposit,2024-06-01 22:45:42,2024-06-01 22:45:42,Savings Vault topup,4.85,0.00,EUR,COMPLETED,4.85
Transfer,Deposit,2024-06-01 22:45:42,2024-06-01 22:45:42,Saving vault topup prefunding wallet,-4.85,0.00,EUR,COMPLETED,0.00
Transfer,Deposit,2024-06-01 23:16:53,2024-06-01 23:16:53,Savings Vault topup,5.00,0.00,EUR,COMPLETED,5.00
Transfer,Deposit,2024-06-01 23:16:53,2024-06-01 23:16:53,Saving vault topup prefunding wallet,-5.00,0.00,EUR,COMPLETED,0.00
Transfer,Deposit,2024-06-01 23:17:23,2024-06-01 23:17:23,Savings Vault topup,5.00,0.00,EUR,COMPLETED,5.00
Transfer,Deposit,2024-06-01 23:17:23,2024-06-01 23:17:23,Saving vault topup prefunding wallet,-5.00,0.00,EUR,COMPLETED,0.00
Transfer,Deposit,2024-06-02 08:31:48,2024-06-02 08:31:48,Savings Vault topup,1.25,0.00,EUR,COMPLETED,1.25
Transfer,Deposit,2024-06-02 08:31:48,2024-06-02 08:31:48,Saving vault topup prefunding wallet,-1.25,0.00,EUR,COMPLETED,0.00
Transfer,Deposit,2024-06-02 09:45:08,2024-06-02 09:45:08,Savings vault withdrawal from prefunding wallet,100.00,0.00,EUR,COMPLETED,100.00
Transfer,Deposit,2024-06-02 09:45:07,2024-06-02 09:45:08,From Flexible Cash Funds,-100.00,0.00,EUR,COMPLETED,0.00
Transfer,Deposit,2024-06-02 09:49:32,2024-06-02 09:49:32,Savings Vault topup,0.50,0.00,EUR,COMPLETED,0.50
Transfer,Deposit,2024-06-02 09:49:32,2024-06-02 09:49:32,Saving vault topup prefunding wallet,-0.50,0.00,EUR,COMPLETED,0.00
Transfer,Deposit,2024-06-02 09:49:47,2024-06-02 09:49:47,Savings Vault topup,1.65,0.00,EUR,COMPLETED,1.65
Transfer,Deposit,2024-06-02 09:49:47,2024-06-02 09:49:47,Saving vault topup prefunding wallet,-1.65,0.00,EUR,COMPLETED,0.00
Transfer,Deposit,2024-06-02 10:28:56,2024-06-02 10:28:56,Savings Vault topup,5.00,0.00,EUR,COMPLETED,5.00
Transfer,Deposit,2024-06-02 10:28:56,2024-06-02 10:28:56,Saving vault topup prefunding wallet,-5.00,0.00,EUR,COMPLETED,0.00
Transfer,Deposit,2024-06-02 11:49:58,2024-06-02 11:49:58,Savings Vault topup,5.00,0.00,EUR,COMPLETED,5.00
Transfer,Deposit,2024-06-02 11:49:58,2024-06-02 11:49:58,Saving vault topup prefunding wallet,-5.00,0.00,EUR,COMPLETED,0.00
Transfer,Deposit,2024-06-02 12:39:01,2024-06-02 12:39:01,Savings Vault topup,2.05,0.00,EUR,COMPLETED,2.05
Transfer,Deposit,2024-06-02 12:39:01,2024-06-02 12:39:01,Saving vault topup prefunding wallet,-2.05,0.00,EUR,COMPLETED,0.00
Transfer,Deposit,2024-06-02 13:29:52,2024-06-02 13:29:52,Savings Vault topup,2.75,0.00,EUR,COMPLETED,2.75
Transfer,Deposit,2024-06-02 13:29:52,2024-06-02 13:29:52,Saving vault topup prefunding wallet,-2.75,0.00,EUR,COMPLETED,0.00
Transfer,Deposit,2024-06-02 15:05:07,2024-06-02 15:05:07,Savings Vault topup,2.50,0.00,EUR,COMPLETED,2.50
Transfer,Deposit,2024-06-02 15:05:07,2024-06-02 15:05:07,Saving vault topup prefunding wallet,-2.50,0.00,EUR,COMPLETED,0.00
Transfer,Deposit,2024-06-02 15:06:53,2024-06-02 15:06:54,Savings Vault topup,2.50,0.00,EUR,COMPLETED,2.50
Transfer,Deposit,2024-06-02 15:06:54,2024-06-02 15:06:54,Saving vault topup prefunding wallet,-2.50,0.00,EUR,COMPLETED,0.00
Transfer,Deposit,2024-06-02 16:09:54,2024-06-02 16:09:54,Savings Vault topup,5.00,0.00,EUR,COMPLETED,5.00
Transfer,Deposit,2024-06-02 16:09:54,2024-06-02 16:09:54,Saving vault topup prefunding wallet,-5.00,0.00,EUR,COMPLETED,0.00
Transfer,Deposit,2024-06-02 16:14:41,2024-06-02 16:14:41,Savings Vault topup,4.00,0.00,EUR,COMPLETED,4.00
Transfer,Deposit,2024-06-02 16:14:41,2024-06-02 16:14:41,Saving vault topup prefunding wallet,-4.00,0.00,EUR,COMPLETED,0.00
Transfer,Deposit,2024-06-02 18:28:05,2024-06-02 18:28:05,Savings Vault topup,2.85,0.00,EUR,COMPLETED,2.85
Transfer,Deposit,2024-06-02 18:28:05,2024-06-02 18:28:05,Saving vault topup prefunding wallet,-2.85,0.00,EUR,COMPLETED,0.00
Transfer,Deposit,2024-06-02 20:12:11,2024-06-02 20:12:11,Savings vault withdrawal from prefunding wallet,100.00,0.00,EUR,COMPLETED,100.00
Transfer,Deposit,2024-06-02 20:12:11,2024-06-02 20:12:11,From Flexible Cash Funds,-100.00,0.00,EUR,COMPLETED,0.00
Transfer,Deposit,2024-06-02 20:26:37,2024-06-02 20:26:37,Savings Vault topup,2.50,0.00,EUR,COMPLETED,2.50
Transfer,Deposit,2024-06-02 20:26:37,2024-06-02 20:26:37,Saving vault topup prefunding wallet,-2.50,0.00,EUR,COMPLETED,0.00
Transfer,Deposit,2024-06-03 03:14:08,2024-06-03 03:14:08,Savings Vault topup,0.05,0.00,EUR,COMPLETED,0.05
Transfer,Deposit,2024-06-03 03:14:08,2024-06-03 03:14:08,Saving vault topup prefunding wallet,-0.05,0.00,EUR,COMPLETED,0.00
Transfer,Deposit,2024-06-03 10:52:46,2024-06-03 10:52:46,Savings vault withdrawal from prefunding wallet,100.00,0.00,EUR,COMPLETED,100.00
Transfer,Deposit,2024-06-03 10:52:46,2024-06-03 10:52:46,From Flexible Cash Funds,-100.00,0.00,EUR,COMPLETED,0.00
Transfer,Deposit,2024-06-03 10:53:42,2024-06-03 10:53:42,Savings Vault topup,5.00,0.00,EUR,COMPLETED,5.00
Transfer,Deposit,2024-06-03 10:53:42,2024-06-03 10:53:42,Saving vault topup prefunding wallet,-5.00,0.00,EUR,COMPLETED,0.00
Transfer,Deposit,2024-06-03 11:20:04,2024-06-03 11:20:04,Savings Vault topup,5.00,0.00,EUR,COMPLETED,5.00
Transfer,Deposit,2024-06-03 11:20:04,2024-06-03 11:20:04,Saving vault topup prefunding wallet,-5.00,0.00,EUR,COMPLETED,0.00
Transfer,Deposit,2024-06-03 12:16:32,2024-06-03 12:16:32,Savings Vault topup,5.00,0.00,EUR,COMPLETED,5.00
Transfer,Deposit,2024-06-03 12:16:32,2024-06-03 12:16:32,Saving vault topup prefunding wallet,-5.00,0.00,EUR,COMPLETED,0.00
Transfer,Deposit,2024-06-03 12:32:39,2024-06-03 12:32:39,Savings Vault topup,0.35,0.00,EUR,COMPLETED,0.35
Transfer,Deposit,2024-06-03 12:32:39,2024-06-03 12:32:39,Saving vault topup prefunding wallet,-0.35,0.00,EUR,COMPLETED,0.00
Transfer,Deposit,2024-06-03 13:02:58,2024-06-03 13:02:58,Savings vault withdrawal from prefunding wallet,100.00,0.00,EUR,COMPLETED,100.00
Transfer,Deposit,2024-06-03 13:02:58,2024-06-03 13:02:58,From Flexible Cash Funds,-100.00,0.00,EUR,COMPLETED,0.00
Transfer,Deposit,2024-06-03 13:53:43,2024-06-03 13:53:43,Savings Vault topup,5.00,0.00,EUR,COMPLETED,5.00
Transfer,Deposit,2024-06-03 13:53:44,2024-06-03 13:53:44,Saving vault topup prefunding wallet,-5.00,0.00,EUR,COMPLETED,0.00
Transfer,Deposit,2024-06-03 14:18:52,2024-06-03 14:18:52,Savings Vault topup,5.00,0.00,EUR,COMPLETED,5.00
Transfer,Deposit,2024-06-03 14:18:52,2024-06-03 14:18:52,Saving vault topup prefunding wallet,-5.00,0.00,EUR,COMPLETED,0.00
Transfer,Deposit,2024-06-03 17:01:02,2024-06-03 17:01:02,Savings Vault topup,2.50,0.00,EUR,COMPLETED,2.50
Transfer,Deposit,2024-06-03 17:01:02,2024-06-03 17:01:02,Saving vault topup prefunding wallet,-2.50,0.00,EUR,COMPLETED,0.00
Transfer,Deposit,2024-06-03 19:56:24,2024-06-03 19:56:24,Savings Vault topup,2.50,0.00,EUR,COMPLETED,2.50
Transfer,Deposit,2024-06-03 19:56:24,2024-06-03 19:56:24,Saving vault topup prefunding wallet,-2.50,0.00,EUR,COMPLETED,0.00
Transfer,Deposit,2024-06-04 02:51:45,2024-06-04 02:51:45,Savings Vault topup,0.05,0.00,EUR,COMPLETED,0.05
Transfer,Deposit,2024-06-04 02:51:45,2024-06-04 02:51:45,Saving vault topup prefunding wallet,-0.05,0.00,EUR,COMPLETED,0.00
Transfer,Deposit,2024-06-04 09:10:39,2024-06-04 09:10:39,Savings Vault topup,0.50,0.00,EUR,COMPLETED,0.50
Transfer,Deposit,2024-06-04 09:10:39,2024-06-04 09:10:39,Saving vault topup prefunding wallet,-0.50,0.00,EUR,COMPLETED,0.00
Transfer,Deposit,2024-06-04 09:36:30,2024-06-04 09:36:30,Savings Vault topup,0.20,0.00,EUR,COMPLETED,0.20
Transfer,Deposit,2024-06-04 09:36:30,2024-06-04 09:36:30,Saving vault topup prefunding wallet,-0.20,0.00,EUR,COMPLETED,0.00
Transfer,Deposit,2024-06-04 11:36:51,2024-06-04 11:36:51,Savings vault withdrawal from prefunding wallet,100.00,0.00,EUR,COMPLETED,100.00
Transfer,Deposit,2024-06-04 11:36:51,2024-06-04 11:36:51,From Flexible Cash Funds,-100.00,0.00,EUR,COMPLETED,0.00
Transfer,Deposit,2024-06-04 14:13:16,2024-06-04 14:13:16,Savings Vault topup,4.00,0.00,EUR,COMPLETED,4.00
Transfer,Deposit,2024-06-04 14:13:16,2024-06-04 14:13:16,Saving vault topup prefunding wallet,-4.00,0.00,EUR,COMPLETED,0.00
Transfer,Deposit,2024-06-04 15:37:16,2024-06-04 15:37:16,Savings Vault topup,5.00,0.00,EUR,COMPLETED,5.00
Transfer,Deposit,2024-06-04 15:37:16,2024-06-04 15:37:16,Saving vault topup prefunding wallet,-5.00,0.00,EUR,COMPLETED,0.00
Transfer,Deposit,2024-06-04 16:29:17,2024-06-04 16:29:17,Savings Vault topup,8472.20,0.00,EUR,COMPLETED,8472.20
Transfer,Deposit,2024-06-04 16:29:17,2024-06-04 16:29:17,Saving vault topup prefunding wallet,-8472.20,0.00,EUR,COMPLETED,0.00
Transfer,Deposit,2024-06-04 18:38:59,2024-06-04 18:39:00,Savings Vault topup,5.00,0.00,EUR,COMPLETED,5.00
Transfer,Deposit,2024-06-04 18:39:00,2024-06-04 18:39:00,Saving vault topup prefunding wallet,-5.00,0.00,EUR,COMPLETED,0.00
Transfer,Deposit,2024-06-04 18:45:03,2024-06-04 18:45:03,Savings Vault topup,1.65,0.00,EUR,COMPLETED,1.65
Transfer,Deposit,2024-06-04 18:45:03,2024-06-04 18:45:03,Saving vault topup prefunding wallet,-1.65,0.00,EUR,COMPLETED,0.00
Transfer,Deposit,2024-06-04 20:31:27,2024-06-04 20:31:27,Savings vault withdrawal from prefunding wallet,100.00,0.00,EUR,COMPLETED,100.00
Transfer,Deposit,2024-06-04 20:31:27,2024-06-04 20:31:27,From Flexible Cash Funds,-100.00,0.00,EUR,COMPLETED,0.00
Transfer,Deposit,2024-06-04 20:31:38,2024-06-04 20:31:38,Savings Vault topup,5.00,0.00,EUR,COMPLETED,5.00
Transfer,Deposit,2024-06-04 20:31:38,2024-06-04 20:31:38,Saving vault topup prefunding wallet,-5.00,0.00,EUR,COMPLETED,0.00
Transfer,Deposit,2024-06-05 11:03:31,2024-06-05 11:03:31,Savings Vault topup,2.50,0.00,EUR,COMPLETED,2.50
Transfer,Deposit,2024-06-05 11:03:31,2024-06-05 11:03:31,Saving vault topup prefunding wallet,-2.50,0.00,EUR,COMPLETED,0.00
Transfer,Deposit,2024-06-05 11:08:49,2024-06-05 11:08:49,Savings Vault topup,0.05,0.00,EUR,COMPLETED,0.05
Transfer,Deposit,2024-06-05 11:08:49,2024-06-05 11:08:49,Saving vault topup prefunding wallet,-0.05,0.00,EUR,COMPLETED,0.00
Transfer,Deposit,2024-06-05 12:54:29,2024-06-05 12:54:29,Savings Vault topup,5.00,0.00,EUR,COMPLETED,5.00
Transfer,Deposit,2024-06-05 12:54:29,2024-06-05 12:54:29,Saving vault topup prefunding wallet,-5.00,0.00,EUR,COMPLETED,0.00
Transfer,Deposit,2024-06-05 14:00:45,2024-06-05 14:00:45,Savings Vault topup,5.00,0.00,EUR,COMPLETED,5.00
Transfer,Deposit,2024-06-05 14:00:45,2024-06-05 14:00:45,Saving vault topup prefunding wallet,-5.00,0.00,EUR,COMPLETED,0.00
Transfer,Deposit,2024-06-05 14:36:52,2024-06-05 14:36:52,Savings Vault topup,2.25,0.00,EUR,COMPLETED,2.25
Transfer,Deposit,2024-06-05 14:36:52,2024-06-05 14:36:52,Saving vault topup prefunding wallet,-2.25,0.00,EUR,COMPLETED,0.00
Transfer,Deposit,2024-06-05 14:46:29,2024-06-05 14:46:29,Savings Vault topup,5.00,0.00,EUR,COMPLETED,5.00
Transfer,Deposit,2024-06-05 14:46:29,2024-06-05 14:46:29,Saving vault topup prefunding wallet,-5.00,0.00,EUR,COMPLETED,0.00
Transfer,Deposit,2024-06-05 21:15:13,2024-06-05 21:15:13,Savings vault withdrawal from prefunding wallet,200.00,0.00,EUR,COMPLETED,200.00
Transfer,Deposit,2024-06-05 21:15:13,2024-06-05 21:15:13,From Flexible Cash Funds,-200.00,0.00,EUR,COMPLETED,0.00
Transfer,Deposit,2024-06-05 21:18:21,2024-06-05 21:18:21,Savings Vault topup,5.00,0.00,EUR,COMPLETED,5.00
Transfer,Deposit,2024-06-05 21:18:21,2024-06-05 21:18:21,Saving vault topup prefunding wallet,-5.00,0.00,EUR,COMPLETED,0.00
Transfer,Deposit,2024-06-06 05:49:39,2024-06-06 05:49:39,Savings Vault topup,0.50,0.00,EUR,COMPLETED,0.50
Transfer,Deposit,2024-06-06 05:49:39,2024-06-06 05:49:39,Saving vault topup prefunding wallet,-0.50,0.00,EUR,COMPLETED,0.00
Transfer,Deposit,2024-06-06 07:36:25,2024-06-06 07:36:25,Savings Vault topup,1.00,0.00,EUR,COMPLETED,1.00
Transfer,Deposit,2024-06-06 07:36:25,2024-06-06 07:36:25,Saving vault topup prefunding wallet,-1.00,0.00,EUR,COMPLETED,0.00
Transfer,Deposit,2024-06-06 11:17:46,2024-06-06 11:17:46,Savings Vault topup,4.30,0.00,EUR,COMPLETED,4.30
Transfer,Deposit,2024-06-06 11:17:46,2024-06-06 11:17:46,Saving vault topup prefunding wallet,-4.30,0.00,EUR,COMPLETED,0.00
Transfer,Deposit,2024-06-06 12:03:09,2024-06-06 12:03:09,Savings Vault topup,2.65,0.00,EUR,COMPLETED,2.65
Transfer,Deposit,2024-06-06 12:03:09,2024-06-06 12:03:09,Saving vault topup prefunding wallet,-2.65,0.00,EUR,COMPLETED,0.00
Transfer,Deposit,2024-06-06 12:07:06,2024-06-06 12:07:06,Savings Vault topup,3.00,0.00,EUR,COMPLETED,3.00
Transfer,Deposit,2024-06-06 12:07:06,2024-06-06 12:07:06,Saving vault topup prefunding wallet,-3.00,0.00,EUR,COMPLETED,0.00
Transfer,Deposit,2024-06-06 12:53:01,2024-06-06 12:53:01,Savings Vault topup,5.00,0.00,EUR,COMPLETED,5.00
Transfer,Deposit,2024-06-06 12:53:01,2024-06-06 12:53:01,Saving vault topup prefunding wallet,-5.00,0.00,EUR,COMPLETED,0.00
Transfer,Deposit,2024-06-06 15:00:14,2024-06-06 15:00:14,Savings Vault topup,1.50,0.00,EUR,COMPLETED,1.50
Transfer,Deposit,2024-06-06 15:00:14,2024-06-06 15:00:14,Saving vault topup prefunding wallet,-1.50,0.00,EUR,COMPLETED,0.00
Transfer,Deposit,2024-06-06 17:16:33,2024-06-06 17:16:33,Savings Vault topup,4.70,0.00,EUR,COMPLETED,4.70
Transfer,Deposit,2024-06-06 17:16:33,2024-06-06 17:16:33,Saving vault topup prefunding wallet,-4.70,0.00,EUR,COMPLETED,0.00
Transfer,Deposit,2024-06-06 19:43:28,2024-06-06 19:43:28,Savings vault withdrawal from prefunding wallet,100.00,0.00,EUR,COMPLETED,100.00
Transfer,Deposit,2024-06-06 19:43:28,2024-06-06 19:43:28,From Flexible Cash Funds,-100.00,0.00,EUR,COMPLETED,0.00
Transfer,Deposit,2024-06-06 19:52:11,2024-06-06 19:52:11,Savings Vault topup,2.50,0.00,EUR,COMPLETED,2.50
Transfer,Deposit,2024-06-06 19:52:11,2024-06-06 19:52:11,Saving vault topup prefunding wallet,-2.50,0.00,EUR,COMPLETED,0.00
Transfer,Deposit,2024-06-07 08:55:59,2024-06-07 08:55:59,Savings Vault topup,0.50,0.00,EUR,COMPLETED,0.50
Transfer,Deposit,2024-06-07 08:55:59,2024-06-07 08:55:59,Saving vault topup prefunding wallet,-0.50,0.00,EUR,COMPLETED,0.00
Transfer,Deposit,2024-06-07 09:21:22,2024-06-07 09:21:22,Savings Vault topup,5.00,0.00,EUR,COMPLETED,5.00
Transfer,Deposit,2024-06-07 09:21:22,2024-06-07 09:21:22,Saving vault topup prefunding wallet,-5.00,0.00,EUR,COMPLETED,0.00
Transfer,Deposit,2024-06-07 09:27:06,2024-06-07 09:27:06,Savings Vault topup,3.20,0.00,EUR,COMPLETED,3.20
Transfer,Deposit,2024-06-07 09:27:07,2024-06-07 09:27:07,Saving vault topup prefunding wallet,-3.20,0.00,EUR,COMPLETED,0.00
Transfer,Deposit,2024-06-07 10:23:01,2024-06-07 10:23:01,Savings Vault topup,5.00,0.00,EUR,COMPLETED,5.00
Transfer,Deposit,2024-06-07 10:23:01,2024-06-07 10:23:01,Saving vault topup prefunding wallet,-5.00,0.00,EUR,COMPLETED,0.00
Transfer,Deposit,2024-06-07 11:59:47,2024-06-07 11:59:47,Savings Vault topup,5.00,0.00,EUR,COMPLETED,5.00
Transfer,Deposit,2024-06-07 11:59:48,2024-06-07 11:59:48,Saving vault topup prefunding wallet,-5.00,0.00,EUR,COMPLETED,0.00
Transfer,Deposit,2024-06-07 12:12:20,2024-06-07 12:12:20,Savings Vault topup,3.00,0.00,EUR,COMPLETED,3.00
Transfer,Deposit,2024-06-07 12:12:20,2024-06-07 12:12:20,Saving vault topup prefunding wallet,-3.00,0.00,EUR,COMPLETED,0.00
Transfer,Deposit,2024-06-07 14:52:17,2024-06-07 14:52:17,Savings Vault topup,5.00,0.00,EUR,COMPLETED,5.00
Transfer,Deposit,2024-06-07 14:52:17,2024-06-07 14:52:17,Saving vault topup prefunding wallet,-5.00,0.00,EUR,COMPLETED,0.00
Transfer,Deposit,2024-06-07 15:13:28,2024-06-07 15:13:28,Savings vault withdrawal from prefunding wallet,100.00,0.00,EUR,COMPLETED,100.00
Transfer,Deposit,2024-06-07 15:13:28,2024-06-07 15:13:28,From Flexible Cash Funds,-100.00,0.00,EUR,COMPLETED,0.00
Transfer,Deposit,2024-06-07 15:13:35,2024-06-07 15:13:35,Savings Vault topup,5.00,0.00,EUR,COMPLETED,5.00
Transfer,Deposit,2024-06-07 15:13:36,2024-06-07 15:13:36,Saving vault topup prefunding wallet,-5.00,0.00,EUR,COMPLETED,0.00
Transfer,Deposit,2024-06-07 18:17:36,2024-06-07 18:17:36,Savings Vault topup,2.50,0.00,EUR,COMPLETED,2.50
Transfer,Deposit,2024-06-07 18:17:36,2024-06-07 18:17:36,Saving vault topup prefunding wallet,-2.50,0.00,EUR,COMPLETED,0.00
Transfer,Deposit,2024-06-07 19:21:46,2024-06-07 19:21:46,Savings Vault topup,5.00,0.00,EUR,COMPLETED,5.00
Transfer,Deposit,2024-06-07 19:21:46,2024-06-07 19:21:46,Saving vault topup prefunding wallet,-5.00,0.00,EUR,COMPLETED,0.00
Transfer,Deposit,2024-06-07 19:53:24,2024-06-07 19:53:24,Savings Vault topup,5.00,0.00,EUR,COMPLETED,5.00
Transfer,Deposit,2024-06-07 19:53:24,2024-06-07 19:53:24,Saving vault topup prefunding wallet,-5.00,0.00,EUR,COMPLETED,0.00
Transfer,Deposit,2024-06-07 21:37:28,2024-06-07 21:37:28,Savings vault withdrawal from prefunding wallet,100.00,0.00,EUR,COMPLETED,100.00
Transfer,Deposit,2024-06-07 21:37:28,2024-06-07 21:37:28,From Flexible Cash Funds,-100.00,0.00,EUR,COMPLETED,0.00
Transfer,Deposit,2024-06-07 21:37:39,2024-06-07 21:37:39,Savings Vault topup,5.00,0.00,EUR,COMPLETED,5.00
Transfer,Deposit,2024-06-07 21:37:39,2024-06-07 21:37:39,Saving vault topup prefunding wallet,-5.00,0.00,EUR,COMPLETED,0.00
Transfer,Deposit,2024-06-07 22:08:47,2024-06-07 22:08:47,Savings Vault topup,2.50,0.00,EUR,COMPLETED,2.50
Transfer,Deposit,2024-06-07 22:08:47,2024-06-07 22:08:47,Saving vault topup prefunding wallet,-2.50,0.00,EUR,COMPLETED,0.00
Transfer,Deposit,2024-06-08 07:25:49,2024-06-08 07:25:49,Savings Vault topup,0.05,0.00,EUR,COMPLETED,0.05
Transfer,Deposit,2024-06-08 07:25:49,2024-06-08 07:25:49,Saving vault topup prefunding wallet,-0.05,0.00,EUR,COMPLETED,0.00
Transfer,Deposit,2024-06-08 09:25:53,2024-06-08 09:25:53,Savings Vault topup,3.50,0.00,EUR,COMPLETED,3.50
Transfer,Deposit,2024-06-08 09:25:53,2024-06-08 09:25:53,Saving vault topup prefunding wallet,-3.50,0.00,EUR,COMPLETED,0.00
Transfer,Deposit,2024-06-08 10:21:13,2024-06-08 10:21:13,Savings vault withdrawal from prefunding wallet,25.00,0.00,EUR,COMPLETED,25.00
Transfer,Deposit,2024-06-08 10:21:13,2024-06-08 10:21:13,From Flexible Cash Funds,-25.00,0.00,EUR,COMPLETED,0.00
Transfer,Deposit,2024-06-08 10:32:56,2024-06-08 10:32:56,Savings vault withdrawal from prefunding wallet,100.00,0.00,EUR,COMPLETED,100.00
Transfer,Deposit,2024-06-08 10:32:56,2024-06-08 10:32:56,From Flexible Cash Funds,-100.00,0.00,EUR,COMPLETED,0.00
Transfer,Deposit,2024-06-08 10:33:53,2024-06-08 10:33:53,Savings Vault topup,4.55,0.00,EUR,COMPLETED,4.55
Transfer,Deposit,2024-06-08 10:33:53,2024-06-08 10:33:53,Saving vault topup prefunding wallet,-4.55,0.00,EUR,COMPLETED,0.00
Transfer,Deposit,2024-06-08 14:21:56,2024-06-08 14:21:56,Savings Vault topup,3.55,0.00,EUR,COMPLETED,3.55
Transfer,Deposit,2024-06-08 14:21:56,2024-06-08 14:21:56,Saving vault topup prefunding wallet,-3.55,0.00,EUR,COMPLETED,0.00
Transfer,Deposit,2024-06-08 15:54:19,2024-06-08 15:54:19,Savings Vault topup,5.00,0.00,EUR,COMPLETED,5.00
Transfer,Deposit,2024-06-08 15:54:19,2024-06-08 15:54:19,Saving vault topup prefunding wallet,-5.00,0.00,EUR,COMPLETED,0.00
Transfer,Deposit,2024-06-08 17:44:45,2024-06-08 17:44:45,Savings Vault topup,4.90,0.00,EUR,COMPLETED,4.90
Transfer,Deposit,2024-06-08 17:44:45,2024-06-08 17:44:45,Saving vault topup prefunding wallet,-4.90,0.00,EUR,COMPLETED,0.00
Transfer,Deposit,2024-06-08 18:09:52,2024-06-08 18:09:52,Savings Vault topup,4.50,0.00,EUR,COMPLETED,4.50
Transfer,Deposit,2024-06-08 18:09:52,2024-06-08 18:09:52,Saving vault topup prefunding wallet,-4.50,0.00,EUR,COMPLETED,0.00
Transfer,Deposit,2024-06-08 18:44:28,2024-06-08 18:44:28,Savings Vault topup,3.00,0.00,EUR,COMPLETED,3.00
Transfer,Deposit,2024-06-08 18:44:28,2024-06-08 18:44:28,Saving vault topup prefunding wallet,-3.00,0.00,EUR,COMPLETED,0.00
Transfer,Deposit,2024-06-08 18:50:35,2024-06-08 18:50:35,Savings Vault topup,3.50,0.00,EUR,COMPLETED,3.50
Transfer,Deposit,2024-06-08 18:50:35,2024-06-08 18:50:35,Saving vault topup prefunding wallet,-3.50,0.00,EUR,COMPLETED,0.00
Transfer,Deposit,2024-06-09 00:02:18,2024-06-09 00:02:18,Savings Vault topup,4.50,0.00,EUR,COMPLETED,4.50
Transfer,Deposit,2024-06-09 00:02:18,2024-06-09 00:02:18,Saving vault topup prefunding wallet,-4.50,0.00,EUR,COMPLETED,0.00
Transfer,Deposit,2024-06-09 12:18:58,2024-06-09 12:18:58,Savings Vault topup,1.95,0.00,EUR,COMPLETED,1.95
Transfer,Deposit,2024-06-09 12:18:58,2024-06-09 12:18:58,Saving vault topup prefunding wallet,-1.95,0.00,EUR,COMPLETED,0.00
Transfer,Deposit,2024-06-09 12:34:09,2024-06-09 12:34:09,Savings Vault topup,0.45,0.00,EUR,COMPLETED,0.45
Transfer,Deposit,2024-06-09 12:34:09,2024-06-09 12:34:09,Saving vault topup prefunding wallet,-0.45,0.00,EUR,COMPLETED,0.00
Transfer,Deposit,2024-06-09 16:58:17,2024-06-09 16:58:18,Savings Vault topup,0.15,0.00,EUR,COMPLETED,0.15
Transfer,Deposit,2024-06-09 16:58:18,2024-06-09 16:58:18,Saving vault topup prefunding wallet,-0.15,0.00,EUR,COMPLETED,0.00
Transfer,Deposit,2024-06-09 17:28:44,2024-06-09 17:28:44,Savings Vault topup,5.00,0.00,EUR,COMPLETED,5.00
Transfer,Deposit,2024-06-09 17:28:44,2024-06-09 17:28:44,Saving vault topup prefunding wallet,-5.00,0.00,EUR,COMPLETED,0.00
Transfer,Deposit,2024-06-11 08:25:20,2024-06-11 08:25:20,Savings Vault topup,0.05,0.00,EUR,COMPLETED,0.05
Transfer,Deposit,2024-06-11 08:25:20,2024-06-11 08:25:20,Saving vault topup prefunding wallet,-0.05,0.00,EUR,COMPLETED,0.00
Transfer,Deposit,2024-06-11 08:43:54,2024-06-11 08:43:54,Savings vault withdrawal from prefunding wallet,100.00,0.00,EUR,COMPLETED,100.00
Transfer,Deposit,2024-06-11 08:43:54,2024-06-11 08:43:54,From Flexible Cash Funds,-100.00,0.00,EUR,COMPLETED,0.00
Transfer,Deposit,2024-06-11 08:51:43,2024-06-11 08:51:43,Savings Vault topup,2.75,0.00,EUR,COMPLETED,2.75
Transfer,Deposit,2024-06-11 08:51:43,2024-06-11 08:51:43,Saving vault topup prefunding wallet,-2.75,0.00,EUR,COMPLETED,0.00
Transfer,Deposit,2024-06-11 16:40:43,2024-06-11 16:40:43,Savings Vault topup,0.05,0.00,EUR,COMPLETED,0.05
Transfer,Deposit,2024-06-11 16:40:43,2024-06-11 16:40:43,Saving vault topup prefunding wallet,-0.05,0.00,EUR,COMPLETED,0.00
Transfer,Deposit,2024-06-12 14:23:06,2024-06-12 14:23:06,Savings Vault topup,1.25,0.00,EUR,COMPLETED,1.25
Transfer,Deposit,2024-06-12 14:23:06,2024-06-12 14:23:06,Saving vault topup prefunding wallet,-1.25,0.00,EUR,COMPLETED,0.00
Transfer,Deposit,2024-06-12 16:41:00,2024-06-12 16:41:00,Savings Vault topup,5.00,0.00,EUR,COMPLETED,5.00
Transfer,Deposit,2024-06-12 16:41:00,2024-06-12 16:41:00,Saving vault topup prefunding wallet,-5.00,0.00,EUR,COMPLETED,0.00
Transfer,Deposit,2024-06-12 18:23:25,2024-06-12 18:23:25,Savings Vault topup,2.00,0.00,EUR,COMPLETED,2.00
Transfer,Deposit,2024-06-12 18:23:25,2024-06-12 18:23:25,Saving vault topup prefunding wallet,-2.00,0.00,EUR,COMPLETED,0.00
Transfer,Deposit,2024-06-14 17:54:53,2024-06-14 17:54:53,Savings Vault topup,0.55,0.00,EUR,COMPLETED,0.55
Transfer,Deposit,2024-06-14 17:54:53,2024-06-14 17:54:53,Saving vault topup prefunding wallet,-0.55,0.00,EUR,COMPLETED,0.00
Transfer,Deposit,2024-06-14 19:05:00,2024-06-14 19:05:01,Savings Vault topup,2.55,0.00,EUR,COMPLETED,2.55
Transfer,Deposit,2024-06-14 19:05:01,2024-06-14 19:05:01,Saving vault topup prefunding wallet,-2.55,0.00,EUR,COMPLETED,0.00
Transfer,Deposit,2024-06-14 19:13:37,2024-06-14 19:13:37,Savings Vault topup,2.25,0.00,EUR,COMPLETED,2.25
Transfer,Deposit,2024-06-14 19:13:37,2024-06-14 19:13:37,Saving vault topup prefunding wallet,-2.25,0.00,EUR,COMPLETED,0.00
Transfer,Deposit,2024-06-14 20:39:59,2024-06-14 20:39:59,Savings vault withdrawal from prefunding wallet,100.00,0.00,EUR,COMPLETED,100.00
Transfer,Deposit,2024-06-14 20:39:59,2024-06-14 20:39:59,From Flexible Cash Funds,-100.00,0.00,EUR,COMPLETED,0.00
Transfer,Deposit,2024-06-14 20:40:50,2024-06-14 20:40:50,Savings Vault topup,5.00,0.00,EUR,COMPLETED,5.00
Transfer,Deposit,2024-06-14 20:40:50,2024-06-14 20:40:50,Saving vault topup prefunding wallet,-5.00,0.00,EUR,COMPLETED,0.00
Transfer,Deposit,2024-06-14 22:38:56,2024-06-14 22:38:56,Savings Vault topup,5.00,0.00,EUR,COMPLETED,5.00
Transfer,Deposit,2024-06-14 22:38:56,2024-06-14 22:38:56,Saving vault topup prefunding wallet,-5.00,0.00,EUR,COMPLETED,0.00
Transfer,Deposit,2024-06-15 00:25:57,2024-06-15 00:25:57,Savings vault withdrawal from prefunding wallet,100.00,0.00,EUR,COMPLETED,100.00
Transfer,Deposit,2024-06-15 00:25:57,2024-06-15 00:25:57,From Flexible Cash Funds,-100.00,0.00,EUR,COMPLETED,0.00
Transfer,Deposit,2024-06-15 00:27:35,2024-06-15 00:27:35,Savings Vault topup,5.00,0.00,EUR,COMPLETED,5.00
Transfer,Deposit,2024-06-15 00:27:35,2024-06-15 00:27:35,Saving vault topup prefunding wallet,-5.00,0.00,EUR,COMPLETED,0.00
Transfer,Deposit,2024-06-15 02:00:32,2024-06-15 02:00:32,Savings Vault topup,5.00,0.00,EUR,COMPLETED,5.00
Transfer,Deposit,2024-06-15 02:00:32,2024-06-15 02:00:32,Saving vault topup prefunding wallet,-5.00,0.00,EUR,COMPLETED,0.00
Transfer,Deposit,2024-06-15 02:51:07,2024-06-15 02:51:07,Savings Vault topup,3.00,0.00,EUR,COMPLETED,3.00
Transfer,Deposit,2024-06-15 02:51:07,2024-06-15 02:51:07,Saving vault topup prefunding wallet,-3.00,0.00,EUR,COMPLETED,0.00
Transfer,Deposit,2024-06-15 09:10:47,2024-06-15 09:10:47,Savings Vault topup,2.55,0.00,EUR,COMPLETED,2.55
Transfer,Deposit,2024-06-15 09:10:47,2024-06-15 09:10:47,Saving vault topup prefunding wallet,-2.55,0.00,EUR,COMPLETED,0.00
Transfer,Deposit,2024-06-15 09:19:25,2024-06-15 09:19:25,Savings vault withdrawal from prefunding wallet,100.00,0.00,EUR,COMPLETED,100.00
Transfer,Deposit,2024-06-15 09:19:25,2024-06-15 09:19:25,From Flexible Cash Funds,-100.00,0.00,EUR,COMPLETED,0.00
Transfer,Deposit,2024-06-15 09:19:39,2024-06-15 09:19:39,Savings Vault topup,4.30,0.00,EUR,COMPLETED,4.30
Transfer,Deposit,2024-06-15 09:19:39,2024-06-15 09:19:39,Saving vault topup prefunding wallet,-4.30,0.00,EUR,COMPLETED,0.00
Transfer,Deposit,2024-06-16 19:51:36,2024-06-16 19:51:36,Savings Vault topup,4.40,0.00,EUR,COMPLETED,4.40
Transfer,Deposit,2024-06-16 19:51:36,2024-06-16 19:51:36,Saving vault topup prefunding wallet,-4.40,0.00,EUR,COMPLETED,0.00
Transfer,Deposit,2024-06-17 08:27:46,2024-06-17 08:27:46,Savings Vault topup,4.25,0.00,EUR,COMPLETED,4.25
Transfer,Deposit,2024-06-17 08:27:46,2024-06-17 08:27:46,Saving vault topup prefunding wallet,-4.25,0.00,EUR,COMPLETED,0.00
Transfer,Deposit,2024-06-18 18:31:34,2024-06-18 18:31:34,Savings Vault topup,0.05,0.00,EUR,COMPLETED,0.05
Transfer,Deposit,2024-06-18 18:31:34,2024-06-18 18:31:34,Saving vault topup prefunding wallet,-0.05,0.00,EUR,COMPLETED,0.00
Transfer,Deposit,2024-06-18 20:15:38,2024-06-18 20:15:38,Savings vault withdrawal from prefunding wallet,100.00,0.00,EUR,COMPLETED,100.00
Transfer,Deposit,2024-06-18 20:15:38,2024-06-18 20:15:38,From Flexible Cash Funds,-100.00,0.00,EUR,COMPLETED,0.00
Transfer,Deposit,2024-06-18 20:15:45,2024-06-18 20:15:45,Savings Vault topup,0.05,0.00,EUR,COMPLETED,0.05
Transfer,Deposit,2024-06-18 20:15:45,2024-06-18 20:15:45,Saving vault topup prefunding wallet,-0.05,0.00,EUR,COMPLETED,0.00
Transfer,Deposit,2024-06-19 08:06:35,2024-06-19 08:06:35,Savings Vault topup,2.00,0.00,EUR,COMPLETED,2.00
Transfer,Deposit,2024-06-19 08:06:35,2024-06-19 08:06:35,Saving vault topup prefunding wallet,-2.00,0.00,EUR,COMPLETED,0.00
Transfer,Deposit,2024-06-19 09:53:00,2024-06-19 09:53:00,Savings vault withdrawal from prefunding wallet,100.00,0.00,EUR,COMPLETED,100.00
Transfer,Deposit,2024-06-19 09:53:00,2024-06-19 09:53:00,From Flexible Cash Funds,-100.00,0.00,EUR,COMPLETED,0.00
Transfer,Deposit,2024-06-19 09:54:59,2024-06-19 09:54:59,Savings Vault topup,3.25,0.00,EUR,COMPLETED,3.25
Transfer,Deposit,2024-06-19 09:54:59,2024-06-19 09:54:59,Saving vault topup prefunding wallet,-3.25,0.00,EUR,COMPLETED,0.00
Transfer,Deposit,2024-06-19 10:46:47,2024-06-19 10:46:47,Savings Vault topup,1.25,0.00,EUR,COMPLETED,1.25
Transfer,Deposit,2024-06-19 10:46:47,2024-06-19 10:46:47,Saving vault topup prefunding wallet,-1.25,0.00,EUR,COMPLETED,0.00
Transfer,Deposit,2024-06-19 10:57:54,2024-06-19 10:57:54,Savings Vault topup,5.00,0.00,EUR,COMPLETED,5.00
Transfer,Deposit,2024-06-19 10:57:54,2024-06-19 10:57:54,Saving vault topup prefunding wallet,-5.00,0.00,EUR,COMPLETED,0.00
Transfer,Deposit,2024-06-20 05:56:38,2024-06-20 05:56:38,Savings vault withdrawal from prefunding wallet,100.00,0.00,EUR,COMPLETED,100.00
Transfer,Deposit,2024-06-20 05:56:38,2024-06-20 05:56:38,From Flexible Cash Funds,-100.00,0.00,EUR,COMPLETED,0.00
Transfer,Deposit,2024-06-20 05:58:09,2024-06-20 05:58:09,Savings Vault topup,4.50,0.00,EUR,COMPLETED,4.50
Transfer,Deposit,2024-06-20 05:58:09,2024-06-20 05:58:09,Saving vault topup prefunding wallet,-4.50,0.00,EUR,COMPLETED,0.00
Transfer,Deposit,2024-06-21 08:57:38,2024-06-21 08:57:39,Savings Vault topup,4.20,0.00,EUR,COMPLETED,4.20
Transfer,Deposit,2024-06-21 08:57:39,2024-06-21 08:57:39,Saving vault topup prefunding wallet,-4.20,0.00,EUR,COMPLETED,0.00
Transfer,Deposit,2024-06-21 19:38:13,2024-06-21 19:38:13,Savings Vault topup,3.85,0.00,EUR,COMPLETED,3.85
Transfer,Deposit,2024-06-21 19:38:13,2024-06-21 19:38:13,Saving vault topup prefunding wallet,-3.85,0.00,EUR,COMPLETED,0.00
Transfer,Deposit,2024-06-21 19:57:00,2024-06-21 19:57:00,Savings Vault topup,4.75,0.00,EUR,COMPLETED,4.75
Transfer,Deposit,2024-06-21 19:57:00,2024-06-21 19:57:00,Saving vault topup prefunding wallet,-4.75,0.00,EUR,COMPLETED,0.00
Transfer,Deposit,2024-06-22 12:11:39,2024-06-22 12:11:39,Savings vault withdrawal from prefunding wallet,150.00,0.00,EUR,COMPLETED,150.00
Transfer,Deposit,2024-06-22 12:11:39,2024-06-22 12:11:39,From Flexible Cash Funds,-150.00,0.00,EUR,COMPLETED,0.00
Transfer,Deposit,2024-06-22 12:11:52,2024-06-22 12:11:52,Savings Vault topup,0.55,0.00,EUR,COMPLETED,0.55
Transfer,Deposit,2024-06-22 12:11:52,2024-06-22 12:11:52,Saving vault topup prefunding wallet,-0.55,0.00,EUR,COMPLETED,0.00
Transfer,Deposit,2024-06-22 15:14:55,2024-06-22 15:14:55,Savings Vault topup,3.00,0.00,EUR,COMPLETED,3.00
Transfer,Deposit,2024-06-22 15:14:55,2024-06-22 15:14:55,Saving vault topup prefunding wallet,-3.00,0.00,EUR,COMPLETED,0.00
Transfer,Deposit,2024-06-23 08:00:02,2024-06-23 08:00:02,Savings vault withdrawal from prefunding wallet,250.00,0.00,EUR,COMPLETED,250.00
Transfer,Deposit,2024-06-23 08:00:02,2024-06-23 08:00:02,From Flexible Cash Funds,-250.00,0.00,EUR,COMPLETED,0.00
Transfer,Deposit,2024-06-23 10:19:53,2024-06-23 10:19:53,Savings Vault topup,2.50,0.00,EUR,COMPLETED,2.50
Transfer,Deposit,2024-06-23 10:19:53,2024-06-23 10:19:54,Saving vault topup prefunding wallet,-2.50,0.00,EUR,COMPLETED,0.00
Transfer,Deposit,2024-06-23 12:41:42,2024-06-23 12:41:42,Savings Vault topup,0.45,0.00,EUR,COMPLETED,0.45
Transfer,Deposit,2024-06-23 12:41:42,2024-06-23 12:41:42,Saving vault topup prefunding wallet,-0.45,0.00,EUR,COMPLETED,0.00
Transfer,Deposit,2024-06-23 12:42:05,2024-06-23 12:42:05,Savings Vault topup,1.75,0.00,EUR,COMPLETED,1.75
Transfer,Deposit,2024-06-23 12:42:05,2024-06-23 12:42:05,Saving vault topup prefunding wallet,-1.75,0.00,EUR,COMPLETED,0.00
Transfer,Deposit,2024-06-23 13:00:40,2024-06-23 13:00:40,Savings Vault topup,2.75,0.00,EUR,COMPLETED,2.75
Transfer,Deposit,2024-06-23 13:00:40,2024-06-23 13:00:40,Saving vault topup prefunding wallet,-2.75,0.00,EUR,COMPLETED,0.00
Transfer,Deposit,2024-06-23 21:09:00,2024-06-23 21:09:01,Savings Vault topup,5.00,0.00,EUR,COMPLETED,5.00
Transfer,Deposit,2024-06-23 21:09:01,2024-06-23 21:09:01,Saving vault topup prefunding wallet,-5.00,0.00,EUR,COMPLETED,0.00
Transfer,Deposit,2024-06-24 19:58:38,2024-06-24 19:58:39,Savings Vault topup,4.50,0.00,EUR,COMPLETED,4.50
Transfer,Deposit,2024-06-24 19:58:39,2024-06-24 19:58:39,Saving vault topup prefunding wallet,-4.50,0.00,EUR,COMPLETED,0.00
Transfer,Deposit,2024-06-24 19:59:24,2024-06-24 19:59:25,Savings Vault topup,3.50,0.00,EUR,COMPLETED,3.50
Transfer,Deposit,2024-06-24 19:59:25,2024-06-24 19:59:25,Saving vault topup prefunding wallet,-3.50,0.00,EUR,COMPLETED,0.00
Transfer,Deposit,2024-06-24 20:41:29,2024-06-24 20:41:29,Savings vault withdrawal from prefunding wallet,1000.00,0.00,EUR,COMPLETED,1000.00
Transfer,Deposit,2024-06-24 20:41:29,2024-06-24 20:41:29,From Flexible Cash Funds,-1000.00,0.00,EUR,COMPLETED,0.00
Transfer,Deposit,2024-06-25 09:18:18,2024-06-25 09:18:18,Savings Vault topup,5.00,0.00,EUR,COMPLETED,5.00
Transfer,Deposit,2024-06-25 09:18:18,2024-06-25 09:18:18,Saving vault topup prefunding wallet,-5.00,0.00,EUR,COMPLETED,0.00
Transfer,Deposit,2024-06-25 09:54:05,2024-06-25 09:54:05,Savings Vault topup,2.75,0.00,EUR,COMPLETED,2.75
Transfer,Deposit,2024-06-25 09:54:05,2024-06-25 09:54:05,Saving vault topup prefunding wallet,-2.75,0.00,EUR,COMPLETED,0.00
Transfer,Deposit,2024-06-25 15:26:12,2024-06-25 15:26:12,Savings Vault topup,2.55,0.00,EUR,COMPLETED,2.55
Transfer,Deposit,2024-06-25 15:26:12,2024-06-25 15:26:12,Saving vault topup prefunding wallet,-2.55,0.00,EUR,COMPLETED,0.00
Transfer,Deposit,2024-06-26 09:06:22,2024-06-26 09:06:23,Savings Vault topup,2.75,0.00,EUR,COMPLETED,2.75
Transfer,Deposit,2024-06-26 09:06:23,2024-06-26 09:06:23,Saving vault topup prefunding wallet,-2.75,0.00,EUR,COMPLETED,0.00
Transfer,Deposit,2024-06-26 17:33:55,2024-06-26 17:33:55,Savings Vault topup,3.00,0.00,EUR,COMPLETED,3.00
Transfer,Deposit,2024-06-26 17:33:55,2024-06-26 17:33:55,Saving vault topup prefunding wallet,-3.00,0.00,EUR,COMPLETED,0.00
Transfer,Deposit,2024-06-26 17:36:41,2024-06-26 17:36:41,Savings Vault topup,5.00,0.00,EUR,COMPLETED,5.00
Transfer,Deposit,2024-06-26 17:36:41,2024-06-26 17:36:41,Saving vault topup prefunding wallet,-5.00,0.00,EUR,COMPLETED,0.00
Transfer,Deposit,2024-06-26 20:32:51,2024-06-26 20:32:51,Savings Vault topup,5.00,0.00,EUR,COMPLETED,5.00
Transfer,Deposit,2024-06-26 20:32:51,2024-06-26 20:32:51,Saving vault topup prefunding wallet,-5.00,0.00,EUR,COMPLETED,0.00
Transfer,Deposit,2024-06-26 21:49:03,2024-06-26 21:49:03,Savings Vault topup,5.00,0.00,EUR,COMPLETED,5.00
Transfer,Deposit,2024-06-26 21:49:03,2024-06-26 21:49:03,Saving vault topup prefunding wallet,-5.00,0.00,EUR,COMPLETED,0.00
Transfer,Deposit,2024-06-27 00:51:25,2024-06-27 00:51:25,Savings Vault topup,2.75,0.00,EUR,COMPLETED,2.75
Transfer,Deposit,2024-06-27 00:51:26,2024-06-27 00:51:26,Saving vault topup prefunding wallet,-2.75,0.00,EUR,COMPLETED,0.00
Transfer,Deposit,2024-06-27 01:14:43,2024-06-27 01:14:43,Savings Vault topup,4.00,0.00,EUR,COMPLETED,4.00
Transfer,Deposit,2024-06-27 01:14:43,2024-06-27 01:14:43,Saving vault topup prefunding wallet,-4.00,0.00,EUR,COMPLETED,0.00
Transfer,Deposit,2024-06-27 08:55:07,2024-06-27 08:55:07,Savings Vault topup,4.00,0.00,EUR,COMPLETED,4.00
Transfer,Deposit,2024-06-27 08:55:07,2024-06-27 08:55:07,Saving vault topup prefunding wallet,-4.00,0.00,EUR,COMPLETED,0.00
Transfer,Deposit,2024-06-27 18:48:53,2024-06-27 18:48:53,Savings Vault topup,3.05,0.00,EUR,COMPLETED,3.05
Transfer,Deposit,2024-06-27 18:48:53,2024-06-27 18:48:53,Saving vault topup prefunding wallet,-3.05,0.00,EUR,COMPLETED,0.00
Transfer,Deposit,2024-06-28 17:10:27,2024-06-28 17:10:27,Savings Vault topup,2.50,0.00,EUR,COMPLETED,2.50
Transfer,Deposit,2024-06-28 17:10:28,2024-06-28 17:10:28,Saving vault topup prefunding wallet,-2.50,0.00,EUR,COMPLETED,0.00
Transfer,Deposit,2024-06-28 17:37:05,2024-06-28 17:37:05,Savings Vault topup,5.00,0.00,EUR,COMPLETED,5.00
Transfer,Deposit,2024-06-28 17:37:05,2024-06-28 17:37:05,Saving vault topup prefunding wallet,-5.00,0.00,EUR,COMPLETED,0.00
Transfer,Deposit,2024-06-29 10:15:54,2024-06-29 10:15:54,Savings Vault topup,3.00,0.00,EUR,COMPLETED,3.00
Transfer,Deposit,2024-06-29 10:15:54,2024-06-29 10:15:54,Saving vault topup prefunding wallet,-3.00,0.00,EUR,COMPLETED,0.00
Transfer,Deposit,2024-06-29 13:49:26,2024-06-29 13:49:26,Savings Vault topup,0.05,0.00,EUR,COMPLETED,0.05
Transfer,Deposit,2024-06-29 13:49:26,2024-06-29 13:49:26,Saving vault topup prefunding wallet,-0.05,0.00,EUR,COMPLETED,0.00
Transfer,Deposit,2024-06-29 13:51:21,2024-06-29 13:51:21,Savings Vault topup,5.00,0.00,EUR,COMPLETED,5.00
Transfer,Deposit,2024-06-29 13:51:21,2024-06-29 13:51:21,Saving vault topup prefunding wallet,-5.00,0.00,EUR,COMPLETED,0.00
Transfer,Deposit,2024-06-29 13:56:59,2024-06-29 13:56:59,Savings Vault topup,4.00,0.00,EUR,COMPLETED,4.00
Transfer,Deposit,2024-06-29 13:56:59,2024-06-29 13:56:59,Saving vault topup prefunding wallet,-4.00,0.00,EUR,COMPLETED,0.00
Transfer,Deposit,2024-06-29 14:36:02,2024-06-29 14:36:02,Savings Vault topup,3.00,0.00,EUR,COMPLETED,3.00
Transfer,Deposit,2024-06-29 14:36:02,2024-06-29 14:36:02,Saving vault topup prefunding wallet,-3.00,0.00,EUR,COMPLETED,0.00
Transfer,Deposit,2024-06-29 19:13:20,2024-06-29 19:13:21,Savings Vault topup,4.50,0.00,EUR,COMPLETED,4.50
Transfer,Deposit,2024-06-29 19:13:21,2024-06-29 19:13:21,Saving vault topup prefunding wallet,-4.50,0.00,EUR,COMPLETED,0.00
Transfer,Deposit,2024-06-29 20:01:35,2024-06-29 20:01:35,Savings Vault topup,5.00,0.00,EUR,COMPLETED,5.00
Transfer,Deposit,2024-06-29 20:01:35,2024-06-29 20:01:35,Saving vault topup prefunding wallet,-5.00,0.00,EUR,COMPLETED,0.00
Transfer,Deposit,2024-06-29 22:13:14,2024-06-29 22:13:14,Savings Vault topup,5.00,0.00,EUR,COMPLETED,5.00
Transfer,Deposit,2024-06-29 22:13:14,2024-06-29 22:13:14,Saving vault topup prefunding wallet,-5.00,0.00,EUR,COMPLETED,0.00
Transfer,Deposit,2024-06-30 08:15:07,2024-06-30 08:15:07,Savings Vault topup,5.00,0.00,EUR,COMPLETED,5.00
Transfer,Deposit,2024-06-30 08:15:07,2024-06-30 08:15:07,Saving vault topup prefunding wallet,-5.00,0.00,EUR,COMPLETED,0.00
Transfer,Deposit,2024-06-30 14:15:50,2024-06-30 14:15:50,Savings Vault topup,3.00,0.00,EUR,COMPLETED,3.00
Transfer,Deposit,2024-06-30 14:15:50,2024-06-30 14:15:50,Saving vault topup prefunding wallet,-3.00,0.00,EUR,COMPLETED,0.00
Transfer,Deposit,2024-07-01 16:40:01,2024-07-01 16:40:01,Savings Vault topup,5.00,0.00,EUR,COMPLETED,5.00
Transfer,Deposit,2024-07-01 16:40:01,2024-07-01 16:40:01,Saving vault topup prefunding wallet,-5.00,0.00,EUR,COMPLETED,0.00
Transfer,Deposit,2024-07-01 17:30:41,2024-07-01 17:30:41,Savings Vault topup,5.00,0.00,EUR,COMPLETED,5.00
Transfer,Deposit,2024-07-01 17:30:41,2024-07-01 17:30:41,Saving vault topup prefunding wallet,-5.00,0.00,EUR,COMPLETED,0.00
Transfer,Deposit,2024-07-01 18:38:37,2024-07-01 18:38:37,Savings Vault topup,2.50,0.00,EUR,COMPLETED,2.50
Transfer,Deposit,2024-07-01 18:38:37,2024-07-01 18:38:37,Saving vault topup prefunding wallet,-2.50,0.00,EUR,COMPLETED,0.00
Transfer,Deposit,2024-07-01 18:50:08,2024-07-01 18:50:08,Savings Vault topup,5.00,0.00,EUR,COMPLETED,5.00
Transfer,Deposit,2024-07-01 18:50:08,2024-07-01 18:50:08,Saving vault topup prefunding wallet,-5.00,0.00,EUR,COMPLETED,0.00
Transfer,Deposit,2024-07-01 19:04:45,2024-07-01 19:04:45,Savings Vault topup,1.50,0.00,EUR,COMPLETED,1.50
Transfer,Deposit,2024-07-01 19:04:45,2024-07-01 19:04:45,Saving vault topup prefunding wallet,-1.50,0.00,EUR,COMPLETED,0.00
Transfer,Deposit,2024-07-02 13:07:22,2024-07-02 13:07:22,Savings Vault topup,1.85,0.00,EUR,COMPLETED,1.85
Transfer,Deposit,2024-07-02 13:07:22,2024-07-02 13:07:22,Saving vault topup prefunding wallet,-1.85,0.00,EUR,COMPLETED,0.00
Transfer,Deposit,2024-07-02 16:07:46,2024-07-02 16:07:46,Savings Vault topup,2.55,0.00,EUR,COMPLETED,2.55
Transfer,Deposit,2024-07-02 16:07:46,2024-07-02 16:07:46,Saving vault topup prefunding wallet,-2.55,0.00,EUR,COMPLETED,0.00
Transfer,Deposit,2024-07-03 09:56:19,2024-07-03 09:56:20,Savings Vault topup,0.05,0.00,EUR,COMPLETED,0.05
Transfer,Deposit,2024-07-03 09:56:20,2024-07-03 09:56:20,Saving vault topup prefunding wallet,-0.05,0.00,EUR,COMPLETED,0.00
Transfer,Deposit,2024-07-03 16:04:00,2024-07-03 16:04:00,Savings Vault topup,1.25,0.00,EUR,COMPLETED,1.25
Transfer,Deposit,2024-07-03 16:04:00,2024-07-03 16:04:00,Saving vault topup prefunding wallet,-1.25,0.00,EUR,COMPLETED,0.00
Transfer,Deposit,2024-07-03 18:56:33,2024-07-03 18:56:33,Savings Vault topup,1.00,0.00,EUR,COMPLETED,1.00
Transfer,Deposit,2024-07-03 18:56:33,2024-07-03 18:56:33,Saving vault topup prefunding wallet,-1.00,0.00,EUR,COMPLETED,0.00
Transfer,Deposit,2024-07-04 02:51:45,2024-07-04 02:51:45,Savings Vault topup,0.05,0.00,EUR,COMPLETED,0.05
Transfer,Deposit,2024-07-04 02:51:45,2024-07-04 02:51:45,Saving vault topup prefunding wallet,-0.05,0.00,EUR,COMPLETED,0.00
Transfer,Deposit,2024-07-04 09:36:25,2024-07-04 09:36:26,Savings Vault topup,0.30,0.00,EUR,COMPLETED,0.30
Transfer,Deposit,2024-07-04 09:36:26,2024-07-04 09:36:26,Saving vault topup prefunding wallet,-0.30,0.00,EUR,COMPLETED,0.00
Transfer,Deposit,2024-07-04 10:48:59,2024-07-04 10:48:59,Savings Vault topup,5.00,0.00,EUR,COMPLETED,5.00
Transfer,Deposit,2024-07-04 10:48:59,2024-07-04 10:48:59,Saving vault topup prefunding wallet,-5.00,0.00,EUR,COMPLETED,0.00
Transfer,Deposit,2024-07-04 15:15:03,2024-07-04 15:15:03,Savings Vault topup,3.00,0.00,EUR,COMPLETED,3.00
Transfer,Deposit,2024-07-04 15:15:03,2024-07-04 15:15:03,Saving vault topup prefunding wallet,-3.00,0.00,EUR,COMPLETED,0.00
Transfer,Deposit,2024-07-04 17:42:29,2024-07-04 17:42:29,Savings Vault topup,3.00,0.00,EUR,COMPLETED,3.00
Transfer,Deposit,2024-07-04 17:42:29,2024-07-04 17:42:29,Saving vault topup prefunding wallet,-3.00,0.00,EUR,COMPLETED,0.00
Transfer,Deposit,2024-07-04 18:51:13,2024-07-04 18:51:13,Savings Vault topup,0.15,0.00,EUR,COMPLETED,0.15
Transfer,Deposit,2024-07-04 18:51:13,2024-07-04 18:51:13,Saving vault topup prefunding wallet,-0.15,0.00,EUR,COMPLETED,0.00
Transfer,Deposit,2024-07-04 21:55:05,2024-07-04 21:55:05,Savings Vault topup,1.00,0.00,EUR,COMPLETED,1.00
Transfer,Deposit,2024-07-04 21:55:06,2024-07-04 21:55:06,Saving vault topup prefunding wallet,-1.00,0.00,EUR,COMPLETED,0.00
Transfer,Deposit,2024-07-05 14:09:37,2024-07-05 14:09:37,Savings Vault topup,4.00,0.00,EUR,COMPLETED,4.00
Transfer,Deposit,2024-07-05 14:09:37,2024-07-05 14:09:37,Saving vault topup prefunding wallet,-4.00,0.00,EUR,COMPLETED,0.00
Transfer,Deposit,2024-07-05 15:45:04,2024-07-05 15:45:04,Savings Vault topup,0.75,0.00,EUR,COMPLETED,0.75
Transfer,Deposit,2024-07-05 15:45:04,2024-07-05 15:45:04,Saving vault topup prefunding wallet,-0.75,0.00,EUR,COMPLETED,0.00
Transfer,Deposit,2024-07-05 20:26:08,2024-07-05 20:26:08,Savings Vault topup,4.05,0.00,EUR,COMPLETED,4.05
Transfer,Deposit,2024-07-05 20:26:08,2024-07-05 20:26:08,Saving vault topup prefunding wallet,-4.05,0.00,EUR,COMPLETED,0.00
Transfer,Deposit,2024-07-06 17:47:19,2024-07-06 17:47:19,Savings Vault topup,5.00,0.00,EUR,COMPLETED,5.00
Transfer,Deposit,2024-07-06 17:47:19,2024-07-06 17:47:19,Saving vault topup prefunding wallet,-5.00,0.00,EUR,COMPLETED,0.00
Transfer,Deposit,2024-07-06 19:10:04,2024-07-06 19:10:04,Savings Vault topup,5.00,0.00,EUR,COMPLETED,5.00
Transfer,Deposit,2024-07-06 19:10:04,2024-07-06 19:10:04,Saving vault topup prefunding wallet,-5.00,0.00,EUR,COMPLETED,0.00
Transfer,Deposit,2024-07-07 11:14:09,2024-07-07 11:14:09,Savings Vault topup,4.50,0.00,EUR,COMPLETED,4.50
Transfer,Deposit,2024-07-07 11:14:09,2024-07-07 11:14:09,Saving vault topup prefunding wallet,-4.50,0.00,EUR,COMPLETED,0.00
Transfer,Deposit,2024-07-07 13:09:17,2024-07-07 13:09:17,Savings Vault topup,4.50,0.00,EUR,COMPLETED,4.50
Transfer,Deposit,2024-07-07 13:09:17,2024-07-07 13:09:17,Saving vault topup prefunding wallet,-4.50,0.00,EUR,COMPLETED,0.00
Transfer,Deposit,2024-07-07 15:16:59,2024-07-07 15:16:59,Savings Vault topup,0.75,0.00,EUR,COMPLETED,0.75
Transfer,Deposit,2024-07-07 15:16:59,2024-07-07 15:16:59,Saving vault topup prefunding wallet,-0.75,0.00,EUR,COMPLETED,0.00
Transfer,Deposit,2024-07-08 19:11:42,2024-07-08 19:11:43,Savings Vault topup,2.50,0.00,EUR,COMPLETED,2.50
Transfer,Deposit,2024-07-08 19:11:43,2024-07-08 19:11:43,Saving vault topup prefunding wallet,-2.50,0.00,EUR,COMPLETED,0.00
Transfer,Deposit,2024-07-09 09:08:30,2024-07-09 09:08:30,Savings Vault topup,1.50,0.00,EUR,COMPLETED,1.50
Transfer,Deposit,2024-07-09 09:08:30,2024-07-09 09:08:30,Saving vault topup prefunding wallet,-1.50,0.00,EUR,COMPLETED,0.00
Transfer,Deposit,2024-07-09 12:57:56,2024-07-09 12:57:57,Savings Vault topup,1.25,0.00,EUR,COMPLETED,1.25
Transfer,Deposit,2024-07-09 12:57:57,2024-07-09 12:57:57,Saving vault topup prefunding wallet,-1.25,0.00,EUR,COMPLETED,0.00
Transfer,Deposit,2024-07-09 20:55:13,2024-07-09 20:55:13,Savings Vault topup,0.15,0.00,EUR,COMPLETED,0.15
Transfer,Deposit,2024-07-09 20:55:13,2024-07-09 20:55:13,Saving vault topup prefunding wallet,-0.15,0.00,EUR,COMPLETED,0.00
Transfer,Deposit,2024-07-09 21:02:08,2024-07-09 21:02:08,Savings Vault topup,5.00,0.00,EUR,COMPLETED,5.00
Transfer,Deposit,2024-07-09 21:02:08,2024-07-09 21:02:08,Saving vault topup prefunding wallet,-5.00,0.00,EUR,COMPLETED,0.00
Transfer,Deposit,2024-07-10 14:00:50,2024-07-10 14:00:50,Savings Vault topup,2.05,0.00,EUR,COMPLETED,2.05
Transfer,Deposit,2024-07-10 14:00:50,2024-07-10 14:00:50,Saving vault topup prefunding wallet,-2.05,0.00,EUR,COMPLETED,0.00
Transfer,Deposit,2024-07-10 21:15:41,2024-07-10 21:15:41,Savings Vault topup,5.00,0.00,EUR,COMPLETED,5.00
Transfer,Deposit,2024-07-10 21:15:41,2024-07-10 21:15:41,Saving vault topup prefunding wallet,-5.00,0.00,EUR,COMPLETED,0.00
Transfer,Deposit,2024-07-11 08:43:24,2024-07-11 08:43:24,Savings Vault topup,0.05,0.00,EUR,COMPLETED,0.05
Transfer,Deposit,2024-07-11 08:43:24,2024-07-11 08:43:24,Saving vault topup prefunding wallet,-0.05,0.00,EUR,COMPLETED,0.00
Transfer,Deposit,2024-07-11 08:46:59,2024-07-11 08:46:59,Savings Vault topup,2.75,0.00,EUR,COMPLETED,2.75
Transfer,Deposit,2024-07-11 08:46:59,2024-07-11 08:46:59,Saving vault topup prefunding wallet,-2.75,0.00,EUR,COMPLETED,0.00
Transfer,Deposit,2024-07-11 13:59:34,2024-07-11 13:59:34,Savings Vault topup,5.00,0.00,EUR,COMPLETED,5.00
Transfer,Deposit,2024-07-11 13:59:34,2024-07-11 13:59:34,Saving vault topup prefunding wallet,-5.00,0.00,EUR,COMPLETED,0.00
Transfer,Deposit,2024-07-11 15:54:35,2024-07-11 15:54:35,Savings Vault topup,2.60,0.00,EUR,COMPLETED,2.60
Transfer,Deposit,2024-07-11 15:54:35,2024-07-11 15:54:35,Saving vault topup prefunding wallet,-2.60,0.00,EUR,COMPLETED,0.00
Transfer,Deposit,2024-07-11 23:06:20,2024-07-11 23:06:20,Savings Vault topup,0.55,0.00,EUR,COMPLETED,0.55
Transfer,Deposit,2024-07-11 23:06:20,2024-07-11 23:06:20,Saving vault topup prefunding wallet,-0.55,0.00,EUR,COMPLETED,0.00
Transfer,Deposit,2024-07-12 08:39:30,2024-07-12 08:39:30,Savings Vault topup,2.90,0.00,EUR,COMPLETED,2.90
Transfer,Deposit,2024-07-12 08:39:30,2024-07-12 08:39:30,Saving vault topup prefunding wallet,-2.90,0.00,EUR,COMPLETED,0.00
Transfer,Deposit,2024-07-12 08:40:28,2024-07-12 08:40:29,Savings Vault topup,5.00,0.00,EUR,COMPLETED,5.00
Transfer,Deposit,2024-07-12 08:40:29,2024-07-12 08:40:29,Saving vault topup prefunding wallet,-5.00,0.00,EUR,COMPLETED,0.00
Transfer,Deposit,2024-07-12 18:24:16,2024-07-12 18:24:16,Savings Vault topup,3.00,0.00,EUR,COMPLETED,3.00
Transfer,Deposit,2024-07-12 18:24:16,2024-07-12 18:24:16,Saving vault topup prefunding wallet,-3.00,0.00,EUR,COMPLETED,0.00
Transfer,Deposit,2024-07-12 19:33:25,2024-07-12 19:33:25,Savings Vault topup,0.60,0.00,EUR,COMPLETED,0.60
Transfer,Deposit,2024-07-12 19:33:25,2024-07-12 19:33:25,Saving vault topup prefunding wallet,-0.60,0.00,EUR,COMPLETED,0.00
Transfer,Deposit,2024-07-13 09:00:19,2024-07-13 09:00:19,Savings Vault topup,0.25,0.00,EUR,COMPLETED,0.25
Transfer,Deposit,2024-07-13 09:00:19,2024-07-13 09:00:19,Saving vault topup prefunding wallet,-0.25,0.00,EUR,COMPLETED,0.00
Transfer,Deposit,2024-07-13 10:57:17,2024-07-13 10:57:17,Savings Vault topup,1.00,0.00,EUR,COMPLETED,1.00
Transfer,Deposit,2024-07-13 10:57:17,2024-07-13 10:57:17,Saving vault topup prefunding wallet,-1.00,0.00,EUR,COMPLETED,0.00
Transfer,Deposit,2024-07-13 11:32:58,2024-07-13 11:32:58,Savings Vault topup,2.50,0.00,EUR,COMPLETED,2.50
Transfer,Deposit,2024-07-13 11:32:58,2024-07-13 11:32:58,Saving vault topup prefunding wallet,-2.50,0.00,EUR,COMPLETED,0.00
Transfer,Deposit,2024-07-13 21:11:51,2024-07-13 21:11:51,Savings Vault topup,1.50,0.00,EUR,COMPLETED,1.50
Transfer,Deposit,2024-07-13 21:11:51,2024-07-13 21:11:51,Saving vault topup prefunding wallet,-1.50,0.00,EUR,COMPLETED,0.00
Transfer,Deposit,2024-07-13 21:14:11,2024-07-13 21:14:11,Savings Vault topup,2.50,0.00,EUR,COMPLETED,2.50
Transfer,Deposit,2024-07-13 21:14:11,2024-07-13 21:14:11,Saving vault topup prefunding wallet,-2.50,0.00,EUR,COMPLETED,0.00
Transfer,Deposit,2024-07-13 22:40:33,2024-07-13 22:40:33,Savings Vault topup,0.50,0.00,EUR,COMPLETED,0.50
Transfer,Deposit,2024-07-13 22:40:33,2024-07-13 22:40:33,Saving vault topup prefunding wallet,-0.50,0.00,EUR,COMPLETED,0.00
Transfer,Deposit,2024-07-14 00:01:18,2024-07-14 00:01:18,Savings Vault topup,2.50,0.00,EUR,COMPLETED,2.50
Transfer,Deposit,2024-07-14 00:01:18,2024-07-14 00:01:18,Saving vault topup prefunding wallet,-2.50,0.00,EUR,COMPLETED,0.00
Transfer,Deposit,2024-07-14 00:41:30,2024-07-14 00:41:30,Savings Vault topup,4.00,0.00,EUR,COMPLETED,4.00
Transfer,Deposit,2024-07-14 00:41:30,2024-07-14 00:41:30,Saving vault topup prefunding wallet,-4.00,0.00,EUR,COMPLETED,0.00
Transfer,Deposit,2024-07-14 10:16:14,2024-07-14 10:16:14,Savings Vault topup,3.50,0.00,EUR,COMPLETED,3.50
Transfer,Deposit,2024-07-14 10:16:14,2024-07-14 10:16:14,Saving vault topup prefunding wallet,-3.50,0.00,EUR,COMPLETED,0.00
Transfer,Deposit,2024-07-14 13:18:41,2024-07-14 13:18:41,Savings Vault topup,0.75,0.00,EUR,COMPLETED,0.75
Transfer,Deposit,2024-07-14 13:18:41,2024-07-14 13:18:41,Saving vault topup prefunding wallet,-0.75,0.00,EUR,COMPLETED,0.00
Transfer,Deposit,2024-07-14 14:20:55,2024-07-14 14:20:55,Savings Vault topup,3.05,0.00,EUR,COMPLETED,3.05
Transfer,Deposit,2024-07-14 14:20:55,2024-07-14 14:20:55,Saving vault topup prefunding wallet,-3.05,0.00,EUR,COMPLETED,0.00
Transfer,Deposit,2024-07-14 18:06:05,2024-07-14 18:06:05,Savings Vault topup,3.00,0.00,EUR,COMPLETED,3.00
Transfer,Deposit,2024-07-14 18:06:05,2024-07-14 18:06:05,Saving vault topup prefunding wallet,-3.00,0.00,EUR,COMPLETED,0.00
Transfer,Deposit,2024-07-14 22:23:10,2024-07-14 22:23:10,Savings Vault topup,4.85,0.00,EUR,COMPLETED,4.85
Transfer,Deposit,2024-07-14 22:23:10,2024-07-14 22:23:10,Saving vault topup prefunding wallet,-4.85,0.00,EUR,COMPLETED,0.00
Transfer,Deposit,2024-07-15 08:29:54,2024-07-15 08:29:54,Savings Vault topup,4.30,0.00,EUR,COMPLETED,4.30
Transfer,Deposit,2024-07-15 08:29:54,2024-07-15 08:29:54,Saving vault topup prefunding wallet,-4.30,0.00,EUR,COMPLETED,0.00
Transfer,Deposit,2024-07-15 13:00:57,2024-07-15 13:00:57,Savings Vault topup,1.20,0.00,EUR,COMPLETED,1.20
Transfer,Deposit,2024-07-15 13:00:57,2024-07-15 13:00:57,Saving vault topup prefunding wallet,-1.20,0.00,EUR,COMPLETED,0.00
Transfer,Deposit,2024-07-15 19:03:48,2024-07-15 19:03:48,Savings Vault topup,2.15,0.00,EUR,COMPLETED,2.15
Transfer,Deposit,2024-07-15 19:03:48,2024-07-15 19:03:48,Saving vault topup prefunding wallet,-2.15,0.00,EUR,COMPLETED,0.00
Transfer,Deposit,2024-07-15 20:19:02,2024-07-15 20:19:02,Savings Vault topup,3.60,0.00,EUR,COMPLETED,3.60
Transfer,Deposit,2024-07-15 20:19:02,2024-07-15 20:19:02,Saving vault topup prefunding wallet,-3.60,0.00,EUR,COMPLETED,0.00
Transfer,Deposit,2024-07-16 14:28:16,2024-07-16 14:28:16,Savings Vault topup,2.75,0.00,EUR,COMPLETED,2.75
Transfer,Deposit,2024-07-16 14:28:16,2024-07-16 14:28:16,Saving vault topup prefunding wallet,-2.75,0.00,EUR,COMPLETED,0.00
Transfer,Deposit,2024-07-16 17:32:15,2024-07-16 17:32:16,Savings Vault topup,5.00,0.00,EUR,COMPLETED,5.00
Transfer,Deposit,2024-07-16 17:32:16,2024-07-16 17:32:16,Saving vault topup prefunding wallet,-5.00,0.00,EUR,COMPLETED,0.00
Transfer,Deposit,2024-07-16 17:32:46,2024-07-16 17:32:46,Savings Vault topup,3.80,0.00,EUR,COMPLETED,3.80
Transfer,Deposit,2024-07-16 17:32:46,2024-07-16 17:32:46,Saving vault topup prefunding wallet,-3.80,0.00,EUR,COMPLETED,0.00
Transfer,Deposit,2024-07-16 19:24:22,2024-07-16 19:24:22,Savings Vault topup,5.00,0.00,EUR,COMPLETED,5.00
Transfer,Deposit,2024-07-16 19:24:22,2024-07-16 19:24:22,Saving vault topup prefunding wallet,-5.00,0.00,EUR,COMPLETED,0.00
Transfer,Deposit,2024-07-17 10:56:54,2024-07-17 10:56:54,Savings Vault topup,1.45,0.00,EUR,COMPLETED,1.45
Transfer,Deposit,2024-07-17 10:56:54,2024-07-17 10:56:54,Saving vault topup prefunding wallet,-1.45,0.00,EUR,COMPLETED,0.00
Transfer,Deposit,2024-07-17 20:19:01,2024-07-17 20:19:01,Savings vault withdrawal from prefunding wallet,100.00,0.00,EUR,COMPLETED,100.00
Transfer,Deposit,2024-07-17 20:19:01,2024-07-17 20:19:01,From Flexible Cash Funds,-100.00,0.00,EUR,COMPLETED,0.00
Transfer,Deposit,2024-07-17 20:19:16,2024-07-17 20:19:16,Savings Vault topup,4.65,0.00,EUR,COMPLETED,4.65
Transfer,Deposit,2024-07-17 20:19:16,2024-07-17 20:19:16,Saving vault topup prefunding wallet,-4.65,0.00,EUR,COMPLETED,0.00
Transfer,Deposit,2024-07-18 08:43:40,2024-07-18 08:43:40,Savings Vault topup,1.50,0.00,EUR,COMPLETED,1.50
Transfer,Deposit,2024-07-18 08:43:40,2024-07-18 08:43:40,Saving vault topup prefunding wallet,-1.50,0.00,EUR,COMPLETED,0.00
Transfer,Deposit,2024-07-18 09:11:41,2024-07-18 09:11:41,Savings Vault topup,0.40,0.00,EUR,COMPLETED,0.40
Transfer,Deposit,2024-07-18 09:11:41,2024-07-18 09:11:41,Saving vault topup prefunding wallet,-0.40,0.00,EUR,COMPLETED,0.00
Transfer,Deposit,2024-07-18 17:30:24,2024-07-18 17:30:24,Savings Vault topup,1.10,0.00,EUR,COMPLETED,1.10
Transfer,Deposit,2024-07-18 17:30:24,2024-07-18 17:30:24,Saving vault topup prefunding wallet,-1.10,0.00,EUR,COMPLETED,0.00
Transfer,Deposit,2024-07-19 08:41:04,2024-07-19 08:41:04,Savings Vault topup,1.00,0.00,EUR,COMPLETED,1.00
Transfer,Deposit,2024-07-19 08:41:04,2024-07-19 08:41:04,Saving vault topup prefunding wallet,-1.00,0.00,EUR,COMPLETED,0.00
Transfer,Deposit,2024-07-19 09:08:10,2024-07-19 09:08:10,Savings Vault topup,4.35,0.00,EUR,COMPLETED,4.35
Transfer,Deposit,2024-07-19 09:08:10,2024-07-19 09:08:10,Saving vault topup prefunding wallet,-4.35,0.00,EUR,COMPLETED,0.00
Transfer,Deposit,2024-07-19 19:19:03,2024-07-19 19:19:03,Savings Vault topup,3.00,0.00,EUR,COMPLETED,3.00
Transfer,Deposit,2024-07-19 19:19:03,2024-07-19 19:19:03,Saving vault topup prefunding wallet,-3.00,0.00,EUR,COMPLETED,0.00
Transfer,Deposit,2024-07-19 20:46:36,2024-07-19 20:46:36,Savings Vault topup,2.80,0.00,EUR,COMPLETED,2.80
Transfer,Deposit,2024-07-19 20:46:36,2024-07-19 20:46:36,Saving vault topup prefunding wallet,-2.80,0.00,EUR,COMPLETED,0.00
Transfer,Deposit,2024-07-20 11:23:53,2024-07-20 11:23:54,Savings Vault topup,5.00,0.00,EUR,COMPLETED,5.00
Transfer,Deposit,2024-07-20 11:23:54,2024-07-20 11:23:54,Saving vault topup prefunding wallet,-5.00,0.00,EUR,COMPLETED,0.00
Transfer,Deposit,2024-07-20 19:11:46,2024-07-20 19:11:46,Savings vault withdrawal from prefunding wallet,100.00,0.00,EUR,COMPLETED,100.00
Transfer,Deposit,2024-07-20 19:11:46,2024-07-20 19:11:46,From Flexible Cash Funds,-100.00,0.00,EUR,COMPLETED,0.00
Transfer,Deposit,2024-07-20 19:12:47,2024-07-20 19:12:47,Savings Vault topup,3.50,0.00,EUR,COMPLETED,3.50
Transfer,Deposit,2024-07-20 19:12:47,2024-07-20 19:12:47,Saving vault topup prefunding wallet,-3.50,0.00,EUR,COMPLETED,0.00
Transfer,Deposit,2024-07-20 21:25:29,2024-07-20 21:25:29,Savings vault withdrawal from prefunding wallet,50.00,0.00,EUR,COMPLETED,50.00
Transfer,Deposit,2024-07-20 21:25:29,2024-07-20 21:25:29,From Flexible Cash Funds,-50.00,0.00,EUR,COMPLETED,0.00
Transfer,Deposit,2024-07-20 21:39:14,2024-07-20 21:39:14,Savings Vault topup,5.00,0.00,EUR,COMPLETED,5.00
Transfer,Deposit,2024-07-20 21:39:14,2024-07-20 21:39:14,Saving vault topup prefunding wallet,-5.00,0.00,EUR,COMPLETED,0.00
Transfer,Deposit,2024-07-20 22:58:00,2024-07-20 22:58:00,Savings Vault topup,2.00,0.00,EUR,COMPLETED,2.00
Transfer,Deposit,2024-07-20 22:58:00,2024-07-20 22:58:00,Saving vault topup prefunding wallet,-2.00,0.00,EUR,COMPLETED,0.00
Transfer,Deposit,2024-07-21 00:19:00,2024-07-21 00:19:00,Savings Vault topup,5.00,0.00,EUR,COMPLETED,5.00
Transfer,Deposit,2024-07-21 00:19:00,2024-07-21 00:19:00,Saving vault topup prefunding wallet,-5.00,0.00,EUR,COMPLETED,0.00
Transfer,Deposit,2024-07-21 01:36:42,2024-07-21 01:36:42,Savings vault withdrawal from prefunding wallet,400.00,0.00,EUR,COMPLETED,400.00
Transfer,Deposit,2024-07-21 01:36:42,2024-07-21 01:36:42,From Flexible Cash Funds,-400.00,0.00,EUR,COMPLETED,0.00
Transfer,Deposit,2024-07-21 01:37:06,2024-07-21 01:37:06,Savings Vault topup,0.05,0.00,EUR,COMPLETED,0.05
Transfer,Deposit,2024-07-21 01:37:06,2024-07-21 01:37:06,Saving vault topup prefunding wallet,-0.05,0.00,EUR,COMPLETED,0.00
Transfer,Deposit,2024-07-21 01:42:51,2024-07-21 01:42:51,Savings Vault topup,0.75,0.00,EUR,COMPLETED,0.75
Transfer,Deposit,2024-07-21 01:42:51,2024-07-21 01:42:51,Saving vault topup prefunding wallet,-0.75,0.00,EUR,COMPLETED,0.00
Transfer,Deposit,2024-07-21 12:53:20,2024-07-21 12:53:21,Savings Vault topup,2.65,0.00,EUR,COMPLETED,2.65
Transfer,Deposit,2024-07-21 12:53:21,2024-07-21 12:53:21,Saving vault topup prefunding wallet,-2.65,0.00,EUR,COMPLETED,0.00
Transfer,Deposit,2024-07-22 14:46:52,2024-07-22 14:46:52,Savings vault withdrawal from prefunding wallet,100.00,0.00,EUR,COMPLETED,100.00
Transfer,Deposit,2024-07-22 14:46:52,2024-07-22 14:46:52,From Flexible Cash Funds,-100.00,0.00,EUR,COMPLETED,0.00
Transfer,Deposit,2024-07-22 14:47:07,2024-07-22 14:47:07,Savings Vault topup,1.35,0.00,EUR,COMPLETED,1.35
Transfer,Deposit,2024-07-22 14:47:07,2024-07-22 14:47:07,Saving vault topup prefunding wallet,-1.35,0.00,EUR,COMPLETED,0.00
Transfer,Deposit,2024-07-22 17:05:30,2024-07-22 17:05:30,Savings Vault topup,4.10,0.00,EUR,COMPLETED,4.10
Transfer,Deposit,2024-07-22 17:05:30,2024-07-22 17:05:30,Saving vault topup prefunding wallet,-4.10,0.00,EUR,COMPLETED,0.00
Transfer,Deposit,2024-07-22 17:06:37,2024-07-22 17:06:37,Savings Vault topup,3.60,0.00,EUR,COMPLETED,3.60
Transfer,Deposit,2024-07-22 17:06:37,2024-07-22 17:06:37,Saving vault topup prefunding wallet,-3.60,0.00,EUR,COMPLETED,0.00
Transfer,Deposit,2024-07-23 09:13:20,2024-07-23 09:13:20,Savings Vault topup,1.50,0.00,EUR,COMPLETED,1.50
Transfer,Deposit,2024-07-23 09:13:20,2024-07-23 09:13:20,Saving vault topup prefunding wallet,-1.50,0.00,EUR,COMPLETED,0.00
Transfer,Deposit,2024-07-23 16:59:55,2024-07-23 16:59:55,Savings Vault topup,3.95,0.00,EUR,COMPLETED,3.95
Transfer,Deposit,2024-07-23 16:59:55,2024-07-23 16:59:55,Saving vault topup prefunding wallet,-3.95,0.00,EUR,COMPLETED,0.00
Transfer,Deposit,2024-07-23 18:49:43,2024-07-23 18:49:43,Savings vault withdrawal from prefunding wallet,100.00,0.00,EUR,COMPLETED,100.00
Transfer,Deposit,2024-07-23 18:49:43,2024-07-23 18:49:43,From Flexible Cash Funds,-100.00,0.00,EUR,COMPLETED,0.00
Transfer,Deposit,2024-07-23 18:49:49,2024-07-23 18:49:50,Savings Vault topup,5.00,0.00,EUR,COMPLETED,5.00
Transfer,Deposit,2024-07-23 18:49:50,2024-07-23 18:49:50,Saving vault topup prefunding wallet,-5.00,0.00,EUR,COMPLETED,0.00
Transfer,Deposit,2024-07-24 09:03:08,2024-07-24 09:03:08,Savings Vault topup,1.50,0.00,EUR,COMPLETED,1.50
Transfer,Deposit,2024-07-24 09:03:08,2024-07-24 09:03:08,Saving vault topup prefunding wallet,-1.50,0.00,EUR,COMPLETED,0.00
Transfer,Deposit,2024-07-24 18:32:20,2024-07-24 18:32:20,Savings Vault topup,1.50,0.00,EUR,COMPLETED,1.50
Transfer,Deposit,2024-07-24 18:32:20,2024-07-24 18:32:20,Saving vault topup prefunding wallet,-1.50,0.00,EUR,COMPLETED,0.00
Transfer,Deposit,2024-07-25 08:26:40,2024-07-25 08:26:40,Savings Vault topup,300.00,0.00,EUR,COMPLETED,300.00
Transfer,Deposit,2024-07-25 08:26:40,2024-07-25 08:26:40,Saving vault topup prefunding wallet,-300.00,0.00,EUR,COMPLETED,0.00
Transfer,Deposit,2024-07-25 08:26:48,2024-07-25 08:26:49,Savings Vault topup,43.00,0.00,EUR,COMPLETED,43.00
Transfer,Deposit,2024-07-25 08:26:49,2024-07-25 08:26:49,Saving vault topup prefunding wallet,-43.00,0.00,EUR,COMPLETED,0.00
Transfer,Deposit,2024-07-25 08:33:27,2024-07-25 08:33:27,Savings Vault topup,2.30,0.00,EUR,COMPLETED,2.30
Transfer,Deposit,2024-07-25 08:33:27,2024-07-25 08:33:27,Saving vault topup prefunding wallet,-2.30,0.00,EUR,COMPLETED,0.00
Transfer,Deposit,2024-07-25 08:40:15,2024-07-25 08:40:15,Savings Vault topup,2.50,0.00,EUR,COMPLETED,2.50
Transfer,Deposit,2024-07-25 08:40:15,2024-07-25 08:40:15,Saving vault topup prefunding wallet,-2.50,0.00,EUR,COMPLETED,0.00
Transfer,Deposit,2024-07-25 17:58:28,2024-07-25 17:58:28,Savings Vault topup,5.00,0.00,EUR,COMPLETED,5.00
Transfer,Deposit,2024-07-25 17:58:28,2024-07-25 17:58:28,Saving vault topup prefunding wallet,-5.00,0.00,EUR,COMPLETED,0.00
Transfer,Deposit,2024-07-25 22:09:57,2024-07-25 22:09:57,Savings Vault topup,3.00,0.00,EUR,COMPLETED,3.00
Transfer,Deposit,2024-07-25 22:09:57,2024-07-25 22:09:57,Saving vault topup prefunding wallet,-3.00,0.00,EUR,COMPLETED,0.00
Transfer,Deposit,2024-07-25 23:50:38,2024-07-25 23:50:38,Savings Vault topup,0.25,0.00,EUR,COMPLETED,0.25
Transfer,Deposit,2024-07-25 23:50:38,2024-07-25 23:50:38,Saving vault topup prefunding wallet,-0.25,0.00,EUR,COMPLETED,0.00
Transfer,Deposit,2024-07-26 00:13:02,2024-07-26 00:13:02,Savings Vault topup,4.00,0.00,EUR,COMPLETED,4.00
Transfer,Deposit,2024-07-26 00:13:02,2024-07-26 00:13:02,Saving vault topup prefunding wallet,-4.00,0.00,EUR,COMPLETED,0.00
Transfer,Deposit,2024-07-26 12:26:31,2024-07-26 12:26:31,Savings Vault topup,5.00,0.00,EUR,COMPLETED,5.00
Transfer,Deposit,2024-07-26 12:26:31,2024-07-26 12:26:31,Saving vault topup prefunding wallet,-5.00,0.00,EUR,COMPLETED,0.00
Transfer,Deposit,2024-07-26 19:05:40,2024-07-26 19:05:40,Savings Vault topup,5.00,0.00,EUR,COMPLETED,5.00
Transfer,Deposit,2024-07-26 19:05:40,2024-07-26 19:05:40,Saving vault topup prefunding wallet,-5.00,0.00,EUR,COMPLETED,0.00
Transfer,Deposit,2024-07-26 19:12:59,2024-07-26 19:12:59,Savings Vault topup,4.75,0.00,EUR,COMPLETED,4.75
Transfer,Deposit,2024-07-26 19:12:59,2024-07-26 19:12:59,Saving vault topup prefunding wallet,-4.75,0.00,EUR,COMPLETED,0.00
Transfer,Deposit,2024-07-27 13:55:54,2024-07-27 13:55:55,Savings Vault topup,3.25,0.00,EUR,COMPLETED,3.25
Transfer,Deposit,2024-07-27 13:55:55,2024-07-27 13:55:55,Saving vault topup prefunding wallet,-3.25,0.00,EUR,COMPLETED,0.00
Transfer,Deposit,2024-07-27 18:13:05,2024-07-27 18:13:05,Savings Vault topup,2.50,0.00,EUR,COMPLETED,2.50
Transfer,Deposit,2024-07-27 18:13:05,2024-07-27 18:13:05,Saving vault topup prefunding wallet,-2.50,0.00,EUR,COMPLETED,0.00
Transfer,Deposit,2024-07-27 18:43:15,2024-07-27 18:43:15,Savings Vault topup,5.00,0.00,EUR,COMPLETED,5.00
Transfer,Deposit,2024-07-27 18:43:15,2024-07-27 18:43:15,Saving vault topup prefunding wallet,-5.00,0.00,EUR,COMPLETED,0.00
Transfer,Deposit,2024-07-27 18:44:24,2024-07-27 18:44:25,Savings Vault topup,2.50,0.00,EUR,COMPLETED,2.50
Transfer,Deposit,2024-07-27 18:44:25,2024-07-27 18:44:25,Saving vault topup prefunding wallet,-2.50,0.00,EUR,COMPLETED,0.00
Transfer,Deposit,2024-07-27 19:09:39,2024-07-27 19:09:39,Savings Vault topup,5.00,0.00,EUR,COMPLETED,5.00
Transfer,Deposit,2024-07-27 19:09:39,2024-07-27 19:09:39,Saving vault topup prefunding wallet,-5.00,0.00,EUR,COMPLETED,0.00
Transfer,Deposit,2024-07-27 19:52:11,2024-07-27 19:52:11,Savings Vault topup,5.00,0.00,EUR,COMPLETED,5.00
Transfer,Deposit,2024-07-27 19:52:11,2024-07-27 19:52:11,Saving vault topup prefunding wallet,-5.00,0.00,EUR,COMPLETED,0.00
Transfer,Deposit,2024-07-27 22:11:33,2024-07-27 22:11:33,Savings Vault topup,2.50,0.00,EUR,COMPLETED,2.50
Transfer,Deposit,2024-07-27 22:11:33,2024-07-27 22:11:33,Saving vault topup prefunding wallet,-2.50,0.00,EUR,COMPLETED,0.00
Transfer,Deposit,2024-07-27 22:43:42,2024-07-27 22:43:42,Savings Vault topup,3.00,0.00,EUR,COMPLETED,3.00
Transfer,Deposit,2024-07-27 22:43:42,2024-07-27 22:43:42,Saving vault topup prefunding wallet,-3.00,0.00,EUR,COMPLETED,0.00
Transfer,Deposit,2024-07-27 23:10:32,2024-07-27 23:10:32,Savings Vault topup,3.00,0.00,EUR,COMPLETED,3.00
Transfer,Deposit,2024-07-27 23:10:33,2024-07-27 23:10:33,Saving vault topup prefunding wallet,-3.00,0.00,EUR,COMPLETED,0.00
Transfer,Deposit,2024-07-28 17:40:22,2024-07-28 17:40:22,Savings Vault topup,4.75,0.00,EUR,COMPLETED,4.75
Transfer,Deposit,2024-07-28 17:40:22,2024-07-28 17:40:22,Saving vault topup prefunding wallet,-4.75,0.00,EUR,COMPLETED,0.00
Transfer,Deposit,2024-07-28 17:48:54,2024-07-28 17:48:54,Savings Vault topup,1.05,0.00,EUR,COMPLETED,1.05
Transfer,Deposit,2024-07-28 17:48:54,2024-07-28 17:48:54,Saving vault topup prefunding wallet,-1.05,0.00,EUR,COMPLETED,0.00
Transfer,Deposit,2024-07-29 08:45:45,2024-07-29 08:45:45,Savings Vault topup,1.25,0.00,EUR,COMPLETED,1.25
Transfer,Deposit,2024-07-29 08:45:45,2024-07-29 08:45:45,Saving vault topup prefunding wallet,-1.25,0.00,EUR,COMPLETED,0.00
Transfer,Deposit,2024-07-29 18:30:21,2024-07-29 18:30:21,Savings Vault topup,3.00,0.00,EUR,COMPLETED,3.00
Transfer,Deposit,2024-07-29 18:30:21,2024-07-29 18:30:21,Saving vault topup prefunding wallet,-3.00,0.00,EUR,COMPLETED,0.00
Transfer,Deposit,2024-07-29 20:04:05,2024-07-29 20:04:05,Savings Vault topup,0.55,0.00,EUR,COMPLETED,0.55
Transfer,Deposit,2024-07-29 20:04:05,2024-07-29 20:04:05,Saving vault topup prefunding wallet,-0.55,0.00,EUR,COMPLETED,0.00
Transfer,Deposit,2024-07-30 08:58:41,2024-07-30 08:58:42,Savings Vault topup,1.50,0.00,EUR,COMPLETED,1.50
Transfer,Deposit,2024-07-30 08:58:42,2024-07-30 08:58:42,Saving vault topup prefunding wallet,-1.50,0.00,EUR,COMPLETED,0.00
Transfer,Deposit,2024-07-31 09:08:36,2024-07-31 09:08:36,Savings Vault topup,1.50,0.00,EUR,COMPLETED,1.50
Transfer,Deposit,2024-07-31 09:08:36,2024-07-31 09:08:36,Saving vault topup prefunding wallet,-1.50,0.00,EUR,COMPLETED,0.00
Transfer,Deposit,2024-07-31 13:17:51,2024-07-31 13:17:51,Savings Vault topup,1.50,0.00,EUR,COMPLETED,1.50
Transfer,Deposit,2024-07-31 13:17:51,2024-07-31 13:17:51,Saving vault topup prefunding wallet,-1.50,0.00,EUR,COMPLETED,0.00
Transfer,Deposit,2024-07-31 18:41:00,2024-07-31 18:41:00,Savings Vault topup,0.05,0.00,EUR,COMPLETED,0.05
Transfer,Deposit,2024-07-31 18:41:00,2024-07-31 18:41:00,Saving vault topup prefunding wallet,-0.05,0.00,EUR,COMPLETED,0.00
Transfer,Deposit,2024-08-01 08:26:41,2024-08-01 08:26:41,Savings Vault topup,2.55,0.00,EUR,COMPLETED,2.55
Transfer,Deposit,2024-08-01 08:26:41,2024-08-01 08:26:41,Saving vault topup prefunding wallet,-2.55,0.00,EUR,COMPLETED,0.00
Transfer,Deposit,2024-08-01 10:14:46,2024-08-01 10:14:46,Savings vault withdrawal from prefunding wallet,1000.00,0.00,EUR,COMPLETED,1000.00
Transfer,Deposit,2024-08-01 10:14:46,2024-08-01 10:14:46,From Flexible Cash Funds,-1000.00,0.00,EUR,COMPLETED,0.00
Transfer,Deposit,2024-08-01 10:32:38,2024-08-01 10:32:38,Savings Vault topup,0.35,0.00,EUR,COMPLETED,0.35
Transfer,Deposit,2024-08-01 10:32:38,2024-08-01 10:32:38,Saving vault topup prefunding wallet,-0.35,0.00,EUR,COMPLETED,0.00
Transfer,Deposit,2024-08-01 23:01:55,2024-08-01 23:01:55,Savings Vault topup,0.50,0.00,EUR,COMPLETED,0.50
Transfer,Deposit,2024-08-01 23:01:55,2024-08-01 23:01:55,Saving vault topup prefunding wallet,-0.50,0.00,EUR,COMPLETED,0.00
Transfer,Deposit,2024-08-02 08:43:25,2024-08-02 08:43:25,Savings Vault topup,4.85,0.00,EUR,COMPLETED,4.85
Transfer,Deposit,2024-08-02 08:43:25,2024-08-02 08:43:25,Saving vault topup prefunding wallet,-4.85,0.00,EUR,COMPLETED,0.00
Transfer,Deposit,2024-08-02 08:49:56,2024-08-02 08:49:56,Savings Vault topup,2.50,0.00,EUR,COMPLETED,2.50
Transfer,Deposit,2024-08-02 08:49:56,2024-08-02 08:49:56,Saving vault topup prefunding wallet,-2.50,0.00,EUR,COMPLETED,0.00
Transfer,Deposit,2024-08-02 12:16:14,2024-08-02 12:16:14,Savings Vault topup,1.95,0.00,EUR,COMPLETED,1.95
Transfer,Deposit,2024-08-02 12:16:14,2024-08-02 12:16:14,Saving vault topup prefunding wallet,-1.95,0.00,EUR,COMPLETED,0.00
Transfer,Deposit,2024-08-02 13:27:39,2024-08-02 13:27:39,Savings Vault topup,5.00,0.00,EUR,COMPLETED,5.00
Transfer,Deposit,2024-08-02 13:27:39,2024-08-02 13:27:39,Saving vault topup prefunding wallet,-5.00,0.00,EUR,COMPLETED,0.00
Transfer,Deposit,2024-08-02 14:11:18,2024-08-02 14:11:18,Savings Vault topup,3.60,0.00,EUR,COMPLETED,3.60
Transfer,Deposit,2024-08-02 14:11:18,2024-08-02 14:11:18,Saving vault topup prefunding wallet,-3.60,0.00,EUR,COMPLETED,0.00
Transfer,Deposit,2024-08-03 09:37:06,2024-08-03 09:37:06,Savings Vault topup,4.00,0.00,EUR,COMPLETED,4.00
Transfer,Deposit,2024-08-03 09:37:06,2024-08-03 09:37:06,Saving vault topup prefunding wallet,-4.00,0.00,EUR,COMPLETED,0.00
Transfer,Deposit,2024-08-03 11:42:57,2024-08-03 11:42:57,Savings Vault topup,2.50,0.00,EUR,COMPLETED,2.50
Transfer,Deposit,2024-08-03 11:42:57,2024-08-03 11:42:57,Saving vault topup prefunding wallet,-2.50,0.00,EUR,COMPLETED,0.00
Transfer,Deposit,2024-08-03 14:04:01,2024-08-03 14:04:01,Savings Vault topup,5.00,0.00,EUR,COMPLETED,5.00
Transfer,Deposit,2024-08-03 14:04:01,2024-08-03 14:04:01,Saving vault topup prefunding wallet,-5.00,0.00,EUR,COMPLETED,0.00
Transfer,Deposit,2024-08-03 15:22:47,2024-08-03 15:22:47,Savings Vault topup,0.50,0.00,EUR,COMPLETED,0.50
Transfer,Deposit,2024-08-03 15:22:47,2024-08-03 15:22:47,Saving vault topup prefunding wallet,-0.50,0.00,EUR,COMPLETED,0.00
Transfer,Deposit,2024-08-03 20:58:36,2024-08-03 20:58:36,Savings Vault topup,0.65,0.00,EUR,COMPLETED,0.65
Transfer,Deposit,2024-08-03 20:58:36,2024-08-03 20:58:36,Saving vault topup prefunding wallet,-0.65,0.00,EUR,COMPLETED,0.00
Transfer,Deposit,2024-08-03 21:57:21,2024-08-03 21:57:21,Savings Vault topup,2.50,0.00,EUR,COMPLETED,2.50
Transfer,Deposit,2024-08-03 21:57:21,2024-08-03 21:57:21,Saving vault topup prefunding wallet,-2.50,0.00,EUR,COMPLETED,0.00
Transfer,Deposit,2024-08-03 22:01:43,2024-08-03 22:01:43,Savings Vault topup,2.50,0.00,EUR,COMPLETED,2.50
Transfer,Deposit,2024-08-03 22:01:43,2024-08-03 22:01:43,Saving vault topup prefunding wallet,-2.50,0.00,EUR,COMPLETED,0.00
Transfer,Deposit,2024-08-03 23:59:22,2024-08-03 23:59:22,Savings Vault topup,2.00,0.00,EUR,COMPLETED,2.00
Transfer,Deposit,2024-08-03 23:59:22,2024-08-03 23:59:22,Saving vault topup prefunding wallet,-2.00,0.00,EUR,COMPLETED,0.00
Transfer,Deposit,2024-08-04 02:14:01,2024-08-04 02:14:01,Savings vault withdrawal from prefunding wallet,100.00,0.00,EUR,COMPLETED,100.00
Transfer,Deposit,2024-08-04 02:14:01,2024-08-04 02:14:01,From Flexible Cash Funds,-100.00,0.00,EUR,COMPLETED,0.00
Transfer,Deposit,2024-08-04 02:17:06,2024-08-04 02:17:06,Savings Vault topup,5.00,0.00,EUR,COMPLETED,5.00
Transfer,Deposit,2024-08-04 02:17:06,2024-08-04 02:17:06,Saving vault topup prefunding wallet,-5.00,0.00,EUR,COMPLETED,0.00
Transfer,Deposit,2024-08-04 02:51:54,2024-08-04 02:51:54,Savings Vault topup,0.05,0.00,EUR,COMPLETED,0.05
Transfer,Deposit,2024-08-04 02:51:54,2024-08-04 02:51:54,Saving vault topup prefunding wallet,-0.05,0.00,EUR,COMPLETED,0.00
Transfer,Deposit,2024-08-04 09:36:34,2024-08-04 09:36:34,Savings Vault topup,0.50,0.00,EUR,COMPLETED,0.50
Transfer,Deposit,2024-08-04 09:36:34,2024-08-04 09:36:34,Saving vault topup prefunding wallet,-0.50,0.00,EUR,COMPLETED,0.00
Transfer,Deposit,2024-08-04 11:53:52,2024-08-04 11:53:52,Savings Vault topup,2.50,0.00,EUR,COMPLETED,2.50
Transfer,Deposit,2024-08-04 11:53:52,2024-08-04 11:53:52,Saving vault topup prefunding wallet,-2.50,0.00,EUR,COMPLETED,0.00
Transfer,Deposit,2024-08-04 12:16:18,2024-08-04 12:16:18,Savings Vault topup,5.00,0.00,EUR,COMPLETED,5.00
Transfer,Deposit,2024-08-04 12:16:18,2024-08-04 12:16:18,Saving vault topup prefunding wallet,-5.00,0.00,EUR,COMPLETED,0.00
Transfer,Deposit,2024-08-04 13:58:39,2024-08-04 13:58:39,Savings vault withdrawal from prefunding wallet,100.00,0.00,EUR,COMPLETED,100.00
Transfer,Deposit,2024-08-04 13:58:39,2024-08-04 13:58:39,From Flexible Cash Funds,-100.00,0.00,EUR,COMPLETED,0.00
Transfer,Deposit,2024-08-04 13:58:43,2024-08-04 13:58:43,Savings Vault topup,5.00,0.00,EUR,COMPLETED,5.00
Transfer,Deposit,2024-08-04 13:58:43,2024-08-04 13:58:43,Saving vault topup prefunding wallet,-5.00,0.00,EUR,COMPLETED,0.00
Transfer,Deposit,2024-08-04 14:14:32,2024-08-04 14:14:32,Savings Vault topup,0.25,0.00,EUR,COMPLETED,0.25
Transfer,Deposit,2024-08-04 14:14:32,2024-08-04 14:14:32,Saving vault topup prefunding wallet,-0.25,0.00,EUR,COMPLETED,0.00
Transfer,Deposit,2024-08-04 14:27:48,2024-08-04 14:27:48,Savings Vault topup,3.75,0.00,EUR,COMPLETED,3.75
Transfer,Deposit,2024-08-04 14:27:48,2024-08-04 14:27:48,Saving vault topup prefunding wallet,-3.75,0.00,EUR,COMPLETED,0.00
Transfer,Deposit,2024-08-05 10:58:25,2024-08-05 10:58:26,Savings Vault topup,3.75,0.00,EUR,COMPLETED,3.75
Transfer,Deposit,2024-08-05 10:58:26,2024-08-05 10:58:26,Saving vault topup prefunding wallet,-3.75,0.00,EUR,COMPLETED,0.00
Transfer,Deposit,2024-08-05 14:21:28,2024-08-05 14:21:28,Savings Vault topup,5.00,0.00,EUR,COMPLETED,5.00
Transfer,Deposit,2024-08-05 14:21:28,2024-08-05 14:21:28,Saving vault topup prefunding wallet,-5.00,0.00,EUR,COMPLETED,0.00
Transfer,Deposit,2024-08-07 15:15:26,2024-08-07 15:15:26,Savings vault withdrawal from prefunding wallet,100.00,0.00,EUR,COMPLETED,100.00
Transfer,Deposit,2024-08-07 15:15:26,2024-08-07 15:15:27,From Flexible Cash Funds,-100.00,0.00,EUR,COMPLETED,0.00
Transfer,Deposit,2024-08-07 20:41:05,2024-08-07 20:41:05,Savings Vault topup,0.55,0.00,EUR,COMPLETED,0.55
Transfer,Deposit,2024-08-07 20:41:05,2024-08-07 20:41:05,Saving vault topup prefunding wallet,-0.55,0.00,EUR,COMPLETED,0.00
Transfer,Deposit,2024-08-08 13:55:49,2024-08-08 13:55:49,Savings Vault topup,2.50,0.00,EUR,COMPLETED,2.50
Transfer,Deposit,2024-08-08 13:55:49,2024-08-08 13:55:49,Saving vault topup prefunding wallet,-2.50,0.00,EUR,COMPLETED,0.00
Transfer,Deposit,2024-08-08 17:08:41,2024-08-08 17:08:41,Savings Vault topup,5.00,0.00,EUR,COMPLETED,5.00
Transfer,Deposit,2024-08-08 17:08:41,2024-08-08 17:08:41,Saving vault topup prefunding wallet,-5.00,0.00,EUR,COMPLETED,0.00
Transfer,Deposit,2024-08-08 17:09:56,2024-08-08 17:09:56,Savings Vault topup,3.80,0.00,EUR,COMPLETED,3.80
Transfer,Deposit,2024-08-08 17:09:56,2024-08-08 17:09:56,Saving vault topup prefunding wallet,-3.80,0.00,EUR,COMPLETED,0.00
Transfer,Deposit,2024-08-08 19:24:08,2024-08-08 19:24:08,Savings vault withdrawal from prefunding wallet,100.00,0.00,EUR,COMPLETED,100.00
Transfer,Deposit,2024-08-08 19:24:08,2024-08-08 19:24:08,From Flexible Cash Funds,-100.00,0.00,EUR,COMPLETED,0.00
Transfer,Deposit,2024-08-08 19:24:42,2024-08-08 19:24:42,Savings Vault topup,5.00,0.00,EUR,COMPLETED,5.00
Transfer,Deposit,2024-08-08 19:24:42,2024-08-08 19:24:42,Saving vault topup prefunding wallet,-5.00,0.00,EUR,COMPLETED,0.00
Transfer,Deposit,2024-08-08 20:05:16,2024-08-08 20:05:16,Savings Vault topup,2.00,0.00,EUR,COMPLETED,2.00
Transfer,Deposit,2024-08-08 20:05:16,2024-08-08 20:05:16,Saving vault topup prefunding wallet,-2.00,0.00,EUR,COMPLETED,0.00
Transfer,Deposit,2024-08-09 08:47:12,2024-08-09 08:47:12,Savings Vault topup,4.50,0.00,EUR,COMPLETED,4.50
Transfer,Deposit,2024-08-09 08:47:12,2024-08-09 08:47:12,Saving vault topup prefunding wallet,-4.50,0.00,EUR,COMPLETED,0.00
Transfer,Deposit,2024-08-09 09:37:17,2024-08-09 09:37:17,Savings Vault topup,2.50,0.00,EUR,COMPLETED,2.50
Transfer,Deposit,2024-08-09 09:37:17,2024-08-09 09:37:17,Saving vault topup prefunding wallet,-2.50,0.00,EUR,COMPLETED,0.00
Transfer,Deposit,2024-08-09 09:48:39,2024-08-09 09:48:39,Savings Vault topup,4.15,0.00,EUR,COMPLETED,4.15
Transfer,Deposit,2024-08-09 09:48:39,2024-08-09 09:48:39,Saving vault topup prefunding wallet,-4.15,0.00,EUR,COMPLETED,0.00
Transfer,Deposit,2024-08-09 23:19:48,2024-08-09 23:19:48,Savings Vault topup,2.50,0.00,EUR,COMPLETED,2.50
Transfer,Deposit,2024-08-09 23:19:48,2024-08-09 23:19:48,Saving vault topup prefunding wallet,-2.50,0.00,EUR,COMPLETED,0.00
Transfer,Deposit,2024-08-10 17:11:27,2024-08-10 17:11:27,Savings vault withdrawal from prefunding wallet,100.00,0.00,EUR,COMPLETED,100.00
Transfer,Deposit,2024-08-10 17:11:27,2024-08-10 17:11:27,From Flexible Cash Funds,-100.00,0.00,EUR,COMPLETED,0.00
Transfer,Deposit,2024-08-10 17:11:32,2024-08-10 17:11:32,Savings Vault topup,2.10,0.00,EUR,COMPLETED,2.10
Transfer,Deposit,2024-08-10 17:11:32,2024-08-10 17:11:32,Saving vault topup prefunding wallet,-2.10,0.00,EUR,COMPLETED,0.00
Transfer,Deposit,2024-08-11 08:43:41,2024-08-11 08:43:41,Savings Vault topup,0.05,0.00,EUR,COMPLETED,0.05
Transfer,Deposit,2024-08-11 08:43:41,2024-08-11 08:43:41,Saving vault topup prefunding wallet,-0.05,0.00,EUR,COMPLETED,0.00
Transfer,Deposit,2024-08-12 12:39:02,2024-08-12 12:39:02,Savings Vault topup,5.00,0.00,EUR,COMPLETED,5.00
Transfer,Deposit,2024-08-12 12:39:02,2024-08-12 12:39:02,Saving vault topup prefunding wallet,-5.00,0.00,EUR,COMPLETED,0.00
Transfer,Deposit,2024-08-12 13:10:42,2024-08-12 13:10:42,Savings Vault topup,5.00,0.00,EUR,COMPLETED,5.00
Transfer,Deposit,2024-08-12 13:10:42,2024-08-12 13:10:42,Saving vault topup prefunding wallet,-5.00,0.00,EUR,COMPLETED,0.00
Transfer,Deposit,2024-08-12 18:17:08,2024-08-12 18:17:08,Savings Vault topup,0.85,0.00,EUR,COMPLETED,0.85
Transfer,Deposit,2024-08-12 18:17:08,2024-08-12 18:17:08,Saving vault topup prefunding wallet,-0.85,0.00,EUR,COMPLETED,0.00
Transfer,Deposit,2024-08-13 12:45:05,2024-08-13 12:45:05,Savings Vault topup,5.00,0.00,EUR,COMPLETED,5.00
Transfer,Deposit,2024-08-13 12:45:05,2024-08-13 12:45:05,Saving vault topup prefunding wallet,-5.00,0.00,EUR,COMPLETED,0.00
Transfer,Deposit,2024-08-13 13:08:25,2024-08-13 13:08:25,Savings Vault topup,2.75,0.00,EUR,COMPLETED,2.75
Transfer,Deposit,2024-08-13 13:08:25,2024-08-13 13:08:25,Saving vault topup prefunding wallet,-2.75,0.00,EUR,COMPLETED,0.00
Transfer,Deposit,2024-08-13 17:16:43,2024-08-13 17:16:43,Savings Vault topup,5.00,0.00,EUR,COMPLETED,5.00
Transfer,Deposit,2024-08-13 17:16:43,2024-08-13 17:16:43,Saving vault topup prefunding wallet,-5.00,0.00,EUR,COMPLETED,0.00
Transfer,Deposit,2024-08-13 17:22:44,2024-08-13 17:22:44,Savings Vault topup,5.00,0.00,EUR,COMPLETED,5.00
Transfer,Deposit,2024-08-13 17:22:44,2024-08-13 17:22:44,Saving vault topup prefunding wallet,-5.00,0.00,EUR,COMPLETED,0.00
Transfer,Deposit,2024-08-13 20:16:40,2024-08-13 20:16:40,Savings Vault topup,0.10,0.00,EUR,COMPLETED,0.10
Transfer,Deposit,2024-08-13 20:16:40,2024-08-13 20:16:40,Saving vault topup prefunding wallet,-0.10,0.00,EUR,COMPLETED,0.00
Transfer,Deposit,2024-08-14 09:05:02,2024-08-14 09:05:02,Savings Vault topup,1.50,0.00,EUR,COMPLETED,1.50
Transfer,Deposit,2024-08-14 09:05:02,2024-08-14 09:05:02,Saving vault topup prefunding wallet,-1.50,0.00,EUR,COMPLETED,0.00
Transfer,Deposit,2024-08-14 13:14:50,2024-08-14 13:14:51,Savings Vault topup,2.50,0.00,EUR,COMPLETED,2.50
Transfer,Deposit,2024-08-14 13:14:51,2024-08-14 13:14:51,Saving vault topup prefunding wallet,-2.50,0.00,EUR,COMPLETED,0.00
Transfer,Deposit,2024-08-14 21:50:36,2024-08-14 21:50:36,Savings Vault topup,3.75,0.00,EUR,COMPLETED,3.75
Transfer,Deposit,2024-08-14 21:50:36,2024-08-14 21:50:36,Saving vault topup prefunding wallet,-3.75,0.00,EUR,COMPLETED,0.00
Transfer,Deposit,2024-08-14 23:01:00,2024-08-14 23:01:00,Savings Vault topup,2.60,0.00,EUR,COMPLETED,2.60
Transfer,Deposit,2024-08-14 23:01:01,2024-08-14 23:01:01,Saving vault topup prefunding wallet,-2.60,0.00,EUR,COMPLETED,0.00
Transfer,Deposit,2024-08-15 08:46:19,2024-08-15 08:46:19,Savings Vault topup,2.50,0.00,EUR,COMPLETED,2.50
Transfer,Deposit,2024-08-15 08:46:19,2024-08-15 08:46:19,Saving vault topup prefunding wallet,-2.50,0.00,EUR,COMPLETED,0.00
Transfer,Deposit,2024-08-15 09:16:05,2024-08-15 09:16:05,Savings Vault topup,2.20,0.00,EUR,COMPLETED,2.20
Transfer,Deposit,2024-08-15 09:16:05,2024-08-15 09:16:05,Saving vault topup prefunding wallet,-2.20,0.00,EUR,COMPLETED,0.00
Transfer,Deposit,2024-08-15 15:10:40,2024-08-15 15:10:40,Savings vault withdrawal from prefunding wallet,100.00,0.00,EUR,COMPLETED,100.00
Transfer,Deposit,2024-08-15 15:10:40,2024-08-15 15:10:40,From Flexible Cash Funds,-100.00,0.00,EUR,COMPLETED,0.00
Transfer,Deposit,2024-08-15 15:10:48,2024-08-15 15:10:48,Savings Vault topup,5.00,0.00,EUR,COMPLETED,5.00
Transfer,Deposit,2024-08-15 15:10:48,2024-08-15 15:10:48,Saving vault topup prefunding wallet,-5.00,0.00,EUR,COMPLETED,0.00
Transfer,Deposit,2024-08-15 15:14:58,2024-08-15 15:14:58,Savings Vault topup,4.00,0.00,EUR,COMPLETED,4.00
Transfer,Deposit,2024-08-15 15:14:58,2024-08-15 15:14:58,Saving vault topup prefunding wallet,-4.00,0.00,EUR,COMPLETED,0.00
Transfer,Deposit,2024-08-16 08:04:09,2024-08-16 08:04:09,Savings Vault topup,0.05,0.00,EUR,COMPLETED,0.05
Transfer,Deposit,2024-08-16 08:04:09,2024-08-16 08:04:09,Saving vault topup prefunding wallet,-0.05,0.00,EUR,COMPLETED,0.00
Transfer,Deposit,2024-08-16 16:03:52,2024-08-16 16:03:52,Savings Vault topup,5.00,0.00,EUR,COMPLETED,5.00
Transfer,Deposit,2024-08-16 16:03:52,2024-08-16 16:03:52,Saving vault topup prefunding wallet,-5.00,0.00,EUR,COMPLETED,0.00
Transfer,Deposit,2024-08-16 18:35:10,2024-08-16 18:35:10,Savings Vault topup,0.55,0.00,EUR,COMPLETED,0.55
Transfer,Deposit,2024-08-16 18:35:10,2024-08-16 18:35:10,Saving vault topup prefunding wallet,-0.55,0.00,EUR,COMPLETED,0.00
Transfer,Deposit,2024-08-17 16:19:21,2024-08-17 16:19:21,Savings Vault topup,2.00,0.00,EUR,COMPLETED,2.00
Transfer,Deposit,2024-08-17 16:19:21,2024-08-17 16:19:21,Saving vault topup prefunding wallet,-2.00,0.00,EUR,COMPLETED,0.00
Transfer,Deposit,2024-08-18 15:52:19,2024-08-18 15:52:19,Savings Vault topup,4.55,0.00,EUR,COMPLETED,4.55
Transfer,Deposit,2024-08-18 15:52:19,2024-08-18 15:52:19,Saving vault topup prefunding wallet,-4.55,0.00,EUR,COMPLETED,0.00
Transfer,Deposit,2024-08-20 08:53:57,2024-08-20 08:53:57,Savings Vault topup,1.50,0.00,EUR,COMPLETED,1.50
Transfer,Deposit,2024-08-20 08:53:57,2024-08-20 08:53:57,Saving vault topup prefunding wallet,-1.50,0.00,EUR,COMPLETED,0.00
Transfer,Deposit,2024-08-21 09:11:20,2024-08-21 09:11:20,Savings Vault topup,1.50,0.00,EUR,COMPLETED,1.50
Transfer,Deposit,2024-08-21 09:11:20,2024-08-21 09:11:20,Saving vault topup prefunding wallet,-1.50,0.00,EUR,COMPLETED,0.00
Transfer,Deposit,2024-08-21 21:21:27,2024-08-21 21:21:27,Savings vault withdrawal from prefunding wallet,1200.00,0.00,EUR,COMPLETED,1200.00
Transfer,Deposit,2024-08-21 21:21:27,2024-08-21 21:21:27,From Flexible Cash Funds,-1200.00,0.00,EUR,COMPLETED,0.00
Transfer,Deposit,2024-08-21 21:21:50,2024-08-21 21:21:50,Savings Vault topup,5.00,0.00,EUR,COMPLETED,5.00
Transfer,Deposit,2024-08-21 21:21:50,2024-08-21 21:21:50,Saving vault topup prefunding wallet,-5.00,0.00,EUR,COMPLETED,0.00
Transfer,Deposit,2024-08-22 08:26:13,2024-08-22 08:26:13,Savings Vault topup,0.05,0.00,EUR,COMPLETED,0.05
Transfer,Deposit,2024-08-22 08:26:13,2024-08-22 08:26:13,Saving vault topup prefunding wallet,-0.05,0.00,EUR,COMPLETED,0.00
Transfer,Deposit,2024-08-22 08:32:13,2024-08-22 08:32:13,Savings Vault topup,2.50,0.00,EUR,COMPLETED,2.50
Transfer,Deposit,2024-08-22 08:32:13,2024-08-22 08:32:13,Saving vault topup prefunding wallet,-2.50,0.00,EUR,COMPLETED,0.00
Transfer,Deposit,2024-08-22 17:10:01,2024-08-22 17:10:01,Savings Vault topup,3.40,0.00,EUR,COMPLETED,3.40
Transfer,Deposit,2024-08-22 17:10:01,2024-08-22 17:10:01,Saving vault topup prefunding wallet,-3.40,0.00,EUR,COMPLETED,0.00
Transfer,Deposit,2024-08-22 18:23:59,2024-08-22 18:23:59,Savings vault withdrawal from prefunding wallet,50.00,0.00,EUR,COMPLETED,50.00
Transfer,Deposit,2024-08-22 18:23:59,2024-08-22 18:23:59,From Flexible Cash Funds,-50.00,0.00,EUR,COMPLETED,0.00
Transfer,Deposit,2024-08-22 18:24:18,2024-08-22 18:24:18,Savings Vault topup,3.25,0.00,EUR,COMPLETED,3.25
Transfer,Deposit,2024-08-22 18:24:18,2024-08-22 18:24:18,Saving vault topup prefunding wallet,-3.25,0.00,EUR,COMPLETED,0.00
Transfer,Deposit,2024-08-22 18:26:53,2024-08-22 18:26:54,Savings Vault topup,0.25,0.00,EUR,COMPLETED,0.25
Transfer,Deposit,2024-08-22 18:26:54,2024-08-22 18:26:54,Saving vault topup prefunding wallet,-0.25,0.00,EUR,COMPLETED,0.00
Transfer,Deposit,2024-08-22 18:35:40,2024-08-22 18:35:40,Savings vault withdrawal from prefunding wallet,120.00,0.00,EUR,COMPLETED,120.00
Transfer,Deposit,2024-08-22 18:35:40,2024-08-22 18:35:40,From Flexible Cash Funds,-120.00,0.00,EUR,COMPLETED,0.00
Transfer,Deposit,2024-08-22 18:39:03,2024-08-22 18:39:03,Savings vault withdrawal from prefunding wallet,10.00,0.00,EUR,COMPLETED,10.00
Transfer,Deposit,2024-08-22 18:39:03,2024-08-22 18:39:03,From Flexible Cash Funds,-10.00,0.00,EUR,COMPLETED,0.00
Transfer,Deposit,2024-08-22 18:40:00,2024-08-22 18:40:00,Savings Vault topup,5.00,0.00,EUR,COMPLETED,5.00
Transfer,Deposit,2024-08-22 18:40:00,2024-08-22 18:40:00,Saving vault topup prefunding wallet,-5.00,0.00,EUR,COMPLETED,0.00
Transfer,Deposit,2024-08-22 18:46:39,2024-08-22 18:46:39,Savings vault withdrawal from prefunding wallet,10.00,0.00,EUR,COMPLETED,10.00
Transfer,Deposit,2024-08-22 18:46:39,2024-08-22 18:46:39,From Flexible Cash Funds,-10.00,0.00,EUR,COMPLETED,0.00
Transfer,Deposit,2024-08-22 18:47:07,2024-08-22 18:47:07,Savings Vault topup,1.50,0.00,EUR,COMPLETED,1.50
Transfer,Deposit,2024-08-22 18:47:07,2024-08-22 18:47:07,Saving vault topup prefunding wallet,-1.50,0.00,EUR,COMPLETED,0.00
Transfer,Deposit,2024-08-23 08:32:30,2024-08-23 08:32:30,Savings Vault topup,2.50,0.00,EUR,COMPLETED,2.50
Transfer,Deposit,2024-08-23 08:32:30,2024-08-23 08:32:30,Saving vault topup prefunding wallet,-2.50,0.00,EUR,COMPLETED,0.00
Transfer,Deposit,2024-08-23 15:50:30,2024-08-23 15:50:30,Savings Vault topup,0.05,0.00,EUR,COMPLETED,0.05
Transfer,Deposit,2024-08-23 15:50:30,2024-08-23 15:50:30,Saving vault topup prefunding wallet,-0.05,0.00,EUR,COMPLETED,0.00
Transfer,Deposit,2024-08-24 13:19:59,2024-08-24 13:19:59,Savings Vault topup,0.05,0.00,EUR,COMPLETED,0.05
Transfer,Deposit,2024-08-24 13:19:59,2024-08-24 13:19:59,Saving vault topup prefunding wallet,-0.05,0.00,EUR,COMPLETED,0.00
Transfer,Deposit,2024-08-24 13:23:00,2024-08-24 13:23:00,Savings Vault topup,2.50,0.00,EUR,COMPLETED,2.50
Transfer,Deposit,2024-08-24 13:23:00,2024-08-24 13:23:00,Saving vault topup prefunding wallet,-2.50,0.00,EUR,COMPLETED,0.00
Transfer,Deposit,2024-08-24 17:59:26,2024-08-24 17:59:26,Savings Vault topup,2.50,0.00,EUR,COMPLETED,2.50
Transfer,Deposit,2024-08-24 17:59:26,2024-08-24 17:59:26,Saving vault topup prefunding wallet,-2.50,0.00,EUR,COMPLETED,0.00
Transfer,Deposit,2024-08-24 19:32:49,2024-08-24 19:32:50,Savings Vault topup,5.00,0.00,EUR,COMPLETED,5.00
Transfer,Deposit,2024-08-24 19:32:50,2024-08-24 19:32:50,Saving vault topup prefunding wallet,-5.00,0.00,EUR,COMPLETED,0.00
Transfer,Deposit,2024-08-25 18:41:43,2024-08-25 18:41:43,Savings Vault topup,1.20,0.00,EUR,COMPLETED,1.20
Transfer,Deposit,2024-08-25 18:41:43,2024-08-25 18:41:43,Saving vault topup prefunding wallet,-1.20,0.00,EUR,COMPLETED,0.00
Transfer,Deposit,2024-08-26 15:53:35,2024-08-26 15:53:35,Savings Vault topup,14201.00,0.00,EUR,COMPLETED,14201.00
Transfer,Deposit,2024-08-26 15:53:35,2024-08-26 15:53:35,Saving vault topup prefunding wallet,-14201.00,0.00,EUR,COMPLETED,0.00
Transfer,Deposit,2024-08-26 16:32:49,2024-08-26 16:32:49,Savings vault withdrawal from prefunding wallet,689.99,0.00,EUR,COMPLETED,689.99
Transfer,Deposit,2024-08-26 16:32:49,2024-08-26 16:32:49,From Flexible Cash Funds,-689.99,0.00,EUR,COMPLETED,0.00
Transfer,Deposit,2024-08-26 16:33:02,2024-08-26 16:33:02,Savings Vault topup,0.05,0.00,EUR,COMPLETED,0.05
Transfer,Deposit,2024-08-26 16:33:02,2024-08-26 16:33:02,Saving vault topup prefunding wallet,-0.05,0.00,EUR,COMPLETED,0.00
Transfer,Deposit,2024-08-27 09:01:20,2024-08-27 09:01:20,Savings Vault topup,1.50,0.00,EUR,COMPLETED,1.50
Transfer,Deposit,2024-08-27 09:01:20,2024-08-27 09:01:20,Saving vault topup prefunding wallet,-1.50,0.00,EUR,COMPLETED,0.00
Transfer,Deposit,2024-08-27 13:01:54,2024-08-27 13:01:54,Savings vault withdrawal from prefunding wallet,460.00,0.00,EUR,COMPLETED,460.00
Transfer,Deposit,2024-08-27 13:01:54,2024-08-27 13:01:54,From Flexible Cash Funds,-460.00,0.00,EUR,COMPLETED,0.00
Transfer,Deposit,2024-08-27 13:04:05,2024-08-27 13:04:05,Savings Vault topup,0.35,0.00,EUR,COMPLETED,0.35
Transfer,Deposit,2024-08-27 13:04:05,2024-08-27 13:04:05,Saving vault topup prefunding wallet,-0.35,0.00,EUR,COMPLETED,0.00
Transfer,Deposit,2024-08-27 13:29:24,2024-08-27 13:29:24,Savings Vault topup,5.00,0.00,EUR,COMPLETED,5.00
Transfer,Deposit,2024-08-27 13:29:24,2024-08-27 13:29:24,Saving vault topup prefunding wallet,-5.00,0.00,EUR,COMPLETED,0.00
Transfer,Deposit,2024-08-27 13:40:36,2024-08-27 13:40:36,Savings vault withdrawal from prefunding wallet,100.00,0.00,EUR,COMPLETED,100.00
Transfer,Deposit,2024-08-27 13:40:36,2024-08-27 13:40:36,From Flexible Cash Funds,-100.00,0.00,EUR,COMPLETED,0.00
Transfer,Deposit,2024-08-27 13:40:43,2024-08-27 13:40:43,Savings Vault topup,5.00,0.00,EUR,COMPLETED,5.00
Transfer,Deposit,2024-08-27 13:40:43,2024-08-27 13:40:43,Saving vault topup prefunding wallet,-5.00,0.00,EUR,COMPLETED,0.00
Transfer,Deposit,2024-08-27 18:47:10,2024-08-27 18:47:10,Savings Vault topup,1.25,0.00,EUR,COMPLETED,1.25
Transfer,Deposit,2024-08-27 18:47:10,2024-08-27 18:47:10,Saving vault topup prefunding wallet,-1.25,0.00,EUR,COMPLETED,0.00
Transfer,Deposit,2024-08-27 18:56:28,2024-08-27 18:56:28,Savings Vault topup,2.50,0.00,EUR,COMPLETED,2.50
Transfer,Deposit,2024-08-27 18:56:28,2024-08-27 18:56:28,Saving vault topup prefunding wallet,-2.50,0.00,EUR,COMPLETED,0.00
Transfer,Deposit,2024-08-27 20:52:11,2024-08-27 20:52:12,Savings Vault topup,2.00,0.00,EUR,COMPLETED,2.00
Transfer,Deposit,2024-08-27 20:52:12,2024-08-27 20:52:12,Saving vault topup prefunding wallet,-2.00,0.00,EUR,COMPLETED,0.00
Transfer,Deposit,2024-08-27 20:59:41,2024-08-27 20:59:41,Savings Vault topup,1.00,0.00,EUR,COMPLETED,1.00
Transfer,Deposit,2024-08-27 20:59:41,2024-08-27 20:59:41,Saving vault topup prefunding wallet,-1.00,0.00,EUR,COMPLETED,0.00
Transfer,Deposit,2024-08-28 08:53:41,2024-08-28 08:53:41,Savings Vault topup,2.55,0.00,EUR,COMPLETED,2.55
Transfer,Deposit,2024-08-28 08:53:41,2024-08-28 08:53:41,Saving vault topup prefunding wallet,-2.55,0.00,EUR,COMPLETED,0.00
Transfer,Deposit,2024-08-28 21:14:01,2024-08-28 21:14:01,Savings Vault topup,1.00,0.00,EUR,COMPLETED,1.00
Transfer,Deposit,2024-08-28 21:14:01,2024-08-28 21:14:01,Saving vault topup prefunding wallet,-1.00,0.00,EUR,COMPLETED,0.00
Transfer,Deposit,2024-08-28 21:19:56,2024-08-28 21:19:56,Savings Vault topup,0.05,0.00,EUR,COMPLETED,0.05
Transfer,Deposit,2024-08-28 21:19:56,2024-08-28 21:19:56,Saving vault topup prefunding wallet,-0.05,0.00,EUR,COMPLETED,0.00
Transfer,Deposit,2024-08-29 08:05:32,2024-08-29 08:05:32,Savings Vault topup,1.50,0.00,EUR,COMPLETED,1.50
Transfer,Deposit,2024-08-29 08:05:32,2024-08-29 08:05:32,Saving vault topup prefunding wallet,-1.50,0.00,EUR,COMPLETED,0.00
Transfer,Deposit,2024-08-29 13:00:54,2024-08-29 13:00:54,Savings Vault topup,2.50,0.00,EUR,COMPLETED,2.50
Transfer,Deposit,2024-08-29 13:00:54,2024-08-29 13:00:54,Saving vault topup prefunding wallet,-2.50,0.00,EUR,COMPLETED,0.00
Transfer,Deposit,2024-08-29 18:55:33,2024-08-29 18:55:33,Savings Vault topup,3.95,0.00,EUR,COMPLETED,3.95
Transfer,Deposit,2024-08-29 18:55:33,2024-08-29 18:55:33,Saving vault topup prefunding wallet,-3.95,0.00,EUR,COMPLETED,0.00
Transfer,Deposit,2024-08-30 08:02:23,2024-08-30 08:02:23,Savings Vault topup,2.50,0.00,EUR,COMPLETED,2.50
Transfer,Deposit,2024-08-30 08:02:23,2024-08-30 08:02:23,Saving vault topup prefunding wallet,-2.50,0.00,EUR,COMPLETED,0.00
Transfer,Deposit,2024-08-30 08:02:45,2024-08-30 08:02:45,Savings Vault topup,420.00,0.00,EUR,COMPLETED,420.00
Transfer,Deposit,2024-08-30 08:02:46,2024-08-30 08:02:46,Saving vault topup prefunding wallet,-420.00,0.00,EUR,COMPLETED,0.00
Transfer,Deposit,2024-08-30 08:25:20,2024-08-30 08:25:20,Savings Vault topup,4.70,0.00,EUR,COMPLETED,4.70
Transfer,Deposit,2024-08-30 08:25:20,2024-08-30 08:25:20,Saving vault topup prefunding wallet,-4.70,0.00,EUR,COMPLETED,0.00
Transfer,Deposit,2024-08-30 08:26:36,2024-08-30 08:26:36,Savings Vault topup,5.00,0.00,EUR,COMPLETED,5.00
Transfer,Deposit,2024-08-30 08:26:36,2024-08-30 08:26:36,Saving vault topup prefunding wallet,-5.00,0.00,EUR,COMPLETED,0.00
Transfer,Deposit,2024-08-30 20:06:51,2024-08-30 20:06:52,Savings Vault topup,4.15,0.00,EUR,COMPLETED,4.15
Transfer,Deposit,2024-08-30 20:06:52,2024-08-30 20:06:52,Saving vault topup prefunding wallet,-4.15,0.00,EUR,COMPLETED,0.00
Transfer,Deposit,2024-08-31 09:18:31,2024-08-31 09:18:31,Savings Vault topup,2.00,0.00,EUR,COMPLETED,2.00
Transfer,Deposit,2024-08-31 09:18:31,2024-08-31 09:18:31,Saving vault topup prefunding wallet,-2.00,0.00,EUR,COMPLETED,0.00
Transfer,Deposit,2024-08-31 09:49:04,2024-08-31 09:49:04,Savings Vault topup,2.50,0.00,EUR,COMPLETED,2.50
Transfer,Deposit,2024-08-31 09:49:04,2024-08-31 09:49:04,Saving vault topup prefunding wallet,-2.50,0.00,EUR,COMPLETED,0.00
Transfer,Deposit,2024-08-31 14:43:16,2024-08-31 14:43:17,Savings Vault topup,3.35,0.00,EUR,COMPLETED,3.35
Transfer,Deposit,2024-08-31 14:43:17,2024-08-31 14:43:17,Saving vault topup prefunding wallet,-3.35,0.00,EUR,COMPLETED,0.00
Transfer,Deposit,2024-08-31 15:26:11,2024-08-31 15:26:11,Savings Vault topup,0.20,0.00,EUR,COMPLETED,0.20
Transfer,Deposit,2024-08-31 15:26:11,2024-08-31 15:26:11,Saving vault topup prefunding wallet,-0.20,0.00,EUR,COMPLETED,0.00
Transfer,Deposit,2024-08-31 15:38:50,2024-08-31 15:38:50,Savings Vault topup,1.10,0.00,EUR,COMPLETED,1.10
Transfer,Deposit,2024-08-31 15:38:50,2024-08-31 15:38:50,Saving vault topup prefunding wallet,-1.10,0.00,EUR,COMPLETED,0.00
Transfer,Deposit,2024-08-31 15:57:23,2024-08-31 15:57:23,Savings Vault topup,5.00,0.00,EUR,COMPLETED,5.00
Transfer,Deposit,2024-08-31 15:57:23,2024-08-31 15:57:23,Saving vault topup prefunding wallet,-5.00,0.00,EUR,COMPLETED,0.00
Transfer,Deposit,2024-09-01 12:53:52,2024-09-01 12:53:52,Savings Vault topup,2.75,0.00,EUR,COMPLETED,2.75
Transfer,Deposit,2024-09-01 12:53:52,2024-09-01 12:53:52,Saving vault topup prefunding wallet,-2.75,0.00,EUR,COMPLETED,0.00
Transfer,Deposit,2024-09-02 12:17:07,2024-09-02 12:17:07,Savings Vault topup,1.45,0.00,EUR,COMPLETED,1.45
Transfer,Deposit,2024-09-02 12:17:07,2024-09-02 12:17:07,Saving vault topup prefunding wallet,-1.45,0.00,EUR,COMPLETED,0.00
Transfer,Deposit,2024-09-02 12:50:04,2024-09-02 12:50:04,Savings Vault topup,3.85,0.00,EUR,COMPLETED,3.85
Transfer,Deposit,2024-09-02 12:50:04,2024-09-02 12:50:04,Saving vault topup prefunding wallet,-3.85,0.00,EUR,COMPLETED,0.00
Transfer,Deposit,2024-09-03 07:50:50,2024-09-03 07:50:50,Savings Vault topup,2.00,0.00,EUR,COMPLETED,2.00
Transfer,Deposit,2024-09-03 07:50:50,2024-09-03 07:50:50,Saving vault topup prefunding wallet,-2.00,0.00,EUR,COMPLETED,0.00
Transfer,Deposit,2024-09-03 11:39:20,2024-09-03 11:39:20,Savings Vault topup,0.80,0.00,EUR,COMPLETED,0.80
Transfer,Deposit,2024-09-03 11:39:20,2024-09-03 11:39:20,Saving vault topup prefunding wallet,-0.80,0.00,EUR,COMPLETED,0.00
Transfer,Deposit,2024-09-03 17:27:20,2024-09-03 17:27:20,Savings Vault topup,5.00,0.00,EUR,COMPLETED,5.00
Transfer,Deposit,2024-09-03 17:27:20,2024-09-03 17:27:20,Saving vault topup prefunding wallet,-5.00,0.00,EUR,COMPLETED,0.00
Transfer,Deposit,2024-09-04 02:51:48,2024-09-04 02:51:48,Savings Vault topup,0.05,0.00,EUR,COMPLETED,0.05
Transfer,Deposit,2024-09-04 02:51:48,2024-09-04 02:51:48,Saving vault topup prefunding wallet,-0.05,0.00,EUR,COMPLETED,0.00
Transfer,Deposit,2024-09-04 09:36:22,2024-09-04 09:36:22,Savings Vault topup,0.90,0.00,EUR,COMPLETED,0.90
Transfer,Deposit,2024-09-04 09:36:22,2024-09-04 09:36:22,Saving vault topup prefunding wallet,-0.90,0.00,EUR,COMPLETED,0.00
Transfer,Deposit,2024-09-04 11:11:13,2024-09-04 11:11:13,Savings vault withdrawal from prefunding wallet,1000.00,0.00,EUR,COMPLETED,1000.00
Transfer,Deposit,2024-09-04 11:11:13,2024-09-04 11:11:14,From Flexible Cash Funds,-1000.00,0.00,EUR,COMPLETED,0.00
Transfer,Deposit,2024-09-04 11:13:19,2024-09-04 11:13:19,Savings Vault topup,1.55,0.00,EUR,COMPLETED,1.55
Transfer,Deposit,2024-09-04 11:13:19,2024-09-04 11:13:19,Saving vault topup prefunding wallet,-1.55,0.00,EUR,COMPLETED,0.00
Transfer,Deposit,2024-09-04 18:11:35,2024-09-04 18:11:35,Savings Vault topup,2.00,0.00,EUR,COMPLETED,2.00
Transfer,Deposit,2024-09-04 18:11:35,2024-09-04 18:11:35,Saving vault topup prefunding wallet,-2.00,0.00,EUR,COMPLETED,0.00
Transfer,Deposit,2024-09-04 18:35:27,2024-09-04 18:35:27,Savings Vault topup,5.00,0.00,EUR,COMPLETED,5.00
Transfer,Deposit,2024-09-04 18:35:27,2024-09-04 18:35:27,Saving vault topup prefunding wallet,-5.00,0.00,EUR,COMPLETED,0.00
Transfer,Deposit,2024-09-04 19:05:10,2024-09-04 19:05:10,Savings Vault topup,2.00,0.00,EUR,COMPLETED,2.00
Transfer,Deposit,2024-09-04 19:05:10,2024-09-04 19:05:10,Saving vault topup prefunding wallet,-2.00,0.00,EUR,COMPLETED,0.00
Transfer,Deposit,2024-09-05 18:17:44,2024-09-05 18:17:44,Savings Vault topup,1.00,0.00,EUR,COMPLETED,1.00
Transfer,Deposit,2024-09-05 18:17:44,2024-09-05 18:17:44,Saving vault topup prefunding wallet,-1.00,0.00,EUR,COMPLETED,0.00
Transfer,Deposit,2024-09-05 20:36:58,2024-09-05 20:36:59,Savings Vault topup,4.65,0.00,EUR,COMPLETED,4.65
Transfer,Deposit,2024-09-05 20:36:59,2024-09-05 20:36:59,Saving vault topup prefunding wallet,-4.65,0.00,EUR,COMPLETED,0.00
Transfer,Deposit,2024-09-06 17:16:31,2024-09-06 17:16:31,Savings Vault topup,0.45,0.00,EUR,COMPLETED,0.45
Transfer,Deposit,2024-09-06 17:16:31,2024-09-06 17:16:31,Saving vault topup prefunding wallet,-0.45,0.00,EUR,COMPLETED,0.00
Transfer,Deposit,2024-09-06 19:03:32,2024-09-06 19:03:32,Savings vault withdrawal from prefunding wallet,100.00,0.00,EUR,COMPLETED,100.00
Transfer,Deposit,2024-09-06 19:03:32,2024-09-06 19:03:32,From Flexible Cash Funds,-100.00,0.00,EUR,COMPLETED,0.00
Transfer,Deposit,2024-09-06 19:03:57,2024-09-06 19:03:57,Savings Vault topup,4.25,0.00,EUR,COMPLETED,4.25
Transfer,Deposit,2024-09-06 19:03:57,2024-09-06 19:03:57,Saving vault topup prefunding wallet,-4.25,0.00,EUR,COMPLETED,0.00
Transfer,Deposit,2024-09-07 09:00:15,2024-09-07 09:00:15,Savings Vault topup,5.00,0.00,EUR,COMPLETED,5.00
Transfer,Deposit,2024-09-07 09:00:15,2024-09-07 09:00:15,Saving vault topup prefunding wallet,-5.00,0.00,EUR,COMPLETED,0.00
Transfer,Deposit,2024-09-07 09:58:49,2024-09-07 09:58:49,Savings Vault topup,0.30,0.00,EUR,COMPLETED,0.30
Transfer,Deposit,2024-09-07 09:58:49,2024-09-07 09:58:49,Saving vault topup prefunding wallet,-0.30,0.00,EUR,COMPLETED,0.00
Transfer,Deposit,2024-09-07 11:32:40,2024-09-07 11:32:40,Savings Vault topup,5.00,0.00,EUR,COMPLETED,5.00
Transfer,Deposit,2024-09-07 11:32:40,2024-09-07 11:32:40,Saving vault topup prefunding wallet,-5.00,0.00,EUR,COMPLETED,0.00
Transfer,Deposit,2024-09-07 11:33:46,2024-09-07 11:33:46,Savings Vault topup,0.50,0.00,EUR,COMPLETED,0.50
Transfer,Deposit,2024-09-07 11:33:46,2024-09-07 11:33:46,Saving vault topup prefunding wallet,-0.50,0.00,EUR,COMPLETED,0.00
Transfer,Deposit,2024-09-07 12:00:02,2024-09-07 12:00:02,Savings Vault topup,4.50,0.00,EUR,COMPLETED,4.50
Transfer,Deposit,2024-09-07 12:00:02,2024-09-07 12:00:02,Saving vault topup prefunding wallet,-4.50,0.00,EUR,COMPLETED,0.00
Transfer,Deposit,2024-09-07 12:17:58,2024-09-07 12:17:59,Savings Vault topup,0.55,0.00,EUR,COMPLETED,0.55
Transfer,Deposit,2024-09-07 12:17:59,2024-09-07 12:17:59,Saving vault topup prefunding wallet,-0.55,0.00,EUR,COMPLETED,0.00
Transfer,Deposit,2024-09-08 09:02:55,2024-09-08 09:02:55,Savings Vault topup,2.45,0.00,EUR,COMPLETED,2.45
Transfer,Deposit,2024-09-08 09:02:55,2024-09-08 09:02:55,Saving vault topup prefunding wallet,-2.45,0.00,EUR,COMPLETED,0.00
Transfer,Deposit,2024-09-08 10:30:12,2024-09-08 10:30:12,Savings Vault topup,0.05,0.00,EUR,COMPLETED,0.05
Transfer,Deposit,2024-09-08 10:30:12,2024-09-08 10:30:12,Saving vault topup prefunding wallet,-0.05,0.00,EUR,COMPLETED,0.00
Transfer,Deposit,2024-09-10 11:29:53,2024-09-10 11:29:53,Savings Vault topup,2.00,0.00,EUR,COMPLETED,2.00
Transfer,Deposit,2024-09-10 11:29:53,2024-09-10 11:29:53,Saving vault topup prefunding wallet,-2.00,0.00,EUR,COMPLETED,0.00
Transfer,Deposit,2024-09-10 13:23:11,2024-09-10 13:23:11,Savings vault withdrawal from prefunding wallet,100.00,0.00,EUR,COMPLETED,100.00
Transfer,Deposit,2024-09-10 13:23:11,2024-09-10 13:23:12,From Flexible Cash Funds,-100.00,0.00,EUR,COMPLETED,0.00
Transfer,Deposit,2024-09-10 13:25:29,2024-09-10 13:25:29,Savings Vault topup,5.00,0.00,EUR,COMPLETED,5.00
Transfer,Deposit,2024-09-10 13:25:29,2024-09-10 13:25:29,Saving vault topup prefunding wallet,-5.00,0.00,EUR,COMPLETED,0.00
Transfer,Deposit,2024-09-10 14:32:00,2024-09-10 14:32:00,Savings Vault topup,3.00,0.00,EUR,COMPLETED,3.00
Transfer,Deposit,2024-09-10 14:32:00,2024-09-10 14:32:00,Saving vault topup prefunding wallet,-3.00,0.00,EUR,COMPLETED,0.00
Transfer,Deposit,2024-09-10 14:37:25,2024-09-10 14:37:25,Savings Vault topup,0.50,0.00,EUR,COMPLETED,0.50
Transfer,Deposit,2024-09-10 14:37:25,2024-09-10 14:37:25,Saving vault topup prefunding wallet,-0.50,0.00,EUR,COMPLETED,0.00
Transfer,Deposit,2024-09-10 14:59:04,2024-09-10 14:59:04,Savings Vault topup,4.00,0.00,EUR,COMPLETED,4.00
Transfer,Deposit,2024-09-10 14:59:04,2024-09-10 14:59:04,Saving vault topup prefunding wallet,-4.00,0.00,EUR,COMPLETED,0.00
Transfer,Deposit,2024-09-10 17:03:43,2024-09-10 17:03:43,Savings Vault topup,1.05,0.00,EUR,COMPLETED,1.05
Transfer,Deposit,2024-09-10 17:03:43,2024-09-10 17:03:43,Saving vault topup prefunding wallet,-1.05,0.00,EUR,COMPLETED,0.00
Transfer,Deposit,2024-09-11 15:16:24,2024-09-11 15:16:24,Savings vault withdrawal from prefunding wallet,250.00,0.00,EUR,COMPLETED,250.00
Transfer,Deposit,2024-09-11 15:16:23,2024-09-11 15:16:24,From Flexible Cash Funds,-250.00,0.00,EUR,COMPLETED,0.00
Transfer,Deposit,2024-09-11 15:16:47,2024-09-11 15:16:48,Savings Vault topup,5.00,0.00,EUR,COMPLETED,5.00
Transfer,Deposit,2024-09-11 15:16:48,2024-09-11 15:16:48,Saving vault topup prefunding wallet,-5.00,0.00,EUR,COMPLETED,0.00
Transfer,Deposit,2024-09-11 16:55:18,2024-09-11 16:55:18,Savings vault withdrawal from prefunding wallet,120.00,0.00,EUR,COMPLETED,120.00
Transfer,Deposit,2024-09-11 16:55:18,2024-09-11 16:55:18,From Flexible Cash Funds,-120.00,0.00,EUR,COMPLETED,0.00
Transfer,Deposit,2024-09-11 16:57:30,2024-09-11 16:57:30,Savings Vault topup,0.05,0.00,EUR,COMPLETED,0.05
Transfer,Deposit,2024-09-11 16:57:30,2024-09-11 16:57:30,Saving vault topup prefunding wallet,-0.05,0.00,EUR,COMPLETED,0.00
Transfer,Deposit,2024-09-13 07:40:51,2024-09-13 07:40:51,Savings Vault topup,0.45,0.00,EUR,COMPLETED,0.45
Transfer,Deposit,2024-09-13 07:40:51,2024-09-13 07:40:51,Saving vault topup prefunding wallet,-0.45,0.00,EUR,COMPLETED,0.00
Transfer,Deposit,2024-09-14 19:34:09,2024-09-14 19:34:10,Savings Vault topup,5.00,0.00,EUR,COMPLETED,5.00
Transfer,Deposit,2024-09-14 19:34:10,2024-09-14 19:34:10,Saving vault topup prefunding wallet,-5.00,0.00,EUR,COMPLETED,0.00
Transfer,Deposit,2024-09-14 23:07:56,2024-09-14 23:07:56,Savings Vault topup,1.50,0.00,EUR,COMPLETED,1.50
Transfer,Deposit,2024-09-14 23:07:56,2024-09-14 23:07:56,Saving vault topup prefunding wallet,-1.50,0.00,EUR,COMPLETED,0.00
Transfer,Deposit,2024-09-15 10:58:27,2024-09-15 10:58:27,Savings vault withdrawal from prefunding wallet,100.00,0.00,EUR,COMPLETED,100.00
Transfer,Deposit,2024-09-15 10:58:27,2024-09-15 10:58:27,From Flexible Cash Funds,-100.00,0.00,EUR,COMPLETED,0.00
Transfer,Deposit,2024-09-15 10:59:22,2024-09-15 10:59:22,Savings Vault topup,2.75,0.00,EUR,COMPLETED,2.75
Transfer,Deposit,2024-09-15 10:59:22,2024-09-15 10:59:22,Saving vault topup prefunding wallet,-2.75,0.00,EUR,COMPLETED,0.00
Transfer,Deposit,2024-09-15 16:09:45,2024-09-15 16:09:45,Savings Vault topup,3.00,0.00,EUR,COMPLETED,3.00
Transfer,Deposit,2024-09-15 16:09:45,2024-09-15 16:09:45,Saving vault topup prefunding wallet,-3.00,0.00,EUR,COMPLETED,0.00
Transfer,Deposit,2024-09-17 08:35:32,2024-09-17 08:35:32,Savings Vault topup,2.75,0.00,EUR,COMPLETED,2.75
Transfer,Deposit,2024-09-17 08:35:32,2024-09-17 08:35:32,Saving vault topup prefunding wallet,-2.75,0.00,EUR,COMPLETED,0.00
Transfer,Deposit,2024-09-17 13:59:30,2024-09-17 13:59:30,Savings Vault topup,5.00,0.00,EUR,COMPLETED,5.00
Transfer,Deposit,2024-09-17 13:59:30,2024-09-17 13:59:30,Saving vault topup prefunding wallet,-5.00,0.00,EUR,COMPLETED,0.00
Transfer,Deposit,2024-09-18 08:40:51,2024-09-18 08:40:51,Savings Vault topup,2.75,0.00,EUR,COMPLETED,2.75
Transfer,Deposit,2024-09-18 08:40:51,2024-09-18 08:40:51,Saving vault topup prefunding wallet,-2.75,0.00,EUR,COMPLETED,0.00
Transfer,Deposit,2024-09-18 19:25:04,2024-09-18 19:25:04,Savings Vault topup,0.15,0.00,EUR,COMPLETED,0.15
Transfer,Deposit,2024-09-18 19:25:04,2024-09-18 19:25:04,Saving vault topup prefunding wallet,-0.15,0.00,EUR,COMPLETED,0.00
Transfer,Deposit,2024-09-19 08:33:40,2024-09-19 08:33:40,Savings Vault topup,2.75,0.00,EUR,COMPLETED,2.75
Transfer,Deposit,2024-09-19 08:33:40,2024-09-19 08:33:40,Saving vault topup prefunding wallet,-2.75,0.00,EUR,COMPLETED,0.00
Transfer,Deposit,2024-09-20 08:48:35,2024-09-20 08:48:35,Savings Vault topup,2.75,0.00,EUR,COMPLETED,2.75
Transfer,Deposit,2024-09-20 08:48:35,2024-09-20 08:48:35,Saving vault topup prefunding wallet,-2.75,0.00,EUR,COMPLETED,0.00
Transfer,Deposit,2024-09-20 14:18:01,2024-09-20 14:18:01,Savings vault withdrawal from prefunding wallet,50.00,0.00,EUR,COMPLETED,50.00
Transfer,Deposit,2024-09-20 14:18:01,2024-09-20 14:18:01,From Flexible Cash Funds,-50.00,0.00,EUR,COMPLETED,0.00
Transfer,Deposit,2024-09-20 14:18:07,2024-09-20 14:18:07,Savings Vault topup,2.50,0.00,EUR,COMPLETED,2.50
Transfer,Deposit,2024-09-20 14:18:07,2024-09-20 14:18:07,Saving vault topup prefunding wallet,-2.50,0.00,EUR,COMPLETED,0.00
Transfer,Deposit,2024-09-20 14:44:54,2024-09-20 14:44:54,Savings vault withdrawal from prefunding wallet,100.00,0.00,EUR,COMPLETED,100.00
Transfer,Deposit,2024-09-20 14:44:54,2024-09-20 14:44:54,From Flexible Cash Funds,-100.00,0.00,EUR,COMPLETED,0.00
Transfer,Deposit,2024-09-20 14:45:00,2024-09-20 14:45:00,Savings Vault topup,2.70,0.00,EUR,COMPLETED,2.70
Transfer,Deposit,2024-09-20 14:45:00,2024-09-20 14:45:00,Saving vault topup prefunding wallet,-2.70,0.00,EUR,COMPLETED,0.00
Transfer,Deposit,2024-09-20 14:49:10,2024-09-20 14:49:10,Savings Vault topup,1.50,0.00,EUR,COMPLETED,1.50
Transfer,Deposit,2024-09-20 14:49:10,2024-09-20 14:49:10,Saving vault topup prefunding wallet,-1.50,0.00,EUR,COMPLETED,0.00
Transfer,Deposit,2024-09-20 16:41:41,2024-09-20 16:41:41,Savings Vault topup,5.00,0.00,EUR,COMPLETED,5.00
Transfer,Deposit,2024-09-20 16:41:41,2024-09-20 16:41:41,Saving vault topup prefunding wallet,-5.00,0.00,EUR,COMPLETED,0.00
Transfer,Deposit,2024-09-21 09:22:05,2024-09-21 09:22:05,Savings Vault topup,1.05,0.00,EUR,COMPLETED,1.05
Transfer,Deposit,2024-09-21 09:22:05,2024-09-21 09:22:05,Saving vault topup prefunding wallet,-1.05,0.00,EUR,COMPLETED,0.00
Transfer,Deposit,2024-09-21 09:22:52,2024-09-21 09:22:52,Savings Vault topup,5.00,0.00,EUR,COMPLETED,5.00
Transfer,Deposit,2024-09-21 09:22:52,2024-09-21 09:22:52,Saving vault topup prefunding wallet,-5.00,0.00,EUR,COMPLETED,0.00
Transfer,Deposit,2024-09-21 17:21:51,2024-09-21 17:21:51,Savings Vault topup,4.50,0.00,EUR,COMPLETED,4.50
Transfer,Deposit,2024-09-21 17:21:51,2024-09-21 17:21:51,Saving vault topup prefunding wallet,-4.50,0.00,EUR,COMPLETED,0.00
Transfer,Deposit,2024-09-22 07:27:58,2024-09-22 07:27:58,Savings vault withdrawal from prefunding wallet,77.00,0.00,EUR,COMPLETED,77.00
Transfer,Deposit,2024-09-22 07:27:58,2024-09-22 07:27:58,From Flexible Cash Funds,-77.00,0.00,EUR,COMPLETED,0.00
Transfer,Deposit,2024-09-22 09:26:04,2024-09-22 09:26:04,Savings Vault topup,3.50,0.00,EUR,COMPLETED,3.50
Transfer,Deposit,2024-09-22 09:26:04,2024-09-22 09:26:04,Saving vault topup prefunding wallet,-3.50,0.00,EUR,COMPLETED,0.00
Transfer,Deposit,2024-09-22 13:41:10,2024-09-22 13:41:10,Savings Vault topup,3.75,0.00,EUR,COMPLETED,3.75
Transfer,Deposit,2024-09-22 13:41:10,2024-09-22 13:41:10,Saving vault topup prefunding wallet,-3.75,0.00,EUR,COMPLETED,0.00
Transfer,Deposit,2024-09-22 17:18:31,2024-09-22 17:18:31,Savings Vault topup,2.25,0.00,EUR,COMPLETED,2.25
Transfer,Deposit,2024-09-22 17:18:31,2024-09-22 17:18:31,Saving vault topup prefunding wallet,-2.25,0.00,EUR,COMPLETED,0.00
Transfer,Deposit,2024-09-23 12:15:25,2024-09-23 13:29:32,Savings vault withdrawal from prefunding wallet,60.00,0.00,EUR,COMPLETED,60.00
Transfer,Deposit,2024-09-23 12:15:25,2024-09-23 13:29:32,From Flexible Cash Funds,-60.00,0.00,EUR,COMPLETED,0.00
Transfer,Deposit,2024-09-23 12:16:59,2024-09-23 13:29:53,Savings vault withdrawal from prefunding wallet,60.00,0.00,EUR,COMPLETED,60.00
Transfer,Deposit,2024-09-23 12:16:59,2024-09-23 13:29:53,From Flexible Cash Funds,-60.00,0.00,EUR,COMPLETED,0.00
Transfer,Deposit,2024-09-23 16:32:08,2024-09-23 16:32:08,Savings Vault topup,5.00,0.00,EUR,COMPLETED,5.00
Transfer,Deposit,2024-09-23 16:32:08,2024-09-23 16:32:08,Saving vault topup prefunding wallet,-5.00,0.00,EUR,COMPLETED,0.00
Transfer,Deposit,2024-09-24 09:02:42,2024-09-24 09:02:42,Savings Vault topup,2.75,0.00,EUR,COMPLETED,2.75
Transfer,Deposit,2024-09-24 09:02:42,2024-09-24 09:02:42,Saving vault topup prefunding wallet,-2.75,0.00,EUR,COMPLETED,0.00
Transfer,Deposit,2024-09-24 17:20:08,2024-09-24 17:20:08,Savings Vault topup,5.00,0.00,EUR,COMPLETED,5.00
Transfer,Deposit,2024-09-24 17:20:08,2024-09-24 17:20:08,Saving vault topup prefunding wallet,-5.00,0.00,EUR,COMPLETED,0.00
Transfer,Deposit,2024-09-24 17:20:29,2024-09-24 17:20:29,Savings Vault topup,3.80,0.00,EUR,COMPLETED,3.80
Transfer,Deposit,2024-09-24 17:20:29,2024-09-24 17:20:29,Saving vault topup prefunding wallet,-3.80,0.00,EUR,COMPLETED,0.00
Transfer,Deposit,2024-09-24 19:06:42,2024-09-24 19:06:42,Savings Vault topup,4.20,0.00,EUR,COMPLETED,4.20
Transfer,Deposit,2024-09-24 19:06:42,2024-09-24 19:06:42,Saving vault topup prefunding wallet,-4.20,0.00,EUR,COMPLETED,0.00
Transfer,Deposit,2024-09-25 07:38:02,2024-09-25 07:38:02,Savings Vault topup,5.00,0.00,EUR,COMPLETED,5.00
Transfer,Deposit,2024-09-25 07:38:02,2024-09-25 07:38:02,Saving vault topup prefunding wallet,-5.00,0.00,EUR,COMPLETED,0.00
Transfer,Deposit,2024-09-25 07:38:19,2024-09-25 07:38:19,Savings Vault topup,250.00,0.00,EUR,COMPLETED,250.00
Transfer,Deposit,2024-09-25 07:38:19,2024-09-25 07:38:19,Saving vault topup prefunding wallet,-250.00,0.00,EUR,COMPLETED,0.00
Transfer,Deposit,2024-09-25 12:56:24,2024-09-25 12:56:24,Savings Vault topup,2.50,0.00,EUR,COMPLETED,2.50
Transfer,Deposit,2024-09-25 12:56:24,2024-09-25 12:56:24,Saving vault topup prefunding wallet,-2.50,0.00,EUR,COMPLETED,0.00
Transfer,Deposit,2024-09-25 21:34:47,2024-09-25 21:34:48,Savings Vault topup,2.70,0.00,EUR,COMPLETED,2.70
Transfer,Deposit,2024-09-25 21:34:48,2024-09-25 21:34:48,Saving vault topup prefunding wallet,-2.70,0.00,EUR,COMPLETED,0.00
Transfer,Deposit,2024-09-25 22:02:38,2024-09-25 22:02:38,Savings Vault topup,1.85,0.00,EUR,COMPLETED,1.85
Transfer,Deposit,2024-09-25 22:02:38,2024-09-25 22:02:38,Saving vault topup prefunding wallet,-1.85,0.00,EUR,COMPLETED,0.00
Transfer,Deposit,2024-09-26 08:25:46,2024-09-26 08:25:46,Savings Vault topup,5.00,0.00,EUR,COMPLETED,5.00
Transfer,Deposit,2024-09-26 08:25:46,2024-09-26 08:25:46,Saving vault topup prefunding wallet,-5.00,0.00,EUR,COMPLETED,0.00
Transfer,Deposit,2024-09-26 12:33:14,2024-09-26 12:33:14,Savings Vault topup,1.25,0.00,EUR,COMPLETED,1.25
Transfer,Deposit,2024-09-26 12:33:14,2024-09-26 12:33:14,Saving vault topup prefunding wallet,-1.25,0.00,EUR,COMPLETED,0.00
Transfer,Deposit,2024-09-26 19:17:22,2024-09-26 19:17:22,Savings Vault topup,5.00,0.00,EUR,COMPLETED,5.00
Transfer,Deposit,2024-09-26 19:17:22,2024-09-26 19:17:22,Saving vault topup prefunding wallet,-5.00,0.00,EUR,COMPLETED,0.00
Transfer,Deposit,2024-09-26 19:26:49,2024-09-26 19:26:49,Savings Vault topup,4.25,0.00,EUR,COMPLETED,4.25
Transfer,Deposit,2024-09-26 19:26:49,2024-09-26 19:26:49,Saving vault topup prefunding wallet,-4.25,0.00,EUR,COMPLETED,0.00
Transfer,Deposit,2024-09-27 08:29:18,2024-09-27 08:29:18,Savings Vault topup,5.00,0.00,EUR,COMPLETED,5.00
Transfer,Deposit,2024-09-27 08:29:18,2024-09-27 08:29:18,Saving vault topup prefunding wallet,-5.00,0.00,EUR,COMPLETED,0.00
Transfer,Deposit,2024-09-27 12:26:33,2024-09-27 12:26:33,Savings Vault topup,0.10,0.00,EUR,COMPLETED,0.10
Transfer,Deposit,2024-09-27 12:26:33,2024-09-27 12:26:33,Saving vault topup prefunding wallet,-0.10,0.00,EUR,COMPLETED,0.00
Transfer,Deposit,2024-09-27 15:42:05,2024-09-27 15:42:05,Savings Vault topup,5.00,0.00,EUR,COMPLETED,5.00
Transfer,Deposit,2024-09-27 15:42:05,2024-09-27 15:42:05,Saving vault topup prefunding wallet,-5.00,0.00,EUR,COMPLETED,0.00
Transfer,Deposit,2024-09-27 15:57:54,2024-09-27 15:57:54,Savings Vault topup,2.00,0.00,EUR,COMPLETED,2.00
Transfer,Deposit,2024-09-27 15:57:54,2024-09-27 15:57:54,Saving vault topup prefunding wallet,-2.00,0.00,EUR,COMPLETED,0.00
Transfer,Deposit,2024-09-27 19:03:40,2024-09-27 19:03:40,Savings Vault topup,3.00,0.00,EUR,COMPLETED,3.00
Transfer,Deposit,2024-09-27 19:03:40,2024-09-27 19:03:40,Saving vault topup prefunding wallet,-3.00,0.00,EUR,COMPLETED,0.00
Transfer,Deposit,2024-09-27 20:16:14,2024-09-27 20:16:15,Savings Vault topup,3.00,0.00,EUR,COMPLETED,3.00
Transfer,Deposit,2024-09-27 20:16:15,2024-09-27 20:16:15,Saving vault topup prefunding wallet,-3.00,0.00,EUR,COMPLETED,0.00
Transfer,Deposit,2024-09-27 21:08:57,2024-09-27 21:08:57,Savings Vault topup,3.25,0.00,EUR,COMPLETED,3.25
Transfer,Deposit,2024-09-27 21:08:57,2024-09-27 21:08:57,Saving vault topup prefunding wallet,-3.25,0.00,EUR,COMPLETED,0.00
Transfer,Deposit,2024-09-27 21:26:14,2024-09-27 21:26:14,Savings Vault topup,5.00,0.00,EUR,COMPLETED,5.00
Transfer,Deposit,2024-09-27 21:26:14,2024-09-27 21:26:14,Saving vault topup prefunding wallet,-5.00,0.00,EUR,COMPLETED,0.00
Transfer,Deposit,2024-09-27 22:04:00,2024-09-27 22:04:00,Savings Vault topup,1.00,0.00,EUR,COMPLETED,1.00
Transfer,Deposit,2024-09-27 22:04:00,2024-09-27 22:04:00,Saving vault topup prefunding wallet,-1.00,0.00,EUR,COMPLETED,0.00
Transfer,Deposit,2024-09-27 22:28:15,2024-09-27 22:28:15,Savings Vault topup,5.00,0.00,EUR,COMPLETED,5.00
Transfer,Deposit,2024-09-27 22:28:15,2024-09-27 22:28:15,Saving vault topup prefunding wallet,-5.00,0.00,EUR,COMPLETED,0.00
Transfer,Deposit,2024-09-28 00:49:08,2024-09-28 00:49:08,Savings Vault topup,0.50,0.00,EUR,COMPLETED,0.50
Transfer,Deposit,2024-09-28 00:49:08,2024-09-28 00:49:08,Saving vault topup prefunding wallet,-0.50,0.00,EUR,COMPLETED,0.00
Transfer,Deposit,2024-09-28 13:15:28,2024-09-28 13:15:28,Savings Vault topup,1.50,0.00,EUR,COMPLETED,1.50
Transfer,Deposit,2024-09-28 13:15:28,2024-09-28 13:15:28,Saving vault topup prefunding wallet,-1.50,0.00,EUR,COMPLETED,0.00
Transfer,Deposit,2024-09-28 13:17:49,2024-09-28 13:17:49,Savings Vault topup,4.50,0.00,EUR,COMPLETED,4.50
Transfer,Deposit,2024-09-28 13:17:49,2024-09-28 13:17:49,Saving vault topup prefunding wallet,-4.50,0.00,EUR,COMPLETED,0.00
Transfer,Deposit,2024-09-28 14:19:25,2024-09-28 14:19:25,Savings Vault topup,0.05,0.00,EUR,COMPLETED,0.05
Transfer,Deposit,2024-09-28 14:19:25,2024-09-28 14:19:25,Saving vault topup prefunding wallet,-0.05,0.00,EUR,COMPLETED,0.00
Transfer,Deposit,2024-09-28 14:28:52,2024-09-28 14:28:52,Savings Vault topup,5.00,0.00,EUR,COMPLETED,5.00
Transfer,Deposit,2024-09-28 14:28:52,2024-09-28 14:28:52,Saving vault topup prefunding wallet,-5.00,0.00,EUR,COMPLETED,0.00
Transfer,Deposit,2024-09-28 15:50:12,2024-09-28 15:50:12,Savings Vault topup,5.00,0.00,EUR,COMPLETED,5.00
Transfer,Deposit,2024-09-28 15:50:12,2024-09-28 15:50:12,Saving vault topup prefunding wallet,-5.00,0.00,EUR,COMPLETED,0.00
Transfer,Deposit,2024-09-28 20:09:00,2024-09-28 20:09:00,Savings Vault topup,1.25,0.00,EUR,COMPLETED,1.25
Transfer,Deposit,2024-09-28 20:09:00,2024-09-28 20:09:00,Saving vault topup prefunding wallet,-1.25,0.00,EUR,COMPLETED,0.00
Transfer,Deposit,2024-09-30 17:28:56,2024-09-30 17:28:57,Savings Vault topup,4.10,0.00,EUR,COMPLETED,4.10
Transfer,Deposit,2024-09-30 17:28:57,2024-09-30 17:28:57,Saving vault topup prefunding wallet,-4.10,0.00,EUR,COMPLETED,0.00
Transfer,Deposit,2024-10-02 08:48:42,2024-10-02 08:48:42,Savings Vault topup,2.55,0.00,EUR,COMPLETED,2.55
Transfer,Deposit,2024-10-02 08:48:42,2024-10-02 08:48:42,Saving vault topup prefunding wallet,-2.55,0.00,EUR,COMPLETED,0.00
Transfer,Deposit,2024-10-02 12:27:55,2024-10-02 12:27:55,Savings Vault topup,0.85,0.00,EUR,COMPLETED,0.85
Transfer,Deposit,2024-10-02 12:27:55,2024-10-02 12:27:55,Saving vault topup prefunding wallet,-0.85,0.00,EUR,COMPLETED,0.00
Transfer,Deposit,2024-10-03 09:03:33,2024-10-03 09:03:33,Savings Vault topup,5.00,0.00,EUR,COMPLETED,5.00
Transfer,Deposit,2024-10-03 09:03:33,2024-10-03 09:03:33,Saving vault topup prefunding wallet,-5.00,0.00,EUR,COMPLETED,0.00
Transfer,Deposit,2024-10-03 13:04:50,2024-10-03 13:04:50,Savings Vault topup,1.25,0.00,EUR,COMPLETED,1.25
Transfer,Deposit,2024-10-03 13:04:50,2024-10-03 13:04:50,Saving vault topup prefunding wallet,-1.25,0.00,EUR,COMPLETED,0.00
Transfer,Deposit,2024-10-03 16:22:51,2024-10-03 16:22:51,Savings Vault topup,2.75,0.00,EUR,COMPLETED,2.75
Transfer,Deposit,2024-10-03 16:22:51,2024-10-03 16:22:51,Saving vault topup prefunding wallet,-2.75,0.00,EUR,COMPLETED,0.00
Transfer,Deposit,2024-10-03 23:09:25,2024-10-03 23:09:25,Savings Vault topup,3.00,0.00,EUR,COMPLETED,3.00
Transfer,Deposit,2024-10-03 23:09:25,2024-10-03 23:09:25,Saving vault topup prefunding wallet,-3.00,0.00,EUR,COMPLETED,0.00
Transfer,Deposit,2024-10-04 02:51:34,2024-10-04 02:51:34,Savings Vault topup,0.05,0.00,EUR,COMPLETED,0.05
Transfer,Deposit,2024-10-04 02:51:34,2024-10-04 02:51:34,Saving vault topup prefunding wallet,-0.05,0.00,EUR,COMPLETED,0.00
Transfer,Deposit,2024-10-04 09:36:36,2024-10-04 09:36:36,Savings Vault topup,1.05,0.00,EUR,COMPLETED,1.05
Transfer,Deposit,2024-10-04 09:36:36,2024-10-04 09:36:36,Saving vault topup prefunding wallet,-1.05,0.00,EUR,COMPLETED,0.00
Transfer,Deposit,2024-10-04 13:19:22,2024-10-04 13:19:22,Savings Vault topup,4.85,0.00,EUR,COMPLETED,4.85
Transfer,Deposit,2024-10-04 13:19:22,2024-10-04 13:19:22,Saving vault topup prefunding wallet,-4.85,0.00,EUR,COMPLETED,0.00
Transfer,Deposit,2024-10-04 18:07:52,2024-10-04 18:07:52,Savings Vault topup,4.05,0.00,EUR,COMPLETED,4.05
Transfer,Deposit,2024-10-04 18:07:52,2024-10-04 18:07:52,Saving vault topup prefunding wallet,-4.05,0.00,EUR,COMPLETED,0.00
Transfer,Deposit,2024-10-05 11:18:57,2024-10-05 11:18:57,Savings Vault topup,4.00,0.00,EUR,COMPLETED,4.00
Transfer,Deposit,2024-10-05 11:18:57,2024-10-05 11:18:57,Saving vault topup prefunding wallet,-4.00,0.00,EUR,COMPLETED,0.00
Transfer,Deposit,2024-10-05 11:52:56,2024-10-05 11:52:56,Savings Vault topup,2.60,0.00,EUR,COMPLETED,2.60
Transfer,Deposit,2024-10-05 11:52:56,2024-10-05 11:52:56,Saving vault topup prefunding wallet,-2.60,0.00,EUR,COMPLETED,0.00
Transfer,Deposit,2024-10-05 12:06:04,2024-10-05 12:06:04,Savings Vault topup,2.65,0.00,EUR,COMPLETED,2.65
Transfer,Deposit,2024-10-05 12:06:04,2024-10-05 12:06:04,Saving vault topup prefunding wallet,-2.65,0.00,EUR,COMPLETED,0.00
Transfer,Deposit,2024-10-05 20:19:51,2024-10-05 20:19:51,Savings Vault topup,5.00,0.00,EUR,COMPLETED,5.00
Transfer,Deposit,2024-10-05 20:19:51,2024-10-05 20:19:51,Saving vault topup prefunding wallet,-5.00,0.00,EUR,COMPLETED,0.00
Transfer,Deposit,2024-10-05 20:20:47,2024-10-05 20:20:47,Savings Vault topup,0.50,0.00,EUR,COMPLETED,0.50
Transfer,Deposit,2024-10-05 20:20:47,2024-10-05 20:20:47,Saving vault topup prefunding wallet,-0.50,0.00,EUR,COMPLETED,0.00
Transfer,Deposit,2024-10-06 13:14:15,2024-10-06 13:14:15,Savings Vault topup,5.00,0.00,EUR,COMPLETED,5.00
Transfer,Deposit,2024-10-06 13:14:15,2024-10-06 13:14:15,Saving vault topup prefunding wallet,-5.00,0.00,EUR,COMPLETED,0.00
Transfer,Deposit,2024-10-06 13:35:01,2024-10-06 13:35:01,Savings Vault topup,1.75,0.00,EUR,COMPLETED,1.75
Transfer,Deposit,2024-10-06 13:35:01,2024-10-06 13:35:01,Saving vault topup prefunding wallet,-1.75,0.00,EUR,COMPLETED,0.00
Transfer,Deposit,2024-10-06 13:46:32,2024-10-06 13:46:32,Savings Vault topup,5.00,0.00,EUR,COMPLETED,5.00
Transfer,Deposit,2024-10-06 13:46:32,2024-10-06 13:46:32,Saving vault topup prefunding wallet,-5.00,0.00,EUR,COMPLETED,0.00
Transfer,Deposit,2024-10-06 14:52:48,2024-10-06 14:52:48,Savings Vault topup,0.10,0.00,EUR,COMPLETED,0.10
Transfer,Deposit,2024-10-06 14:52:48,2024-10-06 14:52:48,Saving vault topup prefunding wallet,-0.10,0.00,EUR,COMPLETED,0.00
Transfer,Deposit,2024-10-06 17:16:25,2024-10-06 17:16:25,Savings Vault topup,0.05,0.00,EUR,COMPLETED,0.05
Transfer,Deposit,2024-10-06 17:16:25,2024-10-06 17:16:25,Saving vault topup prefunding wallet,-0.05,0.00,EUR,COMPLETED,0.00
Transfer,Deposit,2024-10-06 17:31:42,2024-10-06 17:31:42,Savings vault withdrawal from prefunding wallet,12000.00,0.00,EUR,COMPLETED,12000.00
Transfer,Deposit,2024-10-06 17:31:42,2024-10-06 17:31:42,From Flexible Cash Funds,-12000.00,0.00,EUR,COMPLETED,0.00
Transfer,Deposit,2024-10-07 08:52:43,2024-10-07 08:52:44,Savings Vault topup,5.00,0.00,EUR,COMPLETED,5.00
Transfer,Deposit,2024-10-07 08:52:44,2024-10-07 08:52:44,Saving vault topup prefunding wallet,-5.00,0.00,EUR,COMPLETED,0.00
Transfer,Deposit,2024-10-07 13:37:17,2024-10-07 13:37:17,Savings Vault topup,5.00,0.00,EUR,COMPLETED,5.00
Transfer,Deposit,2024-10-07 13:37:17,2024-10-07 13:37:17,Saving vault topup prefunding wallet,-5.00,0.00,EUR,COMPLETED,0.00
Transfer,Deposit,2024-10-07 15:34:34,2024-10-07 15:34:34,Savings Vault topup,5.00,0.00,EUR,COMPLETED,5.00
Transfer,Deposit,2024-10-07 15:34:34,2024-10-07 15:34:34,Saving vault topup prefunding wallet,-5.00,0.00,EUR,COMPLETED,0.00
Transfer,Deposit,2024-10-08 08:38:54,2024-10-08 08:38:54,Savings Vault topup,5.00,0.00,EUR,COMPLETED,5.00
Transfer,Deposit,2024-10-08 08:38:54,2024-10-08 08:38:54,Saving vault topup prefunding wallet,-5.00,0.00,EUR,COMPLETED,0.00
Transfer,Deposit,2024-10-08 08:47:55,2024-10-08 08:47:55,Savings Vault topup,0.05,0.00,EUR,COMPLETED,0.05
Transfer,Deposit,2024-10-08 08:47:55,2024-10-08 08:47:55,Saving vault topup prefunding wallet,-0.05,0.00,EUR,COMPLETED,0.00
Transfer,Deposit,2024-10-08 19:53:40,2024-10-08 19:53:40,Savings Vault topup,0.75,0.00,EUR,COMPLETED,0.75
Transfer,Deposit,2024-10-08 19:53:40,2024-10-08 19:53:40,Saving vault topup prefunding wallet,-0.75,0.00,EUR,COMPLETED,0.00
Transfer,Deposit,2024-10-09 10:40:23,2024-10-09 10:40:23,Savings Vault topup,5.00,0.00,EUR,COMPLETED,5.00
Transfer,Deposit,2024-10-09 10:40:23,2024-10-09 10:40:23,Saving vault topup prefunding wallet,-5.00,0.00,EUR,COMPLETED,0.00
Transfer,Deposit,2024-10-09 11:25:55,2024-10-09 11:25:55,Savings Vault topup,0.25,0.00,EUR,COMPLETED,0.25
Transfer,Deposit,2024-10-09 11:25:55,2024-10-09 11:25:55,Saving vault topup prefunding wallet,-0.25,0.00,EUR,COMPLETED,0.00
Transfer,Deposit,2024-10-09 17:54:54,2024-10-09 17:54:54,Savings Vault topup,2.85,0.00,EUR,COMPLETED,2.85
Transfer,Deposit,2024-10-09 17:54:54,2024-10-09 17:54:54,Saving vault topup prefunding wallet,-2.85,0.00,EUR,COMPLETED,0.00
Transfer,Deposit,2024-10-09 18:09:47,2024-10-09 18:09:47,Savings Vault topup,5.00,0.00,EUR,COMPLETED,5.00
Transfer,Deposit,2024-10-09 18:09:47,2024-10-09 18:09:47,Saving vault topup prefunding wallet,-5.00,0.00,EUR,COMPLETED,0.00
Transfer,Deposit,2024-10-09 18:58:47,2024-10-09 18:58:47,Savings Vault topup,1.40,0.00,EUR,COMPLETED,1.40
Transfer,Deposit,2024-10-09 18:58:47,2024-10-09 18:58:47,Saving vault topup prefunding wallet,-1.40,0.00,EUR,COMPLETED,0.00
Transfer,Deposit,2024-10-09 20:37:51,2024-10-09 20:37:51,Savings Vault topup,5.00,0.00,EUR,COMPLETED,5.00
Transfer,Deposit,2024-10-09 20:37:51,2024-10-09 20:37:51,Saving vault topup prefunding wallet,-5.00,0.00,EUR,COMPLETED,0.00
Transfer,Deposit,2024-10-09 20:43:55,2024-10-09 20:43:55,Savings Vault topup,5.00,0.00,EUR,COMPLETED,5.00
Transfer,Deposit,2024-10-09 20:43:55,2024-10-09 20:43:55,Saving vault topup prefunding wallet,-5.00,0.00,EUR,COMPLETED,0.00
Transfer,Deposit,2024-10-10 08:29:11,2024-10-10 08:29:11,Savings Vault topup,5.00,0.00,EUR,COMPLETED,5.00
Transfer,Deposit,2024-10-10 08:29:11,2024-10-10 08:29:11,Saving vault topup prefunding wallet,-5.00,0.00,EUR,COMPLETED,0.00
Transfer,Deposit,2024-10-11 08:59:41,2024-10-11 08:59:41,Savings Vault topup,5.00,0.00,EUR,COMPLETED,5.00
Transfer,Deposit,2024-10-11 08:59:41,2024-10-11 08:59:41,Saving vault topup prefunding wallet,-5.00,0.00,EUR,COMPLETED,0.00
Transfer,Deposit,2024-10-11 19:51:39,2024-10-11 19:51:39,Savings Vault topup,5.00,0.00,EUR,COMPLETED,5.00
Transfer,Deposit,2024-10-11 19:51:39,2024-10-11 19:51:39,Saving vault topup prefunding wallet,-5.00,0.00,EUR,COMPLETED,0.00
Transfer,Deposit,2024-10-12 11:39:00,2024-10-12 11:39:01,Savings Vault topup,5.00,0.00,EUR,COMPLETED,5.00
Transfer,Deposit,2024-10-12 11:39:01,2024-10-12 11:39:01,Saving vault topup prefunding wallet,-5.00,0.00,EUR,COMPLETED,0.00
Transfer,Deposit,2024-10-12 11:55:24,2024-10-12 11:55:24,Savings Vault topup,0.50,0.00,EUR,COMPLETED,0.50
Transfer,Deposit,2024-10-12 11:55:24,2024-10-12 11:55:24,Saving vault topup prefunding wallet,-0.50,0.00,EUR,COMPLETED,0.00
Transfer,Deposit,2024-10-12 12:01:55,2024-10-12 12:01:55,Savings Vault topup,2.50,0.00,EUR,COMPLETED,2.50
Transfer,Deposit,2024-10-12 12:01:55,2024-10-12 12:01:55,Saving vault topup prefunding wallet,-2.50,0.00,EUR,COMPLETED,0.00
Transfer,Deposit,2024-10-12 12:22:41,2024-10-12 12:22:41,Savings Vault topup,5.00,0.00,EUR,COMPLETED,5.00
Transfer,Deposit,2024-10-12 12:22:41,2024-10-12 12:22:41,Saving vault topup prefunding wallet,-5.00,0.00,EUR,COMPLETED,0.00
Transfer,Deposit,2024-10-12 13:04:58,2024-10-12 13:04:59,Savings Vault topup,1.50,0.00,EUR,COMPLETED,1.50
Transfer,Deposit,2024-10-12 13:04:59,2024-10-12 13:04:59,Saving vault topup prefunding wallet,-1.50,0.00,EUR,COMPLETED,0.00
Transfer,Deposit,2024-10-12 13:49:48,2024-10-12 13:49:48,Savings Vault topup,4.25,0.00,EUR,COMPLETED,4.25
Transfer,Deposit,2024-10-12 13:49:48,2024-10-12 13:49:48,Saving vault topup prefunding wallet,-4.25,0.00,EUR,COMPLETED,0.00
Transfer,Deposit,2024-10-12 14:12:03,2024-10-12 14:12:04,Savings Vault topup,0.75,0.00,EUR,COMPLETED,0.75
Transfer,Deposit,2024-10-12 14:12:04,2024-10-12 14:12:04,Saving vault topup prefunding wallet,-0.75,0.00,EUR,COMPLETED,0.00
Transfer,Deposit,2024-10-12 23:02:10,2024-10-12 23:02:10,Savings Vault topup,1.00,0.00,EUR,COMPLETED,1.00
Transfer,Deposit,2024-10-12 23:02:10,2024-10-12 23:02:10,Saving vault topup prefunding wallet,-1.00,0.00,EUR,COMPLETED,0.00
Transfer,Deposit,2024-10-12 23:32:19,2024-10-12 23:32:19,Savings Vault topup,1.00,0.00,EUR,COMPLETED,1.00
Transfer,Deposit,2024-10-12 23:32:19,2024-10-12 23:32:19,Saving vault topup prefunding wallet,-1.00,0.00,EUR,COMPLETED,0.00
Transfer,Deposit,2024-10-12 23:50:37,2024-10-12 23:50:37,Savings Vault topup,4.00,0.00,EUR,COMPLETED,4.00
Transfer,Deposit,2024-10-12 23:50:37,2024-10-12 23:50:37,Saving vault topup prefunding wallet,-4.00,0.00,EUR,COMPLETED,0.00
Transfer,Deposit,2024-10-13 00:56:29,2024-10-13 00:56:29,Savings Vault topup,2.55,0.00,EUR,COMPLETED,2.55
Transfer,Deposit,2024-10-13 00:56:29,2024-10-13 00:56:29,Saving vault topup prefunding wallet,-2.55,0.00,EUR,COMPLETED,0.00
Transfer,Deposit,2024-10-13 10:23:07,2024-10-13 10:23:07,Savings Vault topup,5.00,0.00,EUR,COMPLETED,5.00
Transfer,Deposit,2024-10-13 10:23:07,2024-10-13 10:23:07,Saving vault topup prefunding wallet,-5.00,0.00,EUR,COMPLETED,0.00
Transfer,Deposit,2024-10-13 10:26:35,2024-10-13 10:26:36,Savings Vault topup,0.25,0.00,EUR,COMPLETED,0.25
Transfer,Deposit,2024-10-13 10:26:36,2024-10-13 10:26:36,Saving vault topup prefunding wallet,-0.25,0.00,EUR,COMPLETED,0.00
Transfer,Deposit,2024-10-13 15:27:24,2024-10-13 15:27:24,Savings Vault topup,2.50,0.00,EUR,COMPLETED,2.50
Transfer,Deposit,2024-10-13 15:27:24,2024-10-13 15:27:24,Saving vault topup prefunding wallet,-2.50,0.00,EUR,COMPLETED,0.00
Transfer,Deposit,2024-10-13 15:46:17,2024-10-13 15:46:17,Savings Vault topup,5.00,0.00,EUR,COMPLETED,5.00
Transfer,Deposit,2024-10-13 15:46:17,2024-10-13 15:46:17,Saving vault topup prefunding wallet,-5.00,0.00,EUR,COMPLETED,0.00
Transfer,Deposit,2024-10-13 16:05:23,2024-10-13 16:05:23,Savings Vault topup,4.50,0.00,EUR,COMPLETED,4.50
Transfer,Deposit,2024-10-13 16:05:23,2024-10-13 16:05:23,Saving vault topup prefunding wallet,-4.50,0.00,EUR,COMPLETED,0.00
Transfer,Deposit,2024-10-13 16:32:00,2024-10-13 16:32:01,Savings Vault topup,3.75,0.00,EUR,COMPLETED,3.75
Transfer,Deposit,2024-10-13 16:32:01,2024-10-13 16:32:01,Saving vault topup prefunding wallet,-3.75,0.00,EUR,COMPLETED,0.00
Transfer,Deposit,2024-10-13 16:37:55,2024-10-13 16:37:55,Savings Vault topup,5.00,0.00,EUR,COMPLETED,5.00
Transfer,Deposit,2024-10-13 16:37:55,2024-10-13 16:37:55,Saving vault topup prefunding wallet,-5.00,0.00,EUR,COMPLETED,0.00
Transfer,Deposit,2024-10-14 13:52:26,2024-10-14 13:52:26,Savings Vault topup,0.75,0.00,EUR,COMPLETED,0.75
Transfer,Deposit,2024-10-14 13:52:26,2024-10-14 13:52:26,Saving vault topup prefunding wallet,-0.75,0.00,EUR,COMPLETED,0.00
Transfer,Deposit,2024-10-16 08:02:17,2024-10-16 08:02:17,Savings Vault topup,5.00,0.00,EUR,COMPLETED,5.00
Transfer,Deposit,2024-10-16 08:02:17,2024-10-16 08:02:17,Saving vault topup prefunding wallet,-5.00,0.00,EUR,COMPLETED,0.00
Transfer,Deposit,2024-10-16 09:31:49,2024-10-16 09:31:49,Savings Vault topup,0.05,0.00,EUR,COMPLETED,0.05
Transfer,Deposit,2024-10-16 09:31:49,2024-10-16 09:31:49,Saving vault topup prefunding wallet,-0.05,0.00,EUR,COMPLETED,0.00
Transfer,Deposit,2024-10-16 17:02:55,2024-10-16 17:02:55,Savings Vault topup,1.25,0.00,EUR,COMPLETED,1.25
Transfer,Deposit,2024-10-16 17:02:55,2024-10-16 17:02:55,Saving vault topup prefunding wallet,-1.25,0.00,EUR,COMPLETED,0.00
Transfer,Deposit,2024-10-16 17:24:49,2024-10-16 17:24:49,Savings Vault topup,5.00,0.00,EUR,COMPLETED,5.00
Transfer,Deposit,2024-10-16 17:24:49,2024-10-16 17:24:49,Saving vault topup prefunding wallet,-5.00,0.00,EUR,COMPLETED,0.00
Transfer,Deposit,2024-10-16 17:30:17,2024-10-16 17:30:17,Savings Vault topup,5.00,0.00,EUR,COMPLETED,5.00
Transfer,Deposit,2024-10-16 17:30:17,2024-10-16 17:30:17,Saving vault topup prefunding wallet,-5.00,0.00,EUR,COMPLETED,0.00
Transfer,Deposit,2024-10-17 19:05:00,2024-10-17 19:05:00,Savings Vault topup,2.00,0.00,EUR,COMPLETED,2.00
Transfer,Deposit,2024-10-17 19:05:00,2024-10-17 19:05:00,Saving vault topup prefunding wallet,-2.00,0.00,EUR,COMPLETED,0.00
Transfer,Deposit,2024-10-18 09:05:46,2024-10-18 09:05:46,Savings Vault topup,2.50,0.00,EUR,COMPLETED,2.50
Transfer,Deposit,2024-10-18 09:05:46,2024-10-18 09:05:46,Saving vault topup prefunding wallet,-2.50,0.00,EUR,COMPLETED,0.00
Transfer,Deposit,2024-10-19 05:04:06,2024-10-19 05:04:06,Savings Vault topup,2.55,0.00,EUR,COMPLETED,2.55
Transfer,Deposit,2024-10-19 05:04:06,2024-10-19 05:04:06,Saving vault topup prefunding wallet,-2.55,0.00,EUR,COMPLETED,0.00
Transfer,Deposit,2024-10-19 13:35:39,2024-10-19 13:35:39,Savings Vault topup,3.60,0.00,EUR,COMPLETED,3.60
Transfer,Deposit,2024-10-19 13:35:39,2024-10-19 13:35:39,Saving vault topup prefunding wallet,-3.60,0.00,EUR,COMPLETED,0.00
Transfer,Deposit,2024-10-19 13:56:17,2024-10-19 13:56:18,Savings Vault topup,4.80,0.00,EUR,COMPLETED,4.80
Transfer,Deposit,2024-10-19 13:56:18,2024-10-19 13:56:18,Saving vault topup prefunding wallet,-4.80,0.00,EUR,COMPLETED,0.00
Transfer,Deposit,2024-10-19 14:11:17,2024-10-19 14:11:17,Savings Vault topup,4.75,0.00,EUR,COMPLETED,4.75
Transfer,Deposit,2024-10-19 14:11:17,2024-10-19 14:11:17,Saving vault topup prefunding wallet,-4.75,0.00,EUR,COMPLETED,0.00
Transfer,Deposit,2024-10-19 19:09:13,2024-10-19 19:09:13,Savings Vault topup,1.60,0.00,EUR,COMPLETED,1.60
Transfer,Deposit,2024-10-19 19:09:13,2024-10-19 19:09:13,Saving vault topup prefunding wallet,-1.60,0.00,EUR,COMPLETED,0.00
Transfer,Deposit,2024-10-20 13:04:12,2024-10-20 13:04:12,Savings Vault topup,5.00,0.00,EUR,COMPLETED,5.00
Transfer,Deposit,2024-10-20 13:04:12,2024-10-20 13:04:12,Saving vault topup prefunding wallet,-5.00,0.00,EUR,COMPLETED,0.00
Transfer,Deposit,2024-10-20 15:22:53,2024-10-20 15:22:54,Savings Vault topup,4.95,0.00,EUR,COMPLETED,4.95
Transfer,Deposit,2024-10-20 15:22:54,2024-10-20 15:22:54,Saving vault topup prefunding wallet,-4.95,0.00,EUR,COMPLETED,0.00
Transfer,Deposit,2024-10-20 17:31:50,2024-10-20 17:31:51,Savings Vault topup,0.25,0.00,EUR,COMPLETED,0.25
Transfer,Deposit,2024-10-20 17:31:51,2024-10-20 17:31:51,Saving vault topup prefunding wallet,-0.25,0.00,EUR,COMPLETED,0.00
Transfer,Deposit,2024-10-20 18:24:53,2024-10-20 18:24:54,Savings Vault topup,5.00,0.00,EUR,COMPLETED,5.00
Transfer,Deposit,2024-10-20 18:24:54,2024-10-20 18:24:54,Saving vault topup prefunding wallet,-5.00,0.00,EUR,COMPLETED,0.00
Transfer,Deposit,2024-10-21 08:31:38,2024-10-21 08:31:38,Savings Vault topup,5.00,0.00,EUR,COMPLETED,5.00
Transfer,Deposit,2024-10-21 08:31:38,2024-10-21 08:31:38,Saving vault topup prefunding wallet,-5.00,0.00,EUR,COMPLETED,0.00
Transfer,Deposit,2024-10-21 19:41:38,2024-10-21 19:41:38,Savings Vault topup,3.80,0.00,EUR,COMPLETED,3.80
Transfer,Deposit,2024-10-21 19:41:38,2024-10-21 19:41:38,Saving vault topup prefunding wallet,-3.80,0.00,EUR,COMPLETED,0.00
Transfer,Deposit,2024-10-21 19:42:24,2024-10-21 19:42:24,Savings Vault topup,0.40,0.00,EUR,COMPLETED,0.40
Transfer,Deposit,2024-10-21 19:42:24,2024-10-21 19:42:24,Saving vault topup prefunding wallet,-0.40,0.00,EUR,COMPLETED,0.00
Transfer,Deposit,2024-10-22 08:04:14,2024-10-22 08:04:14,Savings Vault topup,5.00,0.00,EUR,COMPLETED,5.00
Transfer,Deposit,2024-10-22 08:04:14,2024-10-22 08:04:14,Saving vault topup prefunding wallet,-5.00,0.00,EUR,COMPLETED,0.00
Transfer,Deposit,2024-10-22 22:26:19,2024-10-22 22:26:19,Savings Vault topup,5.00,0.00,EUR,COMPLETED,5.00
Transfer,Deposit,2024-10-22 22:26:19,2024-10-22 22:26:19,Saving vault topup prefunding wallet,-5.00,0.00,EUR,COMPLETED,0.00
Transfer,Deposit,2024-10-23 08:05:47,2024-10-23 08:05:48,Savings Vault topup,5.00,0.00,EUR,COMPLETED,5.00
Transfer,Deposit,2024-10-23 08:05:48,2024-10-23 08:05:48,Saving vault topup prefunding wallet,-5.00,0.00,EUR,COMPLETED,0.00
Transfer,Deposit,2024-10-23 19:20:48,2024-10-23 19:20:48,Savings Vault topup,0.05,0.00,EUR,COMPLETED,0.05
Transfer,Deposit,2024-10-23 19:20:48,2024-10-23 19:20:48,Saving vault topup prefunding wallet,-0.05,0.00,EUR,COMPLETED,0.00
Transfer,Deposit,2024-10-24 08:29:23,2024-10-24 08:29:24,Savings Vault topup,1.25,0.00,EUR,COMPLETED,1.25
Transfer,Deposit,2024-10-24 08:29:24,2024-10-24 08:29:24,Saving vault topup prefunding wallet,-1.25,0.00,EUR,COMPLETED,0.00
Transfer,Deposit,2024-10-24 16:41:23,2024-10-24 16:41:24,Savings Vault topup,2.50,0.00,EUR,COMPLETED,2.50
Transfer,Deposit,2024-10-24 16:41:24,2024-10-24 16:41:24,Saving vault topup prefunding wallet,-2.50,0.00,EUR,COMPLETED,0.00
Transfer,Deposit,2024-10-24 16:47:21,2024-10-24 16:47:22,Savings Vault topup,2.60,0.00,EUR,COMPLETED,2.60
Transfer,Deposit,2024-10-24 16:47:22,2024-10-24 16:47:22,Saving vault topup prefunding wallet,-2.60,0.00,EUR,COMPLETED,0.00
Transfer,Deposit,2024-10-24 16:50:27,2024-10-24 16:50:28,Savings Vault topup,5.00,0.00,EUR,COMPLETED,5.00
Transfer,Deposit,2024-10-24 16:50:28,2024-10-24 16:50:28,Saving vault topup prefunding wallet,-5.00,0.00,EUR,COMPLETED,0.00
Transfer,Deposit,2024-10-24 16:54:09,2024-10-24 16:54:09,Savings Vault topup,1.75,0.00,EUR,COMPLETED,1.75
Transfer,Deposit,2024-10-24 16:54:09,2024-10-24 16:54:09,Saving vault topup prefunding wallet,-1.75,0.00,EUR,COMPLETED,0.00
Transfer,Deposit,2024-10-24 20:32:58,2024-10-24 20:32:58,Savings Vault topup,2.85,0.00,EUR,COMPLETED,2.85
Transfer,Deposit,2024-10-24 20:32:58,2024-10-24 20:32:58,Saving vault topup prefunding wallet,-2.85,0.00,EUR,COMPLETED,0.00
Transfer,Deposit,2024-10-25 15:36:13,2024-10-25 15:36:13,Savings Vault topup,2.50,0.00,EUR,COMPLETED,2.50
Transfer,Deposit,2024-10-25 15:36:13,2024-10-25 15:36:13,Saving vault topup prefunding wallet,-2.50,0.00,EUR,COMPLETED,0.00
Transfer,Deposit,2024-10-25 21:31:03,2024-10-25 21:31:03,Savings Vault topup,5.00,0.00,EUR,COMPLETED,5.00
Transfer,Deposit,2024-10-25 21:31:03,2024-10-25 21:31:03,Saving vault topup prefunding wallet,-5.00,0.00,EUR,COMPLETED,0.00
Transfer,Deposit,2024-10-26 15:41:13,2024-10-26 15:41:13,Savings Vault topup,1.75,0.00,EUR,COMPLETED,1.75
Transfer,Deposit,2024-10-26 15:41:13,2024-10-26 15:41:13,Saving vault topup prefunding wallet,-1.75,0.00,EUR,COMPLETED,0.00
Transfer,Deposit,2024-10-26 15:46:38,2024-10-26 15:46:38,Savings Vault topup,4.50,0.00,EUR,COMPLETED,4.50
Transfer,Deposit,2024-10-26 15:46:38,2024-10-26 15:46:38,Saving vault topup prefunding wallet,-4.50,0.00,EUR,COMPLETED,0.00
Transfer,Deposit,2024-10-26 15:55:55,2024-10-26 15:55:55,Savings Vault topup,2.50,0.00,EUR,COMPLETED,2.50
Transfer,Deposit,2024-10-26 15:55:55,2024-10-26 15:55:55,Saving vault topup prefunding wallet,-2.50,0.00,EUR,COMPLETED,0.00
Transfer,Deposit,2024-10-26 18:41:10,2024-10-26 18:41:10,Savings Vault topup,1.90,0.00,EUR,COMPLETED,1.90
Transfer,Deposit,2024-10-26 18:41:10,2024-10-26 18:41:10,Saving vault topup prefunding wallet,-1.90,0.00,EUR,COMPLETED,0.00
Transfer,Deposit,2024-10-27 11:04:52,2024-10-27 11:04:52,Savings Vault topup,1.65,0.00,EUR,COMPLETED,1.65
Transfer,Deposit,2024-10-27 11:04:52,2024-10-27 11:04:52,Saving vault topup prefunding wallet,-1.65,0.00,EUR,COMPLETED,0.00
Transfer,Deposit,2024-10-27 13:33:59,2024-10-27 13:33:59,Savings Vault topup,4.75,0.00,EUR,COMPLETED,4.75
Transfer,Deposit,2024-10-27 13:33:59,2024-10-27 13:33:59,Saving vault topup prefunding wallet,-4.75,0.00,EUR,COMPLETED,0.00
Transfer,Deposit,2024-10-27 18:41:07,2024-10-27 18:41:07,Savings Vault topup,2.30,0.00,EUR,COMPLETED,2.30
Transfer,Deposit,2024-10-27 18:41:07,2024-10-27 18:41:07,Saving vault topup prefunding wallet,-2.30,0.00,EUR,COMPLETED,0.00
Transfer,Deposit,2024-10-28 14:30:17,2024-10-28 14:30:18,Savings Vault topup,1.40,0.00,EUR,COMPLETED,1.40
Transfer,Deposit,2024-10-28 14:30:18,2024-10-28 14:30:18,Saving vault topup prefunding wallet,-1.40,0.00,EUR,COMPLETED,0.00
Transfer,Deposit,2024-10-28 14:51:17,2024-10-28 14:51:17,Savings Vault topup,0.20,0.00,EUR,COMPLETED,0.20
Transfer,Deposit,2024-10-28 14:51:17,2024-10-28 14:51:17,Saving vault topup prefunding wallet,-0.20,0.00,EUR,COMPLETED,0.00
Transfer,Deposit,2025-01-26 10:54:33,2025-01-26 10:54:33,Savings vault withdrawal from prefunding wallet,21716.53,0.00,EUR,COMPLETED,21716.53
Transfer,Deposit,2025-01-26 10:54:33,2025-01-26 10:54:33,From Flexible Cash Funds,-21716.53,0.00,EUR,COMPLETED,0.00
Transfer,Deposit,2025-01-29 08:51:36,2025-01-29 08:51:36,Savings vault withdrawal from prefunding wallet,0.91,0.00,EUR,COMPLETED,0.91
Transfer,Deposit,2025-01-29 08:51:36,2025-01-29 08:51:36,From Flexible Cash Funds,-0.91,0.00,EUR,COMPLETED,0.00
Transfer,Deposit,2025-03-21 06:57:20,2025-03-21 06:57:20,Closing transaction,0.00,0.00,EUR,COMPLETED,0.00
Card Payment,Current,2023-12-26 20:50:33,2024-01-01 10:43:46,PaMcGrath's,-16.20,0.00,EUR,COMPLETED,791.49
Card Payment,Current,2023-12-30 17:17:59,2024-01-01 11:07:31,Dublin Airport Car Park,-3.00,0.00,EUR,COMPLETED,788.49
Card Payment,Current,2023-12-30 15:18:26,2024-01-01 11:09:21,Texaco,-3.30,0.00,EUR,COMPLETED,785.19
Card Payment,Current,2023-12-31 12:55:04,2024-01-01 11:13:05,SuperValu,-8.33,0.00,EUR,COMPLETED,776.86
Card Payment,Current,2023-12-30 19:26:05,2024-01-01 11:14:00,Spar,-7.04,0.00,EUR,COMPLETED,769.82
Card Payment,Current,2023-12-31 12:37:57,2024-01-01 14:14:17,Starbucks,-4.75,0.00,EUR,COMPLETED,765.07
Card Payment,Current,2023-12-31 12:28:34,2024-01-01 14:21:16,Lidl,-41.94,0.00,EUR,COMPLETED,723.13
Card Payment,Current,2023-12-31 19:15:12,2024-01-01 14:44:06,Fine Wines,-56.20,0.00,EUR,COMPLETED,666.93
Transfer,Current,2024-01-02 00:00:00,2024-01-02 11:48:07,To Flogas Natural Gas,-115.00,0.00,EUR,COMPLETED,551.93
Card Payment,Current,2024-01-01 07:24:14,2024-01-02 13:14:11,HP,-0.99,0.00,EUR,COMPLETED,550.94
Card Payment,Current,2024-01-02 19:59:10,2024-01-03 10:14:05,Spotify,-17.99,0.00,EUR,COMPLETED,532.95
Card Payment,Current,2024-01-02 17:21:25,2024-01-03 10:30:13,Tesco,-4.60,0.00,EUR,COMPLETED,528.35
Card Payment,Current,2024-01-02 17:36:33,2024-01-03 11:41:47,Lidl,-29.29,0.00,EUR,COMPLETED,499.06
Card Payment,Current,2024-01-02 12:00:22,2024-01-03 15:04:39,Amazon Prime,-10.40,0.00,EUR,COMPLETED,488.66
Card Payment,Current,2024-01-03 12:18:04,2024-01-04 09:09:44,OXMANTOWN,-4.20,0.00,EUR,COMPLETED,484.46
Transfer,Current,2024-01-04 11:00:16,2024-01-04 11:00:16,Transfer from MARA DI RAIMONDO,14.95,0.00,EUR,COMPLETED,499.41
Transfer,Current,2024-01-04 11:01:55,2024-01-04 11:01:56,Transfer from MARA DI RAIMONDO,57.50,0.00,EUR,COMPLETED,556.91
Transfer,Current,2024-01-04 11:02:01,2024-01-04 11:02:01,Transfer from MARA DI RAIMONDO,45.00,0.00,EUR,COMPLETED,601.91
Card Payment,Current,2024-01-03 12:07:07,2024-01-04 13:02:09,Boojum,-10.15,0.00,EUR,COMPLETED,591.76
Card Payment,Current,2024-01-03 07:01:37,2024-01-04 13:04:24,Transport for Ireland - TFI,-50.00,0.00,EUR,COMPLETED,541.76
Topup,Current,2024-01-04 16:25:21,2024-01-04 16:25:21,Payment from C. QUISH,1500.00,0.00,EUR,COMPLETED,2041.76
Transfer,Current,2024-01-04 19:17:03,2024-01-04 19:17:03,Transfer to MARA DI RAIMONDO,-7.27,0.00,EUR,COMPLETED,2034.49
Transfer,Current,2024-01-04 19:17:11,2024-01-04 19:17:11,Transfer to MARA DI RAIMONDO,-6.00,0.00,EUR,COMPLETED,2028.49
Card Payment,Current,2024-01-04 09:36:21,2024-01-05 02:11:13,YouTube,-0.98,0.00,EUR,COMPLETED,2027.51
Transfer,Current,2024-01-04 16:26:37,2024-01-05 06:34:54,To Colm Quish,-1425.95,0.00,EUR,COMPLETED,601.56
Card Payment,Current,2024-01-04 02:52:24,2024-01-05 09:36:17,Apple,-2.99,0.00,EUR,COMPLETED,598.57
Card Payment,Current,2024-01-04 12:35:53,2024-01-05 12:35:39,Centra,-5.00,0.00,EUR,COMPLETED,593.57
Card Payment,Current,2024-01-04 09:03:48,2024-01-05 13:08:56,Butler's Chocolate Masters,-4.70,0.00,EUR,COMPLETED,588.87
Transfer,Current,2024-01-05 13:25:36,2024-01-05 13:25:36,Transfer from MARA DI RAIMONDO,200.00,0.00,EUR,COMPLETED,788.87
Card Payment,Current,2024-01-05 13:59:59,2024-01-06 11:49:38,Wise,-10.05,0.00,EUR,COMPLETED,778.82
Card Payment,Current,2024-01-05 19:30:47,2024-01-06 12:43:00,Tesco,-7.50,0.00,EUR,COMPLETED,771.32
Card Payment,Current,2024-01-05 08:57:24,2024-01-06 13:05:52,SuperValu,-18.64,0.00,EUR,COMPLETED,752.68
Transfer,Current,2024-01-06 21:00:27,2024-01-06 21:00:27,Transfer from MARA DI RAIMONDO,35.09,0.00,EUR,COMPLETED,787.77
Card Payment,Current,2024-01-06 13:32:35,2024-01-07 08:44:17,PlayStation,-59.99,0.00,EUR,COMPLETED,727.78
Card Payment,Current,2024-01-06 11:39:48,2024-01-07 11:24:06,SuperValu,-16.98,0.00,EUR,COMPLETED,710.80
Card Payment,Current,2024-01-06 20:02:06,2024-01-07 11:41:20,Zakura,-70.18,0.00,EUR,COMPLETED,640.62
Card Payment,Current,2024-01-06 18:37:33,2024-01-07 11:54:30,Boots,-23.48,0.00,EUR,COMPLETED,617.14
Card Payment,Current,2024-01-06 16:15:30,2024-01-07 15:19:42,Splice,-9.01,0.09,EUR,COMPLETED,608.04
Card Payment,Current,2024-01-06 11:09:20,2024-01-07 15:48:50,Hatch Coffee,-21.00,0.00,EUR,COMPLETED,587.04
Card Payment,Current,2024-01-06 18:44:33,2024-01-08 10:35:19,Easytrip,-10.00,0.00,EUR,COMPLETED,577.04
Card Payment,Current,2024-01-07 15:41:32,2024-01-08 10:50:38,Butlers Chocolates,-4.70,0.00,EUR,COMPLETED,572.34
Card Payment,Current,2024-01-07 14:55:58,2024-01-08 10:51:16,Camile Thai,-22.18,0.00,EUR,COMPLETED,550.16
Card Payment,Current,2024-01-07 15:36:26,2024-01-08 12:10:36,ALDI,-21.59,0.00,EUR,COMPLETED,528.57
Card Payment,Current,2024-01-07 02:22:42,2024-01-08 12:18:30,FLYEfit,-38.00,0.00,EUR,COMPLETED,490.57
Transfer,Current,2024-01-08 15:20:49,2024-01-08 15:20:49,Transfer to MARA DI RAIMONDO,-69.49,0.00,EUR,COMPLETED,421.08
Transfer,Current,2024-01-08 15:20:52,2024-01-08 15:20:52,Transfer to MARA DI RAIMONDO,-42.88,0.00,EUR,COMPLETED,378.20
Transfer,Current,2024-01-09 11:53:59,2024-01-09 11:54:00,Transfer to MARA DI RAIMONDO,-2.82,0.00,EUR,COMPLETED,375.38
Card Payment,Current,2024-01-08 09:54:18,2024-01-09 15:33:26,Amazon,-53.63,0.00,EUR,COMPLETED,321.75
Card Payment,Current,2024-01-09 08:11:39,2024-01-10 12:00:09,Light House Cinema,-32.00,0.00,EUR,COMPLETED,289.75
Card Payment,Current,2024-01-09 08:33:35,2024-01-10 13:31:59,Butlers Chocolates,-4.70,0.00,EUR,COMPLETED,285.05
Transfer,Current,2024-01-10 18:57:42,2024-01-10 18:57:42,Transfer to MARA DI RAIMONDO,-10.57,0.00,EUR,COMPLETED,274.48
Transfer,Current,2024-01-10 18:57:44,2024-01-10 18:57:45,Transfer to MARA DI RAIMONDO,-3.17,0.00,EUR,COMPLETED,271.31
Exchange,Current,2024-01-11 08:28:05,2024-01-11 08:28:05,Exchanged to EUR,263.36,0.00,EUR,COMPLETED,534.67
Card Payment,Current,2024-01-10 08:49:23,2024-01-11 09:59:57,OXMANTOWN,-4.20,0.00,EUR,COMPLETED,530.47
Transfer,Current,2024-01-11 00:00:00,2024-01-11 11:42:31,To Virgin Media Ireland Limited,-60.00,0.00,EUR,COMPLETED,470.47
Transfer,Current,2024-01-11 18:00:39,2024-01-11 18:00:40,Transfer to MARA DI RAIMONDO,-0.75,0.00,EUR,COMPLETED,469.72
Transfer,Current,2024-01-11 19:08:36,2024-01-11 19:08:36,Transfer from MARA DI RAIMONDO,12.90,0.00,EUR,COMPLETED,482.62
Card Payment,Current,2024-01-10 16:48:22,2024-01-11 21:03:25,Boojum,-12.25,0.00,EUR,COMPLETED,470.37
Card Payment,Current,2024-01-10 17:57:38,2024-01-11 21:16:09,Cut and Sew,-32.00,0.00,EUR,COMPLETED,438.37
Card Payment,Current,2024-01-11 16:43:15,2024-01-12 11:22:17,Apple,-19.99,0.00,EUR,COMPLETED,418.38
Card Payment,Current,2024-01-11 19:07:12,2024-01-12 15:02:48,Xian Street Food,-27.70,0.00,EUR,COMPLETED,390.68
Card Payment,Current,2024-01-11 17:53:25,2024-01-12 18:20:59,Cotswold outdoor,-90.00,0.00,EUR,COMPLETED,300.68
Transfer,Current,2024-01-12 20:35:37,2024-01-12 20:35:37,To pocket EUR Rainy day from EUR,-5.00,0.00,EUR,COMPLETED,295.68
Transfer,Current,2024-01-12 20:54:56,2024-01-12 20:54:56,To pocket EUR Rainy day from EUR,-4.30,0.00,EUR,COMPLETED,291.38
Card Payment,Current,2024-01-11 08:27:19,2024-01-12 21:11:28,Butlers Chocolates,-4.70,0.00,EUR,COMPLETED,286.68
Transfer,Current,2024-01-13 10:30:53,2024-01-13 10:30:53,To pocket EUR Rainy day from EUR,-0.75,0.00,EUR,COMPLETED,285.93
Transfer,Current,2024-01-13 11:03:10,2024-01-13 11:03:10,To pocket EUR Rainy day from EUR,-4.00,0.00,EUR,COMPLETED,281.93
Transfer,Current,2024-01-13 16:10:16,2024-01-13 16:10:16,To pocket EUR Rainy day from EUR,-2.75,0.00,EUR,COMPLETED,279.18
Transfer,Current,2024-01-13 16:38:49,2024-01-13 16:38:49,To pocket EUR Rainy day from EUR,-1.50,0.00,EUR,COMPLETED,277.68
Card Payment,Current,2024-01-12 20:35:37,2024-01-13 22:19:38,Little Forest,-70.00,0.00,EUR,COMPLETED,207.68
Transfer,Current,2024-01-14 11:26:48,2024-01-14 11:26:48,To pocket EUR Rainy day from EUR,-0.35,0.00,EUR,COMPLETED,207.33
Transfer,Current,2024-01-14 13:53:33,2024-01-14 13:53:33,To pocket EUR Rainy day from EUR,-5.00,0.00,EUR,COMPLETED,202.33
Transfer,Current,2024-01-14 14:18:00,2024-01-14 14:18:00,To pocket EUR Rainy day from EUR,-4.30,0.00,EUR,COMPLETED,198.03
Transfer,Current,2024-01-14 14:40:14,2024-01-14 14:40:14,Transfer from MARA DI RAIMONDO,5.57,0.00,EUR,COMPLETED,203.60
Transfer,Current,2024-01-14 14:41:32,2024-01-14 14:41:32,To pocket EUR Rainy day from EUR,-3.00,0.00,EUR,COMPLETED,200.60
Transfer,Current,2024-01-15 10:56:03,2024-01-15 10:56:03,To pocket EUR Rainy day from EUR,-2.50,0.00,EUR,COMPLETED,198.10
Card Payment,Current,2024-01-12 20:54:55,2024-01-15 11:14:37,GoMo,-10.14,0.00,EUR,COMPLETED,187.96
Card Payment,Current,2024-01-13 10:30:53,2024-01-15 16:43:17,Hatch Coffee,-26.85,0.00,EUR,COMPLETED,161.11
Transfer,Current,2024-01-15 22:15:43,2024-01-15 22:15:43,To pocket EUR Rainy day from EUR,-2.20,0.00,EUR,COMPLETED,158.91
Card Payment,Current,2024-01-13 16:10:16,2024-01-15 23:41:16,Avoca,-25.45,0.00,EUR,COMPLETED,133.46
Card Payment,Current,2024-01-13 16:38:48,2024-01-15 23:41:16,Avoca,-8.70,0.00,EUR,COMPLETED,124.76
Card Payment,Current,2024-01-14 11:26:48,2024-01-16 00:25:29,SuperValu,-17.93,0.00,EUR,COMPLETED,106.83
Card Payment,Current,2024-01-14 14:41:32,2024-01-16 00:26:32,Butlers Chocolates,-9.40,0.00,EUR,COMPLETED,97.43
Card Payment,Current,2024-01-13 11:03:10,2024-01-16 00:53:00,SuperValu,-10.20,0.00,EUR,COMPLETED,87.23
Card Payment,Current,2024-01-14 14:18:00,2024-01-16 01:19:46,Donnybrook Fair,-11.14,0.00,EUR,COMPLETED,76.09
Card Payment,Current,2024-01-14 13:53:33,2024-01-16 01:35:56,The Health Store,-15.00,0.00,EUR,COMPLETED,61.09
Card Payment,Current,2024-01-15 22:15:42,2024-01-16 12:29:03,Amazon,-10.56,0.00,EUR,COMPLETED,50.53
Card Payment,Current,2024-01-15 10:56:03,2024-01-16 12:50:29,WHSmith,-2.50,0.00,EUR,COMPLETED,48.03
Topup,Current,2024-01-18 07:16:33,2024-01-18 07:16:34,Payment from C. QUISH,1500.00,0.00,EUR,COMPLETED,1548.03
Transfer,Current,2024-01-18 07:20:51,2024-01-18 08:55:18,To Trading 212 UK Limited,-10.00,0.00,EUR,COMPLETED,1538.03
Transfer,Current,2024-01-18 14:28:22,2024-01-18 15:07:50,Transfer from MARA DI RAIMONDO,4.70,0.00,EUR,COMPLETED,1542.73
Transfer,Current,2024-01-19 06:39:27,2024-01-19 06:39:28,Transfer to MARA DI RAIMONDO,-1.62,0.00,EUR,COMPLETED,1541.11
Transfer,Current,2024-01-19 08:17:05,2024-01-19 09:43:25,To Trading 212 UK Limited,-1000.00,0.00,EUR,COMPLETED,541.11
Card Payment,Current,2024-01-19 12:45:09,,Parking Payments,-1.40,0.00,EUR,REVERTED,
Transfer,Current,2024-01-19 12:45:09,2024-01-19 12:45:09,To pocket EUR Rainy day from EUR,-3.00,0.00,EUR,COMPLETED,538.11
Transfer,Current,2024-01-19 13:48:50,2024-01-19 13:48:50,To pocket EUR Rainy day from EUR,-3.75,0.00,EUR,COMPLETED,534.36
Transfer,Current,2024-01-19 18:05:44,2024-01-19 18:05:44,To pocket EUR Rainy day from EUR,-2.35,0.00,EUR,COMPLETED,532.01
Transfer,Current,2024-01-19 22:46:13,2024-01-19 22:46:13,To pocket EUR Rainy day from EUR,-4.25,0.00,EUR,COMPLETED,527.76
Transfer,Current,2024-01-20 10:55:45,2024-01-20 10:55:45,To pocket EUR Rainy day from EUR,-5.00,0.00,EUR,COMPLETED,522.76
Card Payment,Current,2024-01-19 13:48:50,2024-01-20 11:13:31,Brownes of Sandymount,-41.25,0.00,EUR,COMPLETED,481.51
Transfer,Current,2024-01-20 12:03:16,2024-01-20 12:03:16,To pocket EUR Rainy day from EUR,-4.25,0.00,EUR,COMPLETED,477.26
Card Payment,Current,2024-01-19 18:05:43,2024-01-20 12:12:28,Lidl,-23.53,0.00,EUR,COMPLETED,453.73
Transfer,Current,2024-01-20 12:34:31,2024-01-20 12:34:31,To pocket EUR Rainy day from EUR,-1.40,0.00,EUR,COMPLETED,452.33
Card Payment,Current,2024-01-19 22:46:12,2024-01-20 14:07:52,Amazon,-12.15,0.12,EUR,COMPLETED,440.06
Transfer,Current,2024-01-20 20:30:43,2024-01-20 20:30:43,Transfer from MARA DI RAIMONDO,5.00,0.00,EUR,COMPLETED,445.06
Transfer,Current,2024-01-20 20:31:01,2024-01-20 20:31:02,Transfer from MARA DI RAIMONDO,20.62,0.00,EUR,COMPLETED,465.68
Card Payment,Current,2024-01-20 12:03:15,2024-01-21 09:09:37,Hatch Coffee,-13.15,0.00,EUR,COMPLETED,452.53
Card Payment,Current,2024-01-20 10:55:45,2024-01-21 09:10:55,Hatch Coffee,-8.00,0.00,EUR,COMPLETED,444.53
Card Payment,Current,2024-01-20 12:34:31,2024-01-21 09:18:16,Centra,-9.72,0.00,EUR,COMPLETED,434.81
Transfer,Current,2024-01-21 14:30:15,2024-01-21 14:30:15,To pocket EUR Rainy day from EUR,-3.75,0.00,EUR,COMPLETED,431.06
Transfer,Current,2024-01-21 14:49:43,2024-01-21 14:49:43,To pocket EUR Rainy day from EUR,-5.00,0.00,EUR,COMPLETED,426.06
Transfer,Current,2024-01-21 15:51:39,2024-01-21 15:51:39,To pocket EUR Rainy day from EUR,-4.50,0.00,EUR,COMPLETED,421.56
Card Payment,Current,2024-01-21 14:30:15,2024-01-22 10:24:05,Wagamama,-43.25,0.00,EUR,COMPLETED,378.31
Card Payment,Current,2024-01-21 14:49:42,2024-01-22 10:52:19,Easytrip,-10.00,0.00,EUR,COMPLETED,368.31
Card Payment,Current,2024-01-21 15:51:39,2024-01-22 14:35:23,ALDI,-32.10,0.00,EUR,COMPLETED,336.21
Transfer,Current,2024-01-22 16:35:15,2024-01-22 16:35:15,Transfer from MARA DI RAIMONDO,3.00,0.00,EUR,COMPLETED,339.21
Transfer,Current,2024-01-22 21:47:43,2024-01-22 21:47:43,To pocket EUR Rainy day from EUR,-5.00,0.00,EUR,COMPLETED,334.21
Transfer,Current,2024-01-23 08:46:08,2024-01-23 08:46:08,To pocket EUR Rainy day from EUR,-1.50,0.00,EUR,COMPLETED,332.71
Card Payment,Current,2024-01-22 21:47:43,2024-01-23 14:07:37,Amazon,-2.00,0.00,EUR,COMPLETED,330.71
Transfer,Current,2024-01-23 19:52:35,2024-01-23 19:52:35,To pocket EUR Rainy day from EUR,-4.00,0.00,EUR,COMPLETED,326.71
Card Payment,Current,2024-01-23 19:52:35,2024-01-24 11:49:41,Harbour Master,-14.20,0.00,EUR,COMPLETED,312.51
Card Payment,Current,2024-01-23 08:46:07,2024-01-24 11:51:41,Butlers Chocolates,-4.70,0.00,EUR,COMPLETED,307.81
Transfer,Current,2024-01-24 00:00:00,2024-01-24 12:02:40,To eFlow,-12.13,0.00,EUR,COMPLETED,295.68
Transfer,Current,2024-01-24 18:22:30,2024-01-24 18:22:30,To pocket EUR Rainy day from EUR,-5.00,0.00,EUR,COMPLETED,290.68
Transfer,Current,2024-01-24 19:14:22,2024-01-24 19:14:22,Transfer to MARA DI RAIMONDO,-4.70,0.00,EUR,COMPLETED,285.98
Transfer,Current,2024-01-24 19:15:07,2024-01-24 19:15:07,Transfer to Cian Garrett Mc Fadden,-112.15,0.00,EUR,COMPLETED,173.83
Topup,Current,2024-01-25 07:38:55,2024-01-25 07:38:55,Payment from WORKDAY LIMITED,2780.61,0.00,EUR,COMPLETED,2954.44
Transfer,Current,2024-01-25 08:41:12,2024-01-25 08:41:12,To pocket EUR Rainy day from EUR,-5.00,0.00,EUR,COMPLETED,2949.44
Transfer,Current,2024-01-25 08:03:24,2024-01-25 09:25:32,To Colm Quish,-980.90,0.00,EUR,COMPLETED,1968.54
Transfer,Current,2024-01-25 09:48:51,2024-01-25 09:48:51,Transfer from MARA DI RAIMONDO,19.00,0.00,EUR,COMPLETED,1987.54
Transfer,Current,2024-01-25 09:50:18,2024-01-25 09:50:18,Transfer from MARA DI RAIMONDO,450.00,0.00,EUR,COMPLETED,2437.54
Card Payment,Current,2024-01-24 18:22:29,2024-01-25 10:40:08,Payzone,-10.00,0.00,EUR,COMPLETED,2427.54
Transfer,Current,2024-01-25 00:00:00,2024-01-25 12:32:33,To Royal London,-16.72,0.00,EUR,COMPLETED,2410.82
Transfer,Current,2024-01-25 15:36:36,2024-01-25 15:36:36,Transfer to MARA DI RAIMONDO,-6.54,0.00,EUR,COMPLETED,2404.28
Transfer,Current,2024-01-25 15:36:37,2024-01-25 15:36:38,Transfer to MARA DI RAIMONDO,-9.00,0.00,EUR,COMPLETED,2395.28
Transfer,Current,2024-01-25 19:45:49,2024-01-25 19:45:49,To pocket EUR Rainy day from EUR,-3.55,0.00,EUR,COMPLETED,2391.73
Transfer,Current,2024-01-26 08:08:01,2024-01-26 08:08:01,To pocket EUR Rainy day from EUR,-1.50,0.00,EUR,COMPLETED,2390.23
Transfer,Current,2024-01-26 07:16:49,2024-01-26 08:14:16,To Finance Ireland,-1424.50,0.00,EUR,COMPLETED,965.73
Card Payment,Current,2024-01-25 19:45:48,2024-01-26 10:05:59,Deliveroo,-37.29,0.00,EUR,COMPLETED,928.44
Transfer,Current,2024-01-26 10:13:00,2024-01-26 10:13:00,To pocket EUR Subscriptions from EUR,-500.00,0.00,EUR,COMPLETED,428.44
Card Payment,Current,2024-01-25 08:41:12,2024-01-26 11:39:47,Kaldi's Coffee,-4.00,0.00,EUR,COMPLETED,424.44
Transfer,Current,2024-01-26 13:49:45,2024-01-26 13:49:45,To investment account,-50.00,0.00,EUR,COMPLETED,374.44
Topup,Current,2024-01-26 13:49:51,2024-01-26 13:49:51,From investment account,50.00,0.00,EUR,COMPLETED,424.44
Transfer,Current,2024-01-26 14:03:46,2024-01-26 14:03:46,To pocket EUR Rainy day from EUR,-5.00,0.00,EUR,COMPLETED,419.44
Transfer,Current,2024-01-26 16:31:11,2024-01-26 16:31:11,To pocket EUR Rainy day from EUR,-0.10,0.00,EUR,COMPLETED,419.34
Transfer,Current,2024-01-26 18:10:44,2024-01-26 18:10:44,Pocket Withdrawal,230.00,0.00,EUR,COMPLETED,649.34
Transfer,Current,2024-01-26 20:13:28,2024-01-26 20:13:28,To pocket EUR Rainy day from EUR,-5.00,0.00,EUR,COMPLETED,644.34
Card Payment,Current,2024-01-26 14:03:45,2024-01-27 10:18:22,Centra,-5.00,0.00,EUR,COMPLETED,639.34
Transfer,Current,2024-01-27 10:22:02,2024-01-27 10:22:02,To pocket EUR Rainy day from EUR,-5.00,0.00,EUR,COMPLETED,634.34
Transfer,Current,2024-01-27 15:25:40,2024-01-27 15:25:40,To pocket EUR Rainy day from EUR,-0.30,0.00,EUR,COMPLETED,634.04
Transfer,Current,2024-01-27 15:26:26,2024-01-27 15:26:26,To pocket EUR Rainy day from EUR,-5.00,0.00,EUR,COMPLETED,629.04
Card Payment,Current,2024-01-26 08:08:00,2024-01-27 15:43:06,Butlers Chocolates,-4.70,0.00,EUR,COMPLETED,624.34
Transfer,Current,2024-01-27 16:04:47,2024-01-27 16:04:47,Transfer to MARA DI RAIMONDO,-10.93,0.00,EUR,COMPLETED,613.41
Transfer,Current,2024-01-27 17:25:34,2024-01-27 17:25:34,To pocket EUR Rainy day from EUR,-3.75,0.00,EUR,COMPLETED,609.66
Transfer,Current,2024-01-27 19:29:38,2024-01-27 19:29:38,To pocket EUR Rainy day from EUR,-0.05,0.00,EUR,COMPLETED,609.61
Card Payment,Current,2024-01-27 19:29:38,2024-01-28 09:39:36,Deliveroo,-76.99,0.00,EUR,COMPLETED,532.62
Transfer,Current,2024-01-28 09:42:26,2024-01-28 09:42:26,To pocket EUR Rainy day from EUR,-4.00,0.00,EUR,COMPLETED,528.62
Card Payment,Current,2024-01-27 10:22:02,2024-01-28 09:59:47,Ring Of Kerry Cycle,-104.00,0.00,EUR,COMPLETED,424.62
Transfer,Current,2024-01-28 10:18:01,2024-01-28 10:18:01,To pocket EUR Rainy day from EUR,-5.00,0.00,EUR,COMPLETED,419.62
Card Payment,Current,2024-01-26 20:13:28,2024-01-28 11:29:01,The Blackrock Irish Pub,-70.00,0.00,EUR,COMPLETED,349.62
Card Payment,Current,2024-01-26 16:31:10,2024-01-28 13:29:53,Amazon,-17.98,0.00,EUR,COMPLETED,331.64
Transfer,Current,2024-01-28 14:35:31,2024-01-28 14:35:31,To pocket EUR Rainy day from EUR,-5.00,0.00,EUR,COMPLETED,326.64
Transfer,Current,2024-01-28 15:23:13,2024-01-28 15:23:13,To pocket EUR Rainy day from EUR,-2.35,0.00,EUR,COMPLETED,324.29
Card Payment,Current,2024-01-28 14:35:31,2024-01-29 10:15:35,Hatch Coffee,-13.00,0.00,EUR,COMPLETED,311.29
Card Payment,Current,2024-01-28 15:23:13,2024-01-29 10:50:16,ALDI,-24.53,0.00,EUR,COMPLETED,286.76
Card Payment,Current,2024-01-28 10:18:00,2024-01-29 10:58:55,Applegreen,-12.00,0.00,EUR,COMPLETED,274.76
Transfer,Current,2024-01-29 11:18:06,2024-01-29 11:18:06,Transfer from MARA DI RAIMONDO,28.00,0.00,EUR,COMPLETED,302.76
Transfer,Current,2024-01-29 11:18:11,2024-01-29 11:18:15,Transfer from MARA DI RAIMONDO,30.00,0.00,EUR,COMPLETED,332.76
Transfer,Current,2024-01-29 11:18:16,2024-01-29 11:18:16,Transfer from MARA DI RAIMONDO,18.64,0.00,EUR,COMPLETED,351.40
Card Payment,Current,2024-01-28 09:42:26,2024-01-29 11:39:14,Mechanic On Duty,-3.20,0.00,EUR,COMPLETED,348.20
Card Payment,Current,2024-01-27 15:25:40,2024-01-29 12:19:28,SuperValu,-29.94,0.00,EUR,COMPLETED,318.26
Card Payment,Current,2024-01-27 15:26:26,2024-01-29 12:25:50,Xl,-4.00,0.00,EUR,COMPLETED,314.26
Transfer,Current,2024-01-29 22:09:28,2024-01-29 22:09:28,To pocket EUR Rainy day from EUR,-0.50,0.00,EUR,COMPLETED,313.76
Transfer,Current,2024-01-30 08:11:34,2024-01-30 08:11:34,To pocket EUR Rainy day from EUR,-1.50,0.00,EUR,COMPLETED,312.26
Card Payment,Current,2024-01-27 17:25:34,2024-01-30 11:22:12,Ryanair,-158.25,0.00,EUR,COMPLETED,154.01
Card Payment,Current,2024-01-29 22:09:28,2024-01-30 11:33:26,ODEON,-29.90,0.00,EUR,COMPLETED,124.11
Transfer,Current,2024-01-30 12:43:16,2024-01-30 12:43:17,Transfer from MARA DI RAIMONDO,14.95,0.00,EUR,COMPLETED,139.06
Transfer,Current,2024-01-30 14:36:27,2024-01-30 14:36:27,To pocket EUR Rainy day from EUR,-1.50,0.00,EUR,COMPLETED,137.56
Transfer,Current,2024-01-30 20:18:33,2024-01-30 20:18:33,To pocket EUR Rainy day from EUR,-4.00,0.00,EUR,COMPLETED,133.56
Transfer,Current,2024-01-31 07:57:28,2024-01-31 07:57:28,To pocket EUR Rainy day from EUR,-0.05,0.00,EUR,COMPLETED,133.51
Transfer,Current,2024-01-31 07:57:38,2024-01-31 07:57:38,Transfer to MARA DI RAIMONDO,-5.83,0.00,EUR,COMPLETED,127.68
Card Payment,Current,2024-01-30 20:18:33,2024-01-31 10:34:03,ODEON,-10.20,0.00,EUR,COMPLETED,117.48
Card Payment,Current,2024-01-30 14:36:26,2024-01-31 10:52:37,OXMANTOWN,-7.70,0.00,EUR,COMPLETED,109.78
Card Payment,Current,2024-01-30 08:11:34,2024-01-31 11:03:47,Butlers Chocolates,-4.70,0.00,EUR,COMPLETED,105.08
Transfer,Current,2024-01-31 12:31:42,2024-01-31 12:31:42,To pocket EUR Rainy day from EUR,-5.00,0.00,EUR,COMPLETED,100.08
Transfer,Current,2024-01-31 15:00:01,2024-01-31 15:00:01,To pocket EUR Rainy day from EUR,-5.00,0.00,EUR,COMPLETED,95.08
Transfer,Current,2024-01-31 18:00:13,2024-01-31 18:00:13,To pocket EUR Rainy day from EUR,-1.00,0.00,EUR,COMPLETED,94.08
Transfer,Current,2024-01-31 20:24:19,2024-01-31 20:24:19,Transfer to MARA DI RAIMONDO,-2.19,0.00,EUR,COMPLETED,91.89
Transfer,Current,2024-01-31 20:24:29,2024-01-31 20:24:29,Pocket Withdrawal,50.00,0.00,EUR,COMPLETED,141.89
Topup,Current,2024-02-01 09:51:27,2024-02-01 09:51:28,Payment from C. QUISH,50049.57,0.00,EUR,COMPLETED,50191.46
Card Payment,Current,2024-01-31 12:31:42,2024-02-01 09:55:43,Centra,-5.00,0.00,EUR,COMPLETED,50186.46
Card Payment,Current,2024-01-31 07:57:27,2024-02-01 10:53:18,nuud,-13.99,0.00,EUR,COMPLETED,50172.47
Transfer,Current,2024-02-01 09:58:23,2024-02-01 11:08:20,To Trading 212 UK Limited,-10000.00,0.00,EUR,COMPLETED,40172.47
Transfer,Current,2024-02-01 11:53:42,2024-02-01 11:53:42,To pocket EUR Rainy day from EUR,-4.80,0.00,EUR,COMPLETED,40167.67
Transfer,Current,2024-02-01 11:54:45,2024-02-01 11:54:45,Pocket Withdrawal,100.00,0.00,EUR,COMPLETED,40267.67
Transfer,Current,2024-02-01 12:01:34,2024-02-01 12:01:34,To pocket EUR Rainy day from EUR,-2.80,0.00,EUR,COMPLETED,40264.87
Transfer,Current,2024-02-01 11:55:25,2024-02-01 13:11:57,To Trading 212 UK Limited,-39866.00,0.00,EUR,COMPLETED,398.87
Transfer,Current,2024-02-01 18:43:47,2024-02-01 18:43:47,To pocket EUR Rainy day from EUR,-3.95,0.00,EUR,COMPLETED,394.92
Transfer,Current,2024-02-01 18:53:04,2024-02-01 18:53:04,To pocket EUR Rainy day from EUR,-4.50,0.00,EUR,COMPLETED,390.42
Transfer,Current,2024-02-01 15:47:24,2024-02-02 06:41:55,To Payward Ltd.,-1.00,0.00,EUR,COMPLETED,389.42
Card Payment,Current,2024-02-01 18:43:47,2024-02-02 10:18:28,SuperValu,-16.21,0.00,EUR,COMPLETED,373.21
Card Payment,Current,2024-02-01 18:53:04,2024-02-02 11:06:29,Subway,-8.10,0.00,EUR,COMPLETED,365.11
Transfer,Current,2024-02-02 11:14:22,2024-02-02 11:14:22,To pocket EUR Rainy day from EUR,-2.20,0.00,EUR,COMPLETED,362.91
Card Payment,Current,2024-01-31 15:00:01,2024-02-02 12:52:24,NUIG Students' Union Shop,-14.00,0.00,EUR,COMPLETED,348.91
Card Payment,Current,2024-01-31 18:00:13,2024-02-02 12:56:39,The Cobblestone,-11.80,0.00,EUR,COMPLETED,337.11
Card Payment,Current,2024-02-01 11:53:42,2024-02-02 13:46:30,Premier Inn,-275.04,0.00,EUR,COMPLETED,62.07
Card Payment,Current,2024-02-01 12:01:34,2024-02-02 16:17:56,Manchester United,-23.44,0.00,EUR,COMPLETED,38.63
Transfer,Current,2024-02-02 19:57:36,2024-02-02 19:57:36,To pocket EUR Rainy day from EUR,-2.90,0.00,EUR,COMPLETED,35.73
Transfer,Current,2024-02-03 09:47:59,2024-02-03 09:47:59,Pocket Withdrawal,28.00,0.00,EUR,COMPLETED,63.73
Transfer,Current,2024-02-03 09:53:58,2024-02-03 09:53:58,To pocket EUR Rainy day from EUR,-2.00,0.00,EUR,COMPLETED,61.73
Card Payment,Current,2024-02-02 19:57:36,2024-02-03 11:15:10,Lidl,-24.42,0.00,EUR,COMPLETED,37.31
Card Payment,Current,2024-02-02 11:14:22,2024-02-03 15:03:13,Amazon Prime,-10.56,0.00,EUR,COMPLETED,26.75
Transfer,Current,2024-02-04 02:52:25,2024-02-04 02:52:25,To pocket EUR Rainy day from EUR,-0.05,0.00,EUR,COMPLETED,26.70
Transfer,Current,2024-02-04 09:24:29,2024-02-04 09:24:29,To pocket EUR Rainy day from EUR,-4.50,0.00,EUR,COMPLETED,22.20
Transfer,Current,2024-02-04 09:36:22,2024-02-04 09:36:22,To pocket EUR Rainy day from EUR,-0.05,0.00,EUR,COMPLETED,22.15
Card Payment,Current,2024-02-03 09:53:58,2024-02-04 10:38:18,Hatch Coffee,-4.60,0.00,EUR,COMPLETED,17.55
Transfer,Current,2024-02-04 17:20:16,2024-02-04 17:20:16,Transfer from MARA DI RAIMONDO,57.50,0.00,EUR,COMPLETED,75.05
Transfer,Current,2024-02-04 17:20:22,2024-02-04 17:20:22,Transfer from MARA DI RAIMONDO,45.00,0.00,EUR,COMPLETED,120.05
Transfer,Current,2024-02-04 17:20:47,2024-02-04 17:20:47,To pocket EUR Rainy day from EUR,-2.60,0.00,EUR,COMPLETED,117.45
Transfer,Current,2024-02-04 17:20:51,2024-02-04 17:20:52,Transfer from MARA DI RAIMONDO,20.48,0.00,EUR,COMPLETED,137.93
Card Payment,Current,2024-02-04 09:36:22,2024-02-05 02:44:03,YouTube,-0.98,0.01,EUR,COMPLETED,136.94
Card Payment,Current,2024-02-04 17:20:47,2024-02-05 10:26:46,Deliveroo,-20.48,0.00,EUR,COMPLETED,116.46
Card Payment,Current,2024-02-04 02:52:25,2024-02-05 10:55:38,Apple,-2.99,0.00,EUR,COMPLETED,113.47
Card Payment,Current,2024-02-04 09:24:29,2024-02-05 11:30:53,Applegreen,-7.10,0.00,EUR,COMPLETED,106.37
Transfer,Current,2024-02-05 13:52:33,2024-02-05 13:52:33,To pocket EUR Rainy day from EUR,-2.85,0.00,EUR,COMPLETED,103.52
Transfer,Current,2024-02-05 14:03:38,2024-02-05 14:03:38,To pocket EUR Rainy day from EUR,-2.00,0.00,EUR,COMPLETED,101.52
Transfer,Current,2024-02-05 22:03:05,2024-02-05 22:03:05,To pocket EUR Rainy day from EUR,-0.05,0.00,EUR,COMPLETED,101.47
Topup,Current,2024-02-06 06:55:26,2024-02-06 06:55:27,Payment from TRADING 212 UK LIMITED T/AS TRADING 212,250.00,0.00,EUR,COMPLETED,351.47
Card Payment,Current,2024-02-05 13:52:33,2024-02-06 10:01:15,Lidl,-35.43,0.00,EUR,COMPLETED,316.04
Card Payment,Current,2024-02-05 14:03:38,2024-02-06 12:31:47,Tesco,-4.60,0.00,EUR,COMPLETED,311.44
Card Payment,Current,2024-02-05 22:03:05,2024-02-06 14:54:50,Amazon,-6.99,0.00,EUR,COMPLETED,304.45
Transfer,Current,2024-02-06 16:16:32,2024-02-06 16:16:32,To pocket EUR Rainy day from EUR,-4.15,0.00,EUR,COMPLETED,300.30
Transfer,Current,2024-02-06 17:06:16,2024-02-06 17:06:16,Transfer from STEPHEN LEDDIN,137.52,0.00,EUR,COMPLETED,437.82
Transfer,Current,2024-02-06 20:59:36,2024-02-06 20:59:36,To pocket EUR Rainy day from EUR,-5.00,0.00,EUR,COMPLETED,432.82
Transfer,Current,2024-02-07 11:06:02,2024-02-07 11:06:02,To pocket EUR Rainy day from EUR,-2.00,0.00,EUR,COMPLETED,430.82
Card Payment,Current,2024-02-06 20:59:36,2024-02-07 12:20:38,Easytrip,-10.00,0.00,EUR,COMPLETED,420.82
Card Payment,Current,2024-02-06 16:16:32,2024-02-07 14:10:21,Splice,-9.17,0.00,EUR,COMPLETED,411.65
Transfer,Current,2024-02-07 15:01:58,2024-02-07 15:01:58,To pocket EUR Rainy day from EUR,-5.00,0.00,EUR,COMPLETED,406.65
Transfer,Current,2024-02-07 17:11:22,2024-02-07 17:11:22,To pocket EUR Rainy day from EUR,-4.95,0.00,EUR,COMPLETED,401.70
Transfer,Current,2024-02-07 18:07:03,2024-02-07 18:07:03,Transfer to MARA DI RAIMONDO,-12.10,0.00,EUR,COMPLETED,389.60
Card Payment,Current,2024-02-07 15:01:58,2024-02-08 11:01:35,Dún Laoghaire-Rathdown City Council,-40.00,0.00,EUR,COMPLETED,349.60
Card Payment,Current,2024-02-07 11:06:02,2024-02-08 11:20:02,Hatch Coffee,-4.60,0.00,EUR,COMPLETED,345.00
Card Payment,Current,2024-02-07 17:11:22,2024-02-08 14:31:14,Amazon,-118.01,0.00,EUR,COMPLETED,226.99
Transfer,Current,2024-02-09 08:21:27,2024-02-09 08:21:27,To pocket EUR Rainy day from EUR,-2.00,0.00,EUR,COMPLETED,224.99
Transfer,Current,2024-02-09 08:33:18,2024-02-09 08:33:18,To pocket EUR Rainy day from EUR,-3.60,0.00,EUR,COMPLETED,221.39
Transfer,Current,2024-02-10 10:05:28,2024-02-10 10:05:28,To pocket EUR Rainy day from EUR,-4.30,0.00,EUR,COMPLETED,217.09
Transfer,Current,2024-02-10 11:06:24,2024-02-10 11:06:24,To pocket EUR Rainy day from EUR,-4.50,0.00,EUR,COMPLETED,212.59
Transfer,Current,2024-02-10 11:22:50,2024-02-10 11:22:51,Transfer to BRYAN DALTON,-5.00,0.00,EUR,COMPLETED,207.59
Card Payment,Current,2024-02-09 08:33:18,2024-02-10 12:03:27,SuperValu,-21.28,0.00,EUR,COMPLETED,186.31
Transfer,Current,2024-02-10 15:21:20,2024-02-10 15:21:20,To pocket EUR Rainy day from EUR,-1.75,0.00,EUR,COMPLETED,184.56
Card Payment,Current,2024-02-09 08:21:27,2024-02-10 15:24:31,Hatch Coffee,-4.60,0.00,EUR,COMPLETED,179.96
Transfer,Current,2024-02-11 03:19:03,2024-02-11 03:19:03,To pocket EUR Rainy day from EUR,-0.55,0.00,EUR,COMPLETED,179.41
Transfer,Current,2024-02-11 08:45:22,2024-02-11 08:45:22,To pocket EUR Rainy day from EUR,-0.05,0.00,EUR,COMPLETED,179.36
Transfer,Current,2024-02-11 09:05:17,2024-02-11 09:05:17,To pocket EUR Rainy day from EUR,-4.90,0.00,EUR,COMPLETED,174.46
Card Payment,Current,2024-02-10 15:21:19,2024-02-11 09:47:44,Deliveroo,-12.65,0.00,EUR,COMPLETED,161.81
Card Payment,Current,2024-02-10 11:06:24,2024-02-11 11:17:00,Tesco,-32.10,0.00,EUR,COMPLETED,129.71
Card Payment,Current,2024-02-10 10:05:28,2024-02-11 11:58:23,Douglas & Kaldi,-25.14,0.00,EUR,COMPLETED,104.57
Transfer,Current,2024-02-11 18:35:17,2024-02-11 18:35:17,Pocket Withdrawal,56.00,0.00,EUR,COMPLETED,160.57
Card Payment,Current,2024-02-11 03:19:03,2024-02-12 08:24:00,FREE NOW,-14.60,0.00,EUR,COMPLETED,145.97
Card Payment,Current,2024-02-11 09:05:16,2024-02-12 08:38:36,Uber Eats,-13.02,0.00,EUR,COMPLETED,132.95
Transfer,Current,2024-02-12 00:00:00,2024-02-12 11:44:49,To Virgin Media Ireland Limited,-60.00,0.00,EUR,COMPLETED,72.95
Card Payment,Current,2024-02-11 08:45:22,2024-02-12 12:04:48,Apple,-19.99,0.00,EUR,COMPLETED,52.96
Transfer,Current,2024-02-13 00:37:12,2024-02-13 00:37:12,To pocket EUR Rainy day from EUR,-3.90,0.00,EUR,COMPLETED,49.06
Topup,Current,2024-02-14 06:49:22,2024-02-14 06:49:22,Payment from TRADING 212 UK LIMITED T/AS TRADING 212,500.00,0.00,EUR,COMPLETED,549.06
Card Payment,Current,2024-02-13 00:37:12,2024-02-14 11:04:45,GoMo,-10.22,0.00,EUR,COMPLETED,538.84
Transfer,Current,2024-02-14 11:57:10,2024-02-14 11:57:10,To pocket EUR Rainy day from EUR,-3.50,0.00,EUR,COMPLETED,535.34
Card Payment,Current,2024-02-14 07:17:12,2024-02-15 11:48:48,Transport for Ireland - TFI,-40.00,0.00,EUR,COMPLETED,495.34
Transfer,Current,2024-02-15 13:42:45,2024-02-15 13:42:45,Transfer to MARA DI RAIMONDO,-28.98,0.00,EUR,COMPLETED,466.36
Card Payment,Current,2024-02-14 11:57:09,2024-02-15 15:31:41,Market Pharmacy Smithfield,-6.30,0.00,EUR,COMPLETED,460.06
Transfer,Current,2024-02-15 19:41:54,2024-02-15 19:41:54,To pocket EUR Rainy day from EUR,-5.00,0.00,EUR,COMPLETED,455.06
Card Payment,Current,2024-02-15 19:41:53,2024-02-16 11:50:05,Aircoach,-10.00,0.00,EUR,COMPLETED,445.06
Transfer,Current,2024-02-16 13:55:49,2024-02-16 13:55:49,To pocket EUR Rainy day from EUR,-1.50,0.00,EUR,COMPLETED,443.56
Transfer,Current,2024-02-16 14:39:56,2024-02-16 14:39:56,To pocket EUR Rainy day from EUR,-0.25,0.00,EUR,COMPLETED,443.31
Transfer,Current,2024-02-16 19:07:38,2024-02-16 19:07:38,To pocket EUR Rainy day from EUR,-2.75,0.00,EUR,COMPLETED,440.56
Transfer,Current,2024-02-16 19:25:19,2024-02-16 19:25:19,To pocket EUR Rainy day from EUR,-0.50,0.00,EUR,COMPLETED,440.06
Transfer,Current,2024-02-16 20:53:31,2024-02-16 20:53:31,To pocket EUR Rainy day from EUR,-2.75,0.00,EUR,COMPLETED,437.31
Transfer,Current,2024-02-16 23:32:13,2024-02-16 23:32:13,To pocket EUR Rainy day from EUR,-3.20,0.00,EUR,COMPLETED,434.11
Transfer,Current,2024-02-17 00:51:56,2024-02-17 00:51:56,To pocket EUR Rainy day from EUR,-2.75,0.00,EUR,COMPLETED,431.36
Transfer,Current,2024-02-17 02:44:10,2024-02-17 02:44:10,To pocket EUR Rainy day from EUR,-3.30,0.00,EUR,COMPLETED,428.06
Transfer,Current,2024-02-17 03:53:30,2024-02-17 03:53:30,To pocket EUR Rainy day from EUR,-2.80,0.00,EUR,COMPLETED,425.26
Card Payment,Current,2024-02-16 13:55:49,2024-02-17 10:36:53,Dublin Airport,-12.70,0.00,EUR,COMPLETED,412.56
Transfer,Current,2024-02-17 12:46:11,2024-02-17 12:46:11,To pocket EUR Rainy day from EUR,-1.00,0.00,EUR,COMPLETED,411.56
Transfer,Current,2024-02-17 13:05:15,2024-02-17 13:05:15,To pocket EUR Rainy day from EUR,-2.65,0.00,EUR,COMPLETED,408.91
Card Payment,Current,2024-02-16 14:39:56,2024-02-17 13:36:35,KSG Catering,-11.95,0.00,EUR,COMPLETED,396.96
Transfer,Current,2024-02-17 15:31:35,2024-02-17 15:31:35,To pocket EUR Rainy day from EUR,-1.00,0.00,EUR,COMPLETED,395.96
Card Payment,Current,2024-02-16 23:32:12,2024-02-17 15:55:20,Central Bar,-7.36,0.07,EUR,COMPLETED,388.53
Card Payment,Current,2024-02-17 00:51:56,2024-02-17 15:55:20,Central Bar,-5.45,0.05,EUR,COMPLETED,383.03
Transfer,Current,2024-02-17 16:38:08,2024-02-17 16:38:08,To pocket EUR Rainy day from EUR,-0.45,0.00,EUR,COMPLETED,382.58
Card Payment,Current,2024-02-16 19:25:18,2024-02-17 16:48:48,Scarlets Regional,-12.90,0.00,EUR,COMPLETED,369.68
Card Payment,Current,2024-02-16 19:07:37,2024-02-17 16:56:29,Scarlets Regio,-6.45,0.00,EUR,COMPLETED,363.23
Card Payment,Current,2024-02-16 20:53:31,2024-02-17 16:56:32,Scarlets Regio,-6.45,0.00,EUR,COMPLETED,356.78
Transfer,Current,2024-02-17 17:13:41,2024-02-17 17:13:41,To pocket EUR Rainy day from EUR,-1.95,0.00,EUR,COMPLETED,354.83
Transfer,Current,2024-02-17 17:36:01,2024-02-17 17:36:01,To pocket EUR Rainy day from EUR,-2.25,0.00,EUR,COMPLETED,352.58
Transfer,Current,2024-02-17 18:22:31,2024-02-17 18:22:31,To pocket EUR Rainy day from EUR,-4.20,0.00,EUR,COMPLETED,348.38
Transfer,Current,2024-02-17 21:23:31,2024-02-17 21:23:31,Transfer to JAN ULRICH LUNDE,-60.00,0.00,EUR,COMPLETED,288.38
Transfer,Current,2024-02-17 21:50:05,2024-02-17 21:50:05,To pocket EUR Rainy day from EUR,-0.70,0.00,EUR,COMPLETED,287.68
Transfer,Current,2024-02-17 21:52:53,2024-02-17 21:52:53,To pocket EUR Rainy day from EUR,-0.95,0.00,EUR,COMPLETED,286.73
Transfer,Current,2024-02-17 23:00:10,2024-02-17 23:00:10,To pocket EUR Rainy day from EUR,-1.40,0.00,EUR,COMPLETED,285.33
Transfer,Current,2024-02-17 23:48:24,2024-02-17 23:48:24,To pocket EUR Rainy day from EUR,-0.20,0.00,EUR,COMPLETED,285.13
Transfer,Current,2024-02-18 14:22:08,2024-02-18 14:22:08,Transfer from JOHN DANIEL KIELY,10.00,0.00,EUR,COMPLETED,295.13
Card Payment,Current,2024-02-17 02:44:10,2024-02-18 14:25:59,The Live Lounge,-47.34,0.47,EUR,COMPLETED,247.32
Transfer,Current,2024-02-18 14:33:26,2024-02-18 14:33:26,To pocket EUR Rainy day from EUR,-2.45,0.00,EUR,COMPLETED,244.87
Card Payment,Current,2024-02-17 17:36:01,2024-02-18 15:01:22,Ashbeltd,-10.55,0.11,EUR,COMPLETED,234.21
Card Payment,Current,2024-02-17 12:46:11,2024-02-18 15:17:38,Bigmoose Coffee Compan,-22.80,0.23,EUR,COMPLETED,211.18
Card Payment,Current,2024-02-17 15:31:35,2024-02-18 15:21:41,Nq64 Cardiff,-21.80,0.22,EUR,COMPLETED,189.16
Card Payment,Current,2024-02-17 16:38:07,2024-02-18 15:21:48,Nq64 Cardiff,-23.91,0.24,EUR,COMPLETED,165.01
Card Payment,Current,2024-02-17 23:48:24,2024-02-18 15:21:53,Cambrian Tap,-11.96,0.12,EUR,COMPLETED,152.93
Card Payment,Current,2024-02-17 23:00:10,2024-02-18 15:21:53,Cambrian Tap,-11.72,0.12,EUR,COMPLETED,141.09
Card Payment,Current,2024-02-17 17:13:41,2024-02-18 15:22:54,Coyote Ugly Saloon Cardif,-9.61,0.10,EUR,COMPLETED,131.38
Card Payment,Current,2024-02-17 18:22:31,2024-02-18 15:24:03,Cardiff Blues,-35.16,0.35,EUR,COMPLETED,95.87
Card Payment,Current,2024-02-17 21:52:52,2024-02-18 15:24:52,The Philharmonic,-34.81,0.35,EUR,COMPLETED,60.71
Card Payment,Current,2024-02-17 21:50:05,2024-02-18 15:24:52,The Philharmonic,-5.86,0.06,EUR,COMPLETED,54.79
Card Payment,Current,2024-02-17 13:05:15,2024-02-18 15:29:02,Owain Glyndwr,-15.47,0.15,EUR,COMPLETED,39.17
Card Payment,Current,2024-02-17 03:53:30,2024-02-18 15:30:30,McDonald's,-6.44,0.06,EUR,COMPLETED,32.67
Transfer,Current,2024-02-19 08:16:38,2024-02-19 08:16:38,Pocket Withdrawal,52.00,0.00,EUR,COMPLETED,84.67
Transfer,Current,2024-02-19 08:28:41,2024-02-19 08:28:41,To pocket EUR Rainy day from EUR,-1.50,0.00,EUR,COMPLETED,83.17
Card Payment,Current,2024-02-18 00:38:09,2024-02-19 15:17:29,SantaMaria DnB Bar,-22.27,0.22,EUR,COMPLETED,60.68
Transfer,Current,2024-02-19 15:55:16,2024-02-19 15:55:16,To pocket EUR Rainy day from EUR,-1.25,0.00,EUR,COMPLETED,59.43
Card Payment,Current,2024-02-18 14:33:25,2024-02-19 15:55:39,WHSmith,-3.51,0.04,EUR,COMPLETED,55.88
Transfer,Current,2024-02-19 16:05:38,2024-02-19 16:05:38,To pocket EUR Rainy day from EUR,-1.30,0.00,EUR,COMPLETED,54.58
Transfer,Current,2024-02-20 09:01:08,2024-02-20 09:01:08,To pocket EUR Rainy day from EUR,-1.50,0.00,EUR,COMPLETED,53.08
Card Payment,Current,2024-02-19 16:05:38,2024-02-20 10:07:10,Dunnes Stores,-4.74,0.00,EUR,COMPLETED,48.34
Card Payment,Current,2024-02-19 15:55:16,2024-02-20 14:39:16,Boojum,-8.75,0.00,EUR,COMPLETED,39.59
Card Payment,Current,2024-02-19 08:28:41,2024-02-20 14:41:01,Butlers Chocolates,-4.70,0.00,EUR,COMPLETED,34.89
Card Payment,Current,2024-02-20 09:01:08,2024-02-21 11:01:02,Copper + Straw,-4.70,0.00,EUR,COMPLETED,30.19
Transfer,Current,2024-02-21 21:18:22,2024-02-21 21:18:23,Transfer from MARA DI RAIMONDO,28.79,0.00,EUR,COMPLETED,58.98
Transfer,Current,2024-02-21 21:18:27,2024-02-21 21:18:27,Transfer from MARA DI RAIMONDO,124.50,0.00,EUR,COMPLETED,183.48
Transfer,Current,2024-02-21 21:18:32,2024-02-21 21:18:32,Transfer from MARA DI RAIMONDO,277.00,0.00,EUR,COMPLETED,460.48
Transfer,Current,2024-02-21 21:18:37,2024-02-21 21:18:37,Transfer from MARA DI RAIMONDO,67.50,0.00,EUR,COMPLETED,527.98
Card Payment,Current,2024-02-21 09:11:30,2024-02-22 11:38:06,SuperValu,-28.32,0.00,EUR,COMPLETED,499.66
Transfer,Current,2024-02-22 00:00:00,2024-02-22 11:45:27,To eFlow,-9.43,0.00,EUR,COMPLETED,490.23
Topup,Current,2024-02-23 06:41:47,2024-02-23 06:41:47,Payment from WORKDAY LIMITED,2804.55,0.00,EUR,COMPLETED,3294.78
Transfer,Current,2024-02-23 08:13:29,2024-02-23 08:13:29,To pocket EUR Rainy day from EUR,-1.50,0.00,EUR,COMPLETED,3293.28
Transfer,Current,2024-02-23 07:42:09,2024-02-23 09:04:31,To Colm Quish,-1377.74,0.00,EUR,COMPLETED,1915.54
Transfer,Current,2024-02-23 16:07:16,2024-02-23 16:07:16,To pocket EUR Rainy day from EUR,-2.90,0.00,EUR,COMPLETED,1912.64
Transfer,Current,2024-02-23 17:01:23,2024-02-23 17:01:23,To pocket EUR Rainy day from EUR,-5.00,0.00,EUR,COMPLETED,1907.64
Transfer,Current,2024-02-23 18:56:31,2024-02-23 18:56:31,To pocket EUR Rainy day from EUR,-1.00,0.00,EUR,COMPLETED,1906.64
Transfer,Current,2024-02-23 19:48:05,2024-02-23 19:48:05,To pocket EUR Rainy day from EUR,-5.00,0.00,EUR,COMPLETED,1901.64
Card Payment,Current,2024-02-23 17:01:23,2024-02-24 09:13:06,Cut and Sew,-32.00,0.00,EUR,COMPLETED,1869.64
Transfer,Current,2024-02-24 11:02:16,2024-02-24 11:02:16,To pocket EUR Rainy day from EUR,-5.00,0.00,EUR,COMPLETED,1864.64
Card Payment,Current,2024-02-23 19:48:05,2024-02-24 11:47:17,Centra,-12.00,0.00,EUR,COMPLETED,1852.64
Card Payment,Current,2024-02-23 16:07:16,2024-02-24 11:50:33,Market Pharmacy Smithfield,-11.42,0.00,EUR,COMPLETED,1841.22
Card Payment,Current,2024-02-23 08:13:29,2024-02-24 12:39:51,Butlers Chocolates,-4.70,0.00,EUR,COMPLETED,1836.52
Transfer,Current,2024-02-24 14:23:41,2024-02-24 14:23:41,To pocket EUR Rainy day from EUR,-0.05,0.00,EUR,COMPLETED,1836.47
Transfer,Current,2024-02-25 00:14:10,2024-02-25 00:14:10,To pocket EUR Rainy day from EUR,-4.00,0.00,EUR,COMPLETED,1832.47
Transfer,Current,2024-02-25 08:15:23,2024-02-25 08:15:23,To pocket EUR Rainy day from EUR,-0.05,0.00,EUR,COMPLETED,1832.42
Card Payment,Current,2024-02-25 00:14:09,2024-02-25 10:10:31,SumUp,-24.20,0.00,EUR,COMPLETED,1808.22
Card Payment,Current,2024-02-24 14:23:41,2024-02-25 10:55:38,The Health Store,-1.99,0.00,EUR,COMPLETED,1806.23
Transfer,Current,2024-02-25 13:53:17,2024-02-25 13:53:17,To pocket EUR Rainy day from EUR,-2.50,0.00,EUR,COMPLETED,1803.73
Card Payment,Current,2024-02-23 18:56:31,2024-02-25 13:57:21,The Quays Bar,-21.80,0.00,EUR,COMPLETED,1781.93
Transfer,Current,2024-02-25 14:09:44,2024-02-25 14:09:44,To pocket EUR Rainy day from EUR,-0.05,0.00,EUR,COMPLETED,1781.88
Transfer,Current,2024-02-25 07:14:51,2024-02-26 06:46:07,To Finance Ireland,-1424.50,0.00,EUR,COMPLETED,357.38
Transfer,Current,2024-02-26 08:39:40,2024-02-26 08:39:40,To pocket EUR Rainy day from EUR,-1.50,0.00,EUR,COMPLETED,355.88
Card Payment,Current,2024-02-24 11:02:15,2024-02-26 08:54:51,Xl,-4.00,0.00,EUR,COMPLETED,351.88
Card Payment,Current,2024-02-25 14:09:44,2024-02-26 09:39:22,Trespass,-9.99,0.00,EUR,COMPLETED,341.89
Card Payment,Current,2024-02-25 13:53:16,2024-02-26 09:48:09,Dunnes Stores,-8.50,0.00,EUR,COMPLETED,333.39
Card Payment,Current,2024-02-25 08:15:23,2024-02-26 10:26:59,PlayStation,-39.99,0.00,EUR,COMPLETED,293.40
Transfer,Current,2024-02-26 00:00:00,2024-02-26 12:03:23,To Royal London,-16.72,0.00,EUR,COMPLETED,276.68
Transfer,Current,2024-02-26 13:07:49,2024-02-26 13:07:49,To pocket EUR Rainy day from EUR,-2.50,0.00,EUR,COMPLETED,274.18
Transfer,Current,2024-02-26 13:30:14,2024-02-26 13:30:14,Transfer from MARA DI RAIMONDO,450.00,0.00,EUR,COMPLETED,724.18
Transfer,Current,2024-02-26 14:36:48,2024-02-26 14:36:48,To pocket EUR Subscriptions from EUR,-400.00,0.00,EUR,COMPLETED,324.18
Transfer,Current,2024-02-26 17:19:58,2024-02-26 17:19:58,To pocket EUR Rainy day from EUR,-5.00,0.00,EUR,COMPLETED,319.18
Transfer,Current,2024-02-26 18:28:24,2024-02-26 18:28:24,To pocket EUR Rainy day from EUR,-1.50,0.00,EUR,COMPLETED,317.68
Card Payment,Current,2024-02-26 08:39:40,2024-02-27 08:19:11,Butlers Chocolates,-4.70,0.00,EUR,COMPLETED,312.98
Card Payment,Current,2024-02-26 17:19:57,2024-02-27 10:44:10,The Run Hub,-36.00,0.00,EUR,COMPLETED,276.98
Card Payment,Current,2024-02-26 13:07:49,2024-02-27 11:24:05,Centra,-5.50,0.00,EUR,COMPLETED,271.48
Card Payment,Current,2024-02-26 18:28:24,2024-02-27 11:26:28,ALDI,-24.70,0.00,EUR,COMPLETED,246.78
Topup,Current,2024-02-28 06:54:00,2024-02-28 06:54:00,Payment from TRADING 212 UK LIMITED T/AS TRADING 212,20000.00,0.00,EUR,COMPLETED,20246.78
Transfer,Current,2024-02-28 06:54:53,2024-02-28 06:54:53,Savings Vault topup,-20000.00,0.00,EUR,COMPLETED,246.78
Transfer,Current,2024-02-28 06:55:45,2024-02-28 06:55:45,Pocket Withdrawal,44.05,0.00,EUR,COMPLETED,290.83
Transfer,Current,2024-02-28 08:10:55,2024-02-28 08:10:55,Savings Vault topup,-4.05,0.00,EUR,COMPLETED,286.78
Transfer,Current,2024-02-28 08:18:53,2024-02-28 08:18:53,Savings Vault topup,-1.50,0.00,EUR,COMPLETED,285.28
Topup,Current,2024-02-28 12:41:50,2024-02-28 12:41:50,Payment from VHI CLAIMS,75.00,0.00,EUR,COMPLETED,360.28
Transfer,Current,2024-02-28 19:45:29,2024-02-28 19:45:29,Savings Vault topup,-0.75,0.00,EUR,COMPLETED,359.53
Transfer,Current,2024-02-29 08:56:52,2024-02-29 08:56:52,Savings Vault topup,-0.50,0.00,EUR,COMPLETED,359.03
Card Payment,Current,2024-02-28 19:45:29,2024-02-29 10:23:59,Deliveroo,-21.85,0.00,EUR,COMPLETED,337.18
Card Payment,Current,2024-02-28 08:18:53,2024-02-29 12:27:48,Butlers Chocolates,-4.70,0.00,EUR,COMPLETED,332.48
Transfer,Current,2024-02-29 14:34:58,2024-02-29 14:34:59,Transfer from MARA DI RAIMONDO,21.85,0.00,EUR,COMPLETED,354.33
Transfer,Current,2024-02-29 14:38:28,2024-02-29 14:38:29,Transfer from MARA DI RAIMONDO,45.00,0.00,EUR,COMPLETED,399.33
Transfer,Current,2024-02-29 20:03:44,2024-02-29 20:03:44,Savings Vault topup,-2.50,0.00,EUR,COMPLETED,396.83
Transfer,Current,2024-03-01 09:12:51,2024-03-01 09:12:51,Savings Vault topup,-1.50,0.00,EUR,COMPLETED,395.33
Transfer,Current,2024-03-01 10:24:13,2024-03-01 10:24:14,Transfer to MARA DI RAIMONDO,-3.49,0.00,EUR,COMPLETED,391.84
Transfer,Current,2024-03-01 10:24:15,2024-03-01 10:24:15,Transfer to MARA DI RAIMONDO,-1.49,0.00,EUR,COMPLETED,390.35
Transfer,Current,2024-03-01 10:24:17,2024-03-01 10:24:17,Transfer to MARA DI RAIMONDO,-5.74,0.00,EUR,COMPLETED,384.61
Transfer,Current,2024-03-01 10:24:19,2024-03-01 10:24:19,Transfer to MARA DI RAIMONDO,-10.50,0.00,EUR,COMPLETED,374.11
Card Payment,Current,2024-02-29 20:03:43,2024-03-01 11:05:30,Circle K Gas Station,-5.50,0.00,EUR,COMPLETED,368.61
Card Payment,Current,2024-02-29 08:56:52,2024-03-01 13:04:43,Tesco,-4.90,0.00,EUR,COMPLETED,363.71
Transfer,Current,2024-03-01 14:25:19,2024-03-01 14:25:20,Savings Vault topup,-2.15,0.00,EUR,COMPLETED,361.56
Card Payment,Current,2024-02-28 08:10:55,2024-03-01 15:20:04,Amazon,-8.19,0.00,EUR,COMPLETED,353.37
Transfer,Current,2024-03-01 18:02:32,2024-03-01 18:02:32,Savings Vault topup,-0.20,0.00,EUR,COMPLETED,353.17
Card Payment,Current,2024-03-01 18:02:31,2024-03-02 10:14:58,Camile Thai,-27.96,0.00,EUR,COMPLETED,325.21
Transfer,Current,2024-03-02 10:56:28,2024-03-02 10:56:29,Savings Vault topup,-3.50,0.00,EUR,COMPLETED,321.71
Transfer,Current,2024-03-02 11:17:46,2024-03-02 11:17:46,Savings Vault topup,-2.40,0.00,EUR,COMPLETED,319.31
Card Payment,Current,2024-03-01 09:12:51,2024-03-02 12:36:23,Copper + Straw,-4.70,0.00,EUR,COMPLETED,314.61
Card Payment,Current,2024-03-01 14:25:16,2024-03-02 12:51:12,Proper Order Coffee,-9.57,0.00,EUR,COMPLETED,305.04
Transfer,Current,2024-03-02 17:13:42,2024-03-02 17:13:42,Savings Vault topup,-5.00,0.00,EUR,COMPLETED,300.04
Transfer,Current,2024-03-02 17:39:57,2024-03-02 17:39:57,Savings Vault topup,-1.75,0.00,EUR,COMPLETED,298.29
Transfer,Current,2024-03-03 07:36:40,2024-03-03 07:36:40,Savings Vault topup,-2.55,0.00,EUR,COMPLETED,295.74
Transfer,Current,2024-03-03 09:38:11,2024-03-03 09:38:11,Savings Vault topup,-4.85,0.00,EUR,COMPLETED,290.89
Card Payment,Current,2024-03-02 10:56:28,2024-03-03 11:39:54,Happy Out,-29.30,0.00,EUR,COMPLETED,261.59
Card Payment,Current,2024-03-02 11:17:46,2024-03-03 15:08:39,Amazon Prime,-10.52,0.11,EUR,COMPLETED,250.96
Transfer,Current,2024-03-03 15:32:19,2024-03-03 15:32:19,Savings Vault topup,-0.60,0.00,EUR,COMPLETED,250.36
Transfer,Current,2024-03-03 17:50:15,2024-03-03 17:50:15,Savings Vault topup,-3.60,0.00,EUR,COMPLETED,246.76
Transfer,Current,2024-03-03 18:02:44,2024-03-03 18:02:44,Transfer from MARA DI RAIMONDO,35.44,0.00,EUR,COMPLETED,282.20
Transfer,Current,2024-03-03 18:02:49,2024-03-03 18:02:49,Transfer from MARA DI RAIMONDO,25.01,0.00,EUR,COMPLETED,307.21
Transfer,Current,2024-03-03 18:03:44,2024-03-03 18:03:44,Transfer from MARA DI RAIMONDO,11.96,0.00,EUR,COMPLETED,319.17
Transfer,Current,2024-03-03 18:03:49,2024-03-03 18:03:50,Transfer from MARA DI RAIMONDO,57.50,0.00,EUR,COMPLETED,376.67
Transfer,Current,2024-03-04 02:51:37,2024-03-04 02:51:37,Savings Vault topup,-0.05,0.00,EUR,COMPLETED,376.62
Card Payment,Current,2024-03-02 17:39:56,2024-03-04 09:24:14,SuperValu,-35.65,0.00,EUR,COMPLETED,340.97
Card Payment,Current,2024-03-03 15:32:19,2024-03-04 09:32:06,The Coach House,-70.88,0.00,EUR,COMPLETED,270.09
Transfer,Current,2024-03-04 09:36:21,2024-03-04 09:36:21,Savings Vault topup,-0.20,0.00,EUR,COMPLETED,269.89
Card Payment,Current,2024-03-03 07:36:40,2024-03-04 11:52:55,HP,-1.49,0.00,EUR,COMPLETED,268.40
Card Payment,Current,2024-03-03 17:50:14,2024-03-04 11:57:08,ALDI,-23.28,0.00,EUR,COMPLETED,245.12
Card Payment,Current,2024-03-03 09:38:11,2024-03-04 12:06:36,Applegreen,-50.03,0.00,EUR,COMPLETED,195.09
Card Payment,Current,2024-03-02 17:13:42,2024-03-04 12:21:24,The Merry Cobbler,-48.00,0.00,EUR,COMPLETED,147.09
Transfer,Current,2024-03-04 14:11:40,2024-03-04 14:11:41,Transfer from SOPHIE MARY QUISH,233.00,0.00,EUR,COMPLETED,380.09
Transfer,Current,2024-03-04 14:11:45,2024-03-04 14:11:46,Transfer from SOPHIE MARY QUISH,12.30,0.00,EUR,COMPLETED,392.39
Transfer,Current,2024-03-05 00:01:20,2024-03-05 00:01:20,Savings Vault topup,-0.25,0.00,EUR,COMPLETED,392.14
Card Payment,Current,2024-03-04 09:36:21,2024-03-05 03:09:40,YouTube,-0.96,0.00,EUR,COMPLETED,391.18
Transfer,Current,2024-03-05 07:51:07,2024-03-05 07:51:07,Savings Vault topup,-5.00,0.00,EUR,COMPLETED,386.18
Transfer,Current,2024-03-04 15:13:42,2024-03-05 07:56:34,To Colm Quish,-250.00,0.00,EUR,COMPLETED,136.18
Transfer,Current,2024-03-05 08:26:20,2024-03-05 08:26:21,Savings Vault topup,-5.00,0.00,EUR,COMPLETED,131.18
Card Payment,Current,2024-03-04 02:51:37,2024-03-05 12:39:34,Apple,-2.99,0.00,EUR,COMPLETED,128.19
Transfer,Current,2024-03-05 16:59:43,2024-03-05 16:59:43,Transfer from MARA DI RAIMONDO,2.00,0.00,EUR,COMPLETED,130.19
Transfer,Current,2024-03-05 16:59:48,2024-03-05 16:59:48,Transfer from MARA DI RAIMONDO,5.00,0.00,EUR,COMPLETED,135.19
Transfer,Current,2024-03-05 17:39:55,2024-03-05 17:39:55,Transfer to MARA DI RAIMONDO,-37.50,0.00,EUR,COMPLETED,97.69
Card Payment,Current,2024-03-05 00:01:20,2024-03-05 17:42:24,Amazon,-11.95,0.00,EUR,COMPLETED,85.74
Transfer,Current,2024-03-06 07:45:50,2024-03-06 07:45:51,Transfer to MARA DI RAIMONDO,-7.34,0.00,EUR,COMPLETED,78.40
Card Payment,Current,2024-03-05 08:26:20,2024-03-06 12:36:12,National Transport Authority,-10.00,0.00,EUR,COMPLETED,68.40
Card Payment,Current,2024-03-05 07:51:07,2024-03-06 12:37:10,Transport for Ireland - TFI,-10.00,0.00,EUR,COMPLETED,58.40
Transfer,Current,2024-03-06 18:17:08,2024-03-06 18:17:08,Savings Vault topup,-3.55,0.00,EUR,COMPLETED,54.85
Transfer,Current,2024-03-06 18:36:09,2024-03-06 18:36:09,Savings Vault topup,-4.50,0.00,EUR,COMPLETED,50.35
Transfer,Current,2024-03-07 08:05:21,2024-03-07 08:05:21,Transfer from ENDA CARROLL,14.30,0.00,EUR,COMPLETED,64.65
Card Payment,Current,2024-03-06 18:36:08,2024-03-07 12:50:23,Movies@,-40.10,0.00,EUR,COMPLETED,24.55
Card Payment,Current,2024-03-06 18:17:08,2024-03-07 12:55:30,SuperValu,-7.29,0.00,EUR,COMPLETED,17.26
Transfer,Current,2024-03-07 14:29:59,2024-03-07 14:29:59,Transfer from MARA DI RAIMONDO,14.30,0.00,EUR,COMPLETED,31.56
Transfer,Current,2024-03-07 23:32:29,2024-03-07 23:32:29,Savings Vault topup,-5.00,0.00,EUR,COMPLETED,26.56
Transfer,Current,2024-03-08 08:07:33,2024-03-08 08:07:33,Transfer to MARA DI RAIMONDO,-1.55,0.00,EUR,COMPLETED,25.01
Transfer,Current,2024-03-08 11:49:56,2024-03-08 11:49:56,From Flexible account,500.00,0.00,EUR,COMPLETED,525.01
Exchange,Current,2024-03-08 11:50:13,2024-03-08 11:50:13,Exchanged to GBP,-355.00,0.00,EUR,COMPLETED,170.01
Transfer,Current,2024-03-08 12:36:10,2024-03-08 12:36:10,Savings Vault topup,-5.00,0.00,EUR,COMPLETED,165.01
Transfer,Current,2024-03-08 13:24:12,2024-03-08 13:24:12,Savings Vault topup,-0.05,0.00,EUR,COMPLETED,164.96
Transfer,Current,2024-03-08 13:43:56,2024-03-08 13:43:56,Savings Vault topup,-5.00,0.00,EUR,COMPLETED,159.96
Exchange,Current,2024-03-08 16:14:54,2024-03-08 16:14:54,Exchanged to GBP,-59.00,0.00,EUR,COMPLETED,100.96
Transfer,Current,2024-03-08 16:42:45,2024-03-08 16:42:45,Savings Vault topup,-0.05,0.00,EUR,COMPLETED,100.91
Card Payment,Current,2024-03-08 13:43:56,2024-03-09 16:22:51,Xl,-18.00,0.00,EUR,COMPLETED,82.91
Card Payment,Current,2024-03-08 13:24:01,2024-03-09 17:23:05,Apple,-59.99,0.00,EUR,COMPLETED,22.92
Card Payment,Current,2024-03-08 12:36:09,2024-03-09 17:39:20,Aircoach,-10.00,0.00,EUR,COMPLETED,12.92
Card Payment,Current,2024-03-08 16:42:45,2024-03-09 17:55:18,Boots,-0.99,0.00,EUR,COMPLETED,11.93
Transfer,Current,2024-03-10 16:28:08,2024-03-10 16:28:08,From Flexible account,100.00,0.00,EUR,COMPLETED,111.93
Transfer,Current,2024-03-10 16:28:16,2024-03-10 16:28:16,Savings Vault topup,-2.60,0.00,EUR,COMPLETED,109.33
Transfer,Current,2024-03-11 07:43:26,2024-03-11 07:43:26,Savings Vault topup,-0.05,0.00,EUR,COMPLETED,109.28
Transfer,Current,2024-03-11 08:26:07,2024-03-11 08:26:07,Savings Vault topup,-1.85,0.00,EUR,COMPLETED,107.43
Card Payment,Current,2024-03-07 23:32:29,2024-03-11 10:50:24,Easytrip,-10.00,0.00,EUR,COMPLETED,97.43
Card Payment,Current,2024-03-10 16:28:15,2024-03-11 14:35:25,WHSmith,-6.48,0.06,EUR,COMPLETED,90.89
Transfer,Current,2024-03-12 08:13:28,2024-03-12 08:13:28,Savings Vault topup,-1.30,0.00,EUR,COMPLETED,89.59
Card Payment,Current,2024-03-11 08:26:07,2024-03-12 08:16:03,SuperValu,-19.63,0.00,EUR,COMPLETED,69.96
Transfer,Current,2024-03-12 11:38:30,2024-03-12 11:38:31,Transfer to MARA DI RAIMONDO,-5.31,0.00,EUR,COMPLETED,64.65
Transfer,Current,2024-03-12 11:38:32,2024-03-12 11:38:33,Transfer to MARA DI RAIMONDO,-5.24,0.00,EUR,COMPLETED,59.41
Transfer,Current,2024-03-12 11:38:34,2024-03-12 11:38:34,Transfer to MARA DI RAIMONDO,-5.00,0.00,EUR,COMPLETED,54.41
Card Payment,Current,2024-03-11 07:43:25,2024-03-12 16:50:43,Apple,-19.99,0.00,EUR,COMPLETED,34.42
Transfer,Current,2024-03-12 17:07:31,2024-03-12 17:07:31,Transfer to MARA DI RAIMONDO,-0.69,0.00,EUR,COMPLETED,33.73
Transfer,Current,2024-03-12 21:46:06,2024-03-12 21:46:06,Pocket Withdrawal,100.00,0.00,EUR,COMPLETED,133.73
Transfer,Current,2024-03-13 06:46:40,2024-03-13 06:46:40,Savings Vault topup,-5.00,0.00,EUR,COMPLETED,128.73
Card Payment,Current,2024-03-12 08:13:28,2024-03-13 10:11:51,Lidl,-26.74,0.00,EUR,COMPLETED,101.99
Transfer,Current,2024-03-13 00:00:00,2024-03-13 11:44:49,To Virgin Media Ireland Limited,-60.00,0.00,EUR,COMPLETED,41.99
Transfer,Current,2024-03-14 16:46:12,2024-03-14 16:46:12,From Flexible account,200.00,0.00,EUR,COMPLETED,241.99
Transfer,Current,2024-03-14 16:46:15,2024-03-14 16:46:15,Transfer to MARA DI RAIMONDO,-5.12,0.00,EUR,COMPLETED,236.87
Transfer,Current,2024-03-14 16:46:17,2024-03-14 16:46:17,Transfer to MARA DI RAIMONDO,-130.00,0.00,EUR,COMPLETED,106.87
Card Payment,Current,2024-03-13 06:46:40,2024-03-14 21:11:37,Transport for Ireland - TFI,-10.00,0.00,EUR,COMPLETED,96.87
Fee,Current,2024-03-15 01:48:24,2024-03-15 01:48:24,Premium plan fee,-90.00,0.00,EUR,COMPLETED,6.87
Transfer,Current,2024-03-15 06:10:07,2024-03-15 06:10:07,Pocket Withdrawal,30.00,0.00,EUR,COMPLETED,36.87
Transfer,Current,2024-03-15 06:10:18,2024-03-15 06:10:18,Savings Vault topup,-0.15,0.00,EUR,COMPLETED,36.72
Transfer,Current,2024-03-15 16:35:39,2024-03-15 16:35:39,Savings Vault topup,-4.25,0.00,EUR,COMPLETED,32.47
Card Payment,Current,2024-03-15 16:35:38,2024-03-16 09:51:53,Texaco,-5.15,0.00,EUR,COMPLETED,27.32
Transfer,Current,2024-03-16 10:13:40,2024-03-16 10:13:40,From Flexible account,100.00,0.00,EUR,COMPLETED,127.32
Transfer,Current,2024-03-16 10:18:38,2024-03-16 10:18:38,Transfer from MARA DI RAIMONDO,11.97,0.00,EUR,COMPLETED,139.29
Transfer,Current,2024-03-16 15:21:44,2024-03-16 15:21:44,Savings Vault topup,-5.00,0.00,EUR,COMPLETED,134.29
Card Payment,Current,2024-03-15 06:10:18,2024-03-16 17:10:41,Amazon,-11.97,0.00,EUR,COMPLETED,122.32
Transfer,Current,2024-03-17 08:30:33,2024-03-17 08:30:33,Savings Vault topup,-4.85,0.00,EUR,COMPLETED,117.47
Card Payment,Current,2024-03-16 10:13:29,2024-03-17 11:22:30,GoMo,-14.72,0.00,EUR,COMPLETED,102.75
Transfer,Current,2024-03-17 12:03:30,2024-03-17 12:03:30,From Flexible account,100.00,0.00,EUR,COMPLETED,202.75
Transfer,Current,2024-03-17 12:03:47,2024-03-17 12:03:47,Savings Vault topup,-4.50,0.00,EUR,COMPLETED,198.25
Card Payment,Current,2024-03-16 15:21:43,2024-03-17 15:32:44,Decathlon,-26.00,0.00,EUR,COMPLETED,172.25
Card Payment,Current,2024-03-17 12:03:47,2024-03-18 09:38:58,The Rock Shop,-25.10,0.00,EUR,COMPLETED,147.15
Topup,Current,2024-03-18 13:24:11,2024-03-18 13:24:11,Payment from PATRICIA        QUISH,100.00,0.00,EUR,COMPLETED,247.15
Transfer,Current,2024-03-18 13:50:52,2024-03-18 13:50:52,Savings Vault topup,-0.50,0.00,EUR,COMPLETED,246.65
Card Payment,Current,2024-03-17 08:30:32,2024-03-18 13:55:33,Circle K Gas Station,-60.03,0.00,EUR,COMPLETED,186.62
Transfer,Current,2024-03-18 14:09:47,2024-03-18 14:09:47,Transfer from MARA DI RAIMONDO,14.90,0.00,EUR,COMPLETED,201.52
Transfer,Current,2024-03-18 17:58:26,2024-03-18 17:58:26,Savings Vault topup,-1.75,0.00,EUR,COMPLETED,199.77
Transfer,Current,2024-03-18 18:20:07,2024-03-18 18:20:08,Transfer from MARA DI RAIMONDO,12.37,0.00,EUR,COMPLETED,212.14
Card Payment,Current,2024-03-18 17:58:25,2024-03-19 09:36:59,Lidl,-32.65,0.00,EUR,COMPLETED,179.49
Transfer,Current,2024-03-19 13:37:06,2024-03-19 13:37:06,Savings Vault topup,-5.00,0.00,EUR,COMPLETED,174.49
Card Payment,Current,2024-03-18 13:50:52,2024-03-19 14:54:07,SuperValu,-25.90,0.00,EUR,COMPLETED,148.59
Transfer,Current,2024-03-19 17:02:28,2024-03-19 17:02:29,Savings Vault topup,-0.05,0.00,EUR,COMPLETED,148.54
Card Payment,Current,2024-03-20 07:26:00,,FREE NOW,-22.15,0.00,EUR,REVERTED,
Transfer,Current,2024-03-20 07:26:00,2024-03-20 07:26:00,Savings Vault topup,-4.25,0.00,EUR,COMPLETED,144.29
Transfer,Current,2024-03-20 07:27:11,2024-03-20 07:27:11,Savings Vault topup,-1.45,0.00,EUR,COMPLETED,142.84
Card Payment,Current,2024-03-19 13:37:06,2024-03-20 08:23:42,National Transport Authority,-10.00,0.00,EUR,COMPLETED,132.84
Card Refund,Current,2024-03-20 00:00:00,2024-03-20 09:30:13,National Transport Authority,10.00,0.00,EUR,COMPLETED,142.84
Card Payment,Current,2024-03-19 17:02:28,2024-03-20 11:00:08,iConnect,-29.99,0.00,EUR,COMPLETED,112.85
Transfer,Current,2024-03-20 16:46:38,2024-03-20 16:46:38,Savings Vault topup,-2.50,0.00,EUR,COMPLETED,110.35
Transfer,Current,2024-03-20 18:13:27,2024-03-20 18:13:27,Transfer from MARA DI RAIMONDO,29.99,0.00,EUR,COMPLETED,140.34
Transfer,Current,2024-03-20 18:20:20,2024-03-20 18:20:20,Savings Vault topup,-3.30,0.00,EUR,COMPLETED,137.04
Card Payment,Current,2024-03-20 07:27:11,2024-03-21 09:45:54,FREE NOW,-25.00,0.00,EUR,COMPLETED,112.04
Card Payment,Current,2024-03-20 16:46:38,2024-03-21 10:18:53,Centra,-8.50,0.00,EUR,COMPLETED,103.54
Card Payment,Current,2024-03-20 18:20:20,2024-03-21 11:47:02,SuperValu,-17.34,0.00,EUR,COMPLETED,86.20
Transfer,Current,2024-03-21 12:41:34,2024-03-21 12:41:35,Transfer from MARA DI RAIMONDO,8.67,0.00,EUR,COMPLETED,94.87
Transfer,Current,2024-03-21 18:57:03,2024-03-21 18:57:03,Savings Vault topup,-2.50,0.00,EUR,COMPLETED,92.37
Transfer,Current,2024-03-21 20:58:19,2024-03-21 20:58:19,Transfer to MARA DI RAIMONDO,-8.49,0.00,EUR,COMPLETED,83.88
Card Payment,Current,2024-03-21 18:57:02,2024-03-22 09:13:39,APCOA Parking,-4.50,0.00,EUR,COMPLETED,79.38
Transfer,Current,2024-03-22 09:54:07,2024-03-22 09:54:07,Savings Vault topup,-5.00,0.00,EUR,COMPLETED,74.38
Transfer,Current,2024-03-22 00:00:00,2024-03-22 11:45:02,To eFlow,-10.63,0.00,EUR,COMPLETED,63.75
Transfer,Current,2024-03-22 14:46:43,2024-03-22 14:46:43,Savings Vault topup,-3.90,0.00,EUR,COMPLETED,59.85
Transfer,Current,2024-03-22 17:13:04,2024-03-22 17:13:04,From Flexible account,605.00,0.00,EUR,COMPLETED,664.85
Transfer,Current,2024-03-22 17:21:29,2024-03-22 17:21:30,Transfer from MARA DI RAIMONDO,306.00,0.00,EUR,COMPLETED,970.85
Transfer,Current,2024-03-22 17:49:04,2024-03-22 17:49:05,Transfer to MARA DI RAIMONDO,-20.98,0.00,EUR,COMPLETED,949.87
Transfer,Current,2024-03-23 11:00:39,2024-03-23 11:00:39,Savings Vault topup,-0.05,0.00,EUR,COMPLETED,949.82
Transfer,Current,2024-03-23 11:53:58,2024-03-23 11:53:59,Savings Vault topup,-4.25,0.00,EUR,COMPLETED,945.57
Card Payment,Current,2024-03-22 09:54:07,2024-03-23 12:00:32,Payzone,-10.00,0.00,EUR,COMPLETED,935.57
Transfer,Current,2024-03-23 13:26:19,2024-03-23 13:26:19,Savings Vault topup,-4.25,0.00,EUR,COMPLETED,931.32
Transfer,Current,2024-03-23 14:51:02,2024-03-23 14:51:02,Savings Vault topup,-2.50,0.00,EUR,COMPLETED,928.82
Transfer,Current,2024-03-23 14:59:49,2024-03-23 14:59:49,Savings Vault topup,-3.05,0.00,EUR,COMPLETED,925.77
Transfer,Current,2024-03-23 20:48:20,2024-03-23 20:48:20,Savings Vault topup,-1.75,0.00,EUR,COMPLETED,924.02
Transfer,Current,2024-03-23 20:53:44,2024-03-23 20:53:44,Savings Vault topup,-5.00,0.00,EUR,COMPLETED,919.02
Transfer,Current,2024-03-23 21:39:28,2024-03-23 21:39:29,Transfer to JOHN DANIEL KIELY,-40.00,0.00,EUR,COMPLETED,879.02
Card Payment,Current,2024-03-23 11:53:58,2024-03-24 08:43:35,Lidl,-24.15,0.00,EUR,COMPLETED,854.87
Card Payment,Current,2024-03-23 13:26:18,2024-03-24 09:21:32,Hatch Coffee,-72.15,0.00,EUR,COMPLETED,782.72
Card Payment,Current,2024-03-23 20:48:20,2024-03-24 09:59:14,Circle K Gas Station,-7.65,0.00,EUR,COMPLETED,775.07
Card Payment,Current,2024-03-23 11:00:39,2024-03-24 10:07:26,Apple,-13.99,0.00,EUR,COMPLETED,761.08
Card Payment,Current,2024-03-23 14:59:49,2024-03-24 10:13:11,SuperValu,-13.39,0.00,EUR,COMPLETED,747.69
Card Payment,Current,2024-03-23 14:51:02,2024-03-24 10:45:26,LloydsPharmacy,-16.50,0.00,EUR,COMPLETED,731.19
Card Payment,Current,2024-03-22 14:46:42,2024-03-24 12:52:05,Amazon,-14.22,0.00,EUR,COMPLETED,716.97
Transfer,Current,2024-03-24 15:36:03,2024-03-24 15:36:03,Transfer to MARGARET MARY BRENNAN,-55.00,0.00,EUR,COMPLETED,661.97
Transfer,Current,2024-03-24 15:38:35,2024-03-24 15:38:35,Transfer from MARA DI RAIMONDO,28.27,0.00,EUR,COMPLETED,690.24
Transfer,Current,2024-03-24 16:29:17,2024-03-24 16:29:17,Savings Vault topup,-4.90,0.00,EUR,COMPLETED,685.34
Transfer,Current,2024-03-24 16:43:20,2024-03-24 16:43:20,Transfer from MARA DI RAIMONDO,19.41,0.00,EUR,COMPLETED,704.75
Topup,Current,2024-03-25 07:20:19,2024-03-25 07:20:19,Payment from WORKDAY LIMITED,2804.55,0.00,EUR,COMPLETED,3509.30
Card Payment,Current,2024-03-23 20:53:44,2024-03-25 08:39:46,Transport for Ireland - TFI,-5.00,0.00,EUR,COMPLETED,3504.30
Transfer,Current,2024-03-25 07:40:44,2024-03-25 08:50:37,To Finance Ireland,-1424.50,0.00,EUR,COMPLETED,2079.80
Transfer,Current,2024-03-25 07:41:36,2024-03-25 08:50:52,To Colm Quish,-322.26,0.00,EUR,COMPLETED,1757.54
Card Payment,Current,2024-03-24 16:29:16,2024-03-25 09:28:26,SuperValu,-42.02,0.00,EUR,COMPLETED,1715.52
Transfer,Current,2024-03-25 10:13:19,2024-03-25 10:13:19,To pocket EUR Subscriptions from EUR,-350.00,0.00,EUR,COMPLETED,1365.52
Transfer,Current,2024-03-25 17:12:27,2024-03-25 17:12:27,Savings Vault topup,-2.65,0.00,EUR,COMPLETED,1362.87
Transfer,Current,2024-03-25 17:48:37,2024-03-25 17:48:37,Transfer from MARA DI RAIMONDO,0.50,0.00,EUR,COMPLETED,1363.37
Transfer,Current,2024-03-25 21:20:48,2024-03-25 21:20:48,Savings Vault topup,-0.05,0.00,EUR,COMPLETED,1363.32
Transfer,Current,2024-03-26 08:50:52,2024-03-26 08:50:53,Savings Vault topup,-4.00,0.00,EUR,COMPLETED,1359.32
Card Payment,Current,2024-03-25 21:20:48,2024-03-26 09:11:00,Apple,-5.99,0.00,EUR,COMPLETED,1353.33
Card Payment,Current,2024-03-25 17:12:26,2024-03-26 10:39:34,Market Pharmacy Smithfield,-53.47,0.00,EUR,COMPLETED,1299.86
Transfer,Current,2024-03-26 14:35:32,2024-03-26 14:35:33,Savings Vault topup,-5.00,0.00,EUR,COMPLETED,1294.86
Transfer,Current,2024-03-26 17:41:46,2024-03-26 17:41:46,Savings Vault topup,-5.00,0.00,EUR,COMPLETED,1289.86
Card Payment,Current,2024-03-26 17:41:46,2024-03-27 08:34:18,Cut and Sew,-32.00,0.00,EUR,COMPLETED,1257.86
Card Payment,Current,2024-03-26 08:50:52,2024-03-27 09:32:01,OXMANTOWN,-4.20,0.00,EUR,COMPLETED,1253.66
Card Payment,Current,2024-03-26 14:35:32,2024-03-27 09:36:45,Daybreak,-8.00,0.00,EUR,COMPLETED,1245.66
Transfer,Current,2024-03-27 19:37:32,2024-03-27 19:37:32,Transfer from CONNOR MATTHEW BYRNE,30.00,0.00,EUR,COMPLETED,1275.66
Transfer,Current,2024-03-27 19:37:41,2024-03-27 19:37:41,Savings Vault topup,-5.00,0.00,EUR,COMPLETED,1270.66
Transfer,Current,2024-03-27 20:15:31,2024-03-27 20:15:31,Savings Vault topup,-0.50,0.00,EUR,COMPLETED,1270.16
Transfer,Current,2024-03-27 21:14:45,2024-03-27 21:14:45,Savings Vault topup,-5.00,0.00,EUR,COMPLETED,1265.16
Transfer,Current,2024-03-28 08:32:01,2024-03-28 08:32:01,Savings Vault topup,-2.80,0.00,EUR,COMPLETED,1262.36
Card Payment,Current,2024-03-27 21:14:45,2024-03-28 08:46:59,Transport for Ireland - TFI,-20.00,0.00,EUR,COMPLETED,1242.36
Transfer,Current,2024-03-28 12:11:05,2024-03-28 12:11:06,Transfer from MARA DI RAIMONDO,450.00,0.00,EUR,COMPLETED,1692.36
Transfer,Current,2024-03-28 12:46:04,2024-03-28 12:46:04,Savings Vault topup,-750.00,0.00,EUR,COMPLETED,942.36
Transfer,Current,2024-03-28 19:06:31,2024-03-28 19:06:31,Savings Vault topup,-1.00,0.00,EUR,COMPLETED,941.36
Card Payment,Current,2024-03-28 08:32:01,2024-03-29 08:59:46,SuperValu,-9.44,0.00,EUR,COMPLETED,931.92
Card Payment,Current,2024-03-28 19:06:31,2024-03-29 09:00:04,SuperValu,-42.80,0.00,EUR,COMPLETED,889.12
Card Payment,Current,2024-03-27 20:15:31,2024-03-29 09:17:09,The Workman's Club,-12.90,0.00,EUR,COMPLETED,876.22
Transfer,Current,2024-03-29 09:17:25,2024-03-29 09:17:25,Savings Vault topup,-5.00,0.00,EUR,COMPLETED,871.22
Card Payment,Current,2024-03-27 19:37:40,2024-03-29 10:48:28,Full Moon,-75.00,0.00,EUR,COMPLETED,796.22
Transfer,Current,2024-03-29 17:27:57,2024-03-29 17:27:57,Savings Vault topup,-5.00,0.00,EUR,COMPLETED,791.22
Transfer,Current,2024-03-29 17:37:34,2024-03-29 17:37:34,Transfer from MARA DI RAIMONDO,10.00,0.00,EUR,COMPLETED,801.22
Transfer,Current,2024-03-29 22:58:53,2024-03-29 22:58:53,Transfer to SORACHA ESTHER ENRIGHT WARD,-120.00,0.00,EUR,COMPLETED,681.22
Transfer,Current,2024-03-29 22:59:04,2024-03-29 22:59:04,Transfer from MARA DI RAIMONDO,50.00,0.00,EUR,COMPLETED,731.22
Transfer,Current,2024-03-29 23:32:27,2024-03-29 23:32:27,Savings Vault topup,-2.50,0.00,EUR,COMPLETED,728.72
Transfer,Current,2024-03-30 00:12:49,2024-03-30 00:12:49,Transfer to JOHN DANIEL KIELY,-10.00,0.00,EUR,COMPLETED,718.72
Transfer,Current,2024-03-30 01:53:45,2024-03-30 01:53:45,Savings Vault topup,-1.00,0.00,EUR,COMPLETED,717.72
Transfer,Current,2024-03-30 02:19:53,2024-03-30 02:19:53,Transfer from MARA DI RAIMONDO,10.40,0.00,EUR,COMPLETED,728.12
Card Payment,Current,2024-03-29 17:27:57,2024-03-30 11:20:04,Hale VAPING,-8.00,0.00,EUR,COMPLETED,720.12
Card Payment,Current,2024-03-29 23:32:26,2024-03-30 11:35:00,Jack Nealons,-22.50,0.00,EUR,COMPLETED,697.62
Transfer,Current,2024-03-30 14:12:15,2024-03-30 14:12:15,Savings Vault topup,-2.40,0.00,EUR,COMPLETED,695.22
Transfer,Current,2024-03-30 14:23:07,2024-03-30 14:23:08,Transfer to MARA DI RAIMONDO,-12.00,0.00,EUR,COMPLETED,683.22
Transfer,Current,2024-03-30 14:27:19,2024-03-30 14:27:19,Transfer from MARA DI RAIMONDO,25.00,0.00,EUR,COMPLETED,708.22
Transfer,Current,2024-03-30 16:01:38,2024-03-30 16:01:38,Savings Vault topup,-5.00,0.00,EUR,COMPLETED,703.22
Card Payment,Current,2024-03-29 09:17:25,2024-03-30 16:22:56,Hatch Coffee,-13.00,0.00,EUR,COMPLETED,690.22
Transfer,Current,2024-03-30 18:55:01,2024-03-30 18:55:01,From Flexible account,200.00,0.00,EUR,COMPLETED,890.22
Transfer,Current,2024-03-30 19:11:46,2024-03-30 19:11:46,Savings Vault topup,-5.00,0.00,EUR,COMPLETED,885.22
Card Payment,Current,2024-03-30 01:53:45,2024-03-31 08:36:29,Av Cab,-20.80,0.00,EUR,COMPLETED,864.42
Card Payment,Current,2024-03-30 19:11:45,2024-03-31 09:56:18,Ristorante Rinuccini,-110.00,0.00,EUR,COMPLETED,754.42
Card Payment,Current,2024-03-30 16:01:38,2024-03-31 09:56:27,Newpark Hotel Kilkenny,-612.00,0.00,EUR,COMPLETED,142.42
Card Payment,Current,2024-03-30 14:12:14,2024-03-31 09:57:59,Applegreen,-53.52,0.00,EUR,COMPLETED,88.90
Transfer,Current,2024-03-31 12:03:26,2024-03-31 12:03:26,Savings Vault topup,-5.00,0.00,EUR,COMPLETED,83.90
Transfer,Current,2024-03-31 13:55:59,2024-03-31 13:56:00,Savings Vault topup,-2.50,0.00,EUR,COMPLETED,81.40
Transfer,Current,2024-03-31 14:40:01,2024-03-31 14:40:01,Transfer from MARA DI RAIMONDO,4.00,0.00,EUR,COMPLETED,85.40
Transfer,Current,2024-03-31 14:40:06,2024-03-31 14:40:06,Transfer from MARA DI RAIMONDO,55.00,0.00,EUR,COMPLETED,140.40
Transfer,Current,2024-03-31 14:55:15,2024-03-31 14:55:15,Savings Vault topup,-1.00,0.00,EUR,COMPLETED,139.40
Transfer,Current,2024-03-31 20:38:50,2024-03-31 20:38:50,Savings Vault topup,-5.00,0.00,EUR,COMPLETED,134.40
Transfer,Current,2024-03-31 20:50:06,2024-03-31 20:50:06,Savings Vault topup,-1.25,0.00,EUR,COMPLETED,133.15
Transfer,Current,2024-04-01 08:34:08,2024-04-01 08:34:08,Savings Vault topup,-2.55,0.00,EUR,COMPLETED,130.60
Card Payment,Current,2024-03-31 20:50:06,2024-04-01 10:11:17,Spar,-4.75,0.00,EUR,COMPLETED,125.85
Card Payment,Current,2024-03-31 12:03:26,2024-04-01 10:39:55,Dunmore Caves,-8.00,0.00,EUR,COMPLETED,117.85
Card Payment,Current,2024-03-31 13:55:59,2024-04-01 10:45:26,Arán Artisan Bakery & Bistro,-12.50,0.00,EUR,COMPLETED,105.35
Card Payment,Current,2024-03-31 14:55:15,2024-04-01 10:45:30,Arán Artisan Bakery & Bistro,-31.80,0.00,EUR,COMPLETED,73.55
Transfer,Current,2024-04-01 16:42:45,2024-04-01 16:42:45,Transfer from MARA DI RAIMONDO,16.77,0.00,EUR,COMPLETED,90.32
Transfer,Current,2024-04-01 16:42:51,2024-04-01 16:42:51,Transfer from MARA DI RAIMONDO,6.25,0.00,EUR,COMPLETED,96.57
Transfer,Current,2024-04-01 16:42:57,2024-04-01 16:42:57,Transfer from MARA DI RAIMONDO,10.00,0.00,EUR,COMPLETED,106.57
Transfer,Current,2024-04-01 16:43:18,2024-04-01 16:43:18,Transfer from MARA DI RAIMONDO,35.00,0.00,EUR,COMPLETED,141.57
Transfer,Current,2024-04-01 17:39:14,2024-04-01 17:39:14,Savings Vault topup,-5.00,0.00,EUR,COMPLETED,136.57
Card Payment,Current,2024-04-01 08:34:07,2024-04-02 09:25:28,HP,-1.49,0.00,EUR,COMPLETED,135.08
Card Payment,Current,2024-03-31 20:38:50,2024-04-02 09:59:03,Aroi - Asian Fusion restaurant,-70.00,0.00,EUR,COMPLETED,65.08
Transfer,Current,2024-04-02 12:52:48,2024-04-02 12:52:48,Savings Vault topup,-2.30,0.00,EUR,COMPLETED,62.78
Transfer,Current,2024-04-02 19:10:00,2024-04-02 19:10:00,Savings Vault topup,-3.50,0.00,EUR,COMPLETED,59.28
Transfer,Current,2024-04-03 08:30:19,2024-04-03 08:30:19,Transfer from MARA DI RAIMONDO,25.00,0.00,EUR,COMPLETED,84.28
Transfer,Current,2024-04-03 08:30:28,2024-04-03 08:30:29,Transfer from MARA DI RAIMONDO,45.00,0.00,EUR,COMPLETED,129.28
Transfer,Current,2024-04-03 09:27:26,2024-04-03 09:27:26,Savings Vault topup,-1.50,0.00,EUR,COMPLETED,127.78
Card Payment,Current,2024-04-02 19:10:00,2024-04-03 11:29:25,Clayton Hotels,-3.30,0.00,EUR,COMPLETED,124.48
Transfer,Current,2024-04-03 12:40:16,2024-04-03 12:40:16,Savings Vault topup,-2.50,0.00,EUR,COMPLETED,121.98
Transfer,Current,2024-04-03 12:47:03,2024-04-03 12:47:03,Savings Vault topup,-0.75,0.00,EUR,COMPLETED,121.23
Transfer,Current,2024-04-03 12:56:20,2024-04-03 12:56:20,Savings Vault topup,-5.00,0.00,EUR,COMPLETED,116.23
Card Payment,Current,2024-04-02 12:52:47,2024-04-03 13:28:38,Amazon Prime,-10.54,0.00,EUR,COMPLETED,105.69
Card Payment,Current,2024-04-01 17:39:14,2024-04-03 13:28:38,Amazon,-3.00,0.00,EUR,COMPLETED,102.69
Transfer,Current,2024-04-03 19:39:14,2024-04-03 19:39:14,Savings Vault topup,-3.10,0.00,EUR,COMPLETED,99.59
Transfer,Current,2024-04-04 02:51:34,2024-04-04 02:51:34,Savings Vault topup,-0.05,0.00,EUR,COMPLETED,99.54
Card Payment,Current,2024-04-03 12:56:20,2024-04-04 08:56:43,"Keys Cut, Electrical and DIY tools",-9.00,0.00,EUR,COMPLETED,90.54
Transfer,Current,2024-04-04 09:36:20,2024-04-04 09:36:20,Savings Vault topup,-0.30,0.00,EUR,COMPLETED,90.24
Card Payment,Current,2024-04-03 12:40:16,2024-04-04 10:35:02,Centra,-8.50,0.00,EUR,COMPLETED,81.74
Card Payment,Current,2024-04-03 12:47:02,2024-04-04 10:44:57,Boots,-28.85,0.00,EUR,COMPLETED,52.89
Card Payment,Current,2024-04-03 19:39:14,2024-04-04 10:45:14,Tesco,-6.38,0.00,EUR,COMPLETED,46.51
Card Payment,Current,2024-04-03 09:27:26,2024-04-04 11:00:47,Copper + Straw,-4.70,0.00,EUR,COMPLETED,41.81
Transfer,Current,2024-04-04 14:25:13,2024-04-04 14:25:14,Transfer to MARA DI RAIMONDO,-3.24,0.00,EUR,COMPLETED,38.57
Transfer,Current,2024-04-04 16:32:36,2024-04-04 16:32:36,Savings Vault topup,-5.00,0.00,EUR,COMPLETED,33.57
Transfer,Current,2024-04-04 16:32:56,2024-04-04 16:32:56,Savings Vault topup,-5.00,0.00,EUR,COMPLETED,28.57
Transfer,Current,2024-04-04 20:05:35,2024-04-04 20:05:35,Transfer from MARA DI RAIMONDO,57.50,0.00,EUR,COMPLETED,86.07
Transfer,Current,2024-04-04 20:31:55,2024-04-04 20:31:55,Savings Vault topup,-1.20,0.00,EUR,COMPLETED,84.87
Card Payment,Current,2024-04-04 09:36:20,2024-04-05 03:07:11,YouTube,-0.94,0.00,EUR,COMPLETED,83.93
Transfer,Current,2024-04-05 08:13:25,2024-04-05 08:13:25,Savings Vault topup,-2.00,0.00,EUR,COMPLETED,81.93
Card Payment,Current,2024-04-04 16:32:36,2024-04-05 10:00:32,Xl,-9.00,0.00,EUR,COMPLETED,72.93
Card Payment,Current,2024-04-04 16:32:56,2024-04-05 10:00:32,Xl,-7.00,0.00,EUR,COMPLETED,65.93
Card Payment,Current,2024-04-04 02:51:34,2024-04-05 12:22:29,Apple,-2.99,0.00,EUR,COMPLETED,62.94
Transfer,Current,2024-04-05 18:12:45,2024-04-05 18:12:45,Savings Vault topup,-0.10,0.00,EUR,COMPLETED,62.84
Card Payment,Current,2024-04-05 18:12:45,2024-04-06 10:57:29,Camile Thai,-22.98,0.00,EUR,COMPLETED,39.86
Transfer,Current,2024-04-06 15:40:06,2024-04-06 15:40:06,From Flexible account,50.00,0.00,EUR,COMPLETED,89.86
Transfer,Current,2024-04-06 15:41:56,2024-04-06 15:41:56,Savings Vault topup,-4.50,0.00,EUR,COMPLETED,85.36
Card Payment,Current,2024-04-04 20:31:55,2024-04-06 15:51:43,Amazon,-16.76,0.00,EUR,COMPLETED,68.60
Transfer,Current,2024-04-06 16:23:42,2024-04-06 16:23:42,Savings Vault topup,-4.50,0.00,EUR,COMPLETED,64.10
Card Payment,Current,2024-04-05 08:13:25,2024-04-06 16:42:16,Hatch Coffee,-4.60,0.00,EUR,COMPLETED,59.50
Transfer,Current,2024-04-06 16:58:10,2024-04-06 16:58:10,Savings Vault topup,-2.70,0.00,EUR,COMPLETED,56.80
Transfer,Current,2024-04-06 23:38:35,2024-04-06 23:38:35,Transfer from MARA DI RAIMONDO,7.50,0.00,EUR,COMPLETED,64.30
Card Payment,Current,2024-04-06 15:41:56,2024-04-07 08:53:30,Lidl,-12.10,0.00,EUR,COMPLETED,52.20
Card Payment,Current,2024-04-06 16:58:10,2024-04-07 10:03:54,SuperValu,-22.46,0.00,EUR,COMPLETED,29.74
Card Payment,Current,2024-04-06 16:23:42,2024-04-07 11:14:29,Hatch Coffee,-6.10,0.00,EUR,COMPLETED,23.64
Transfer,Current,2024-04-07 17:10:08,2024-04-07 17:10:08,Savings Vault topup,-5.00,0.00,EUR,COMPLETED,18.64
Transfer,Current,2024-04-07 17:10:54,2024-04-07 17:10:54,From Flexible account,100.00,0.00,EUR,COMPLETED,118.64
Transfer,Current,2024-04-07 17:11:00,2024-04-07 17:11:00,Transfer to MARA DI RAIMONDO,-20.97,0.00,EUR,COMPLETED,97.67
Transfer,Current,2024-04-07 17:11:02,2024-04-07 17:11:02,Transfer to MARA DI RAIMONDO,-26.50,0.00,EUR,COMPLETED,71.17
Transfer,Current,2024-04-07 17:57:04,2024-04-07 17:57:04,Savings Vault topup,-1.70,0.00,EUR,COMPLETED,69.47
Transfer,Current,2024-04-08 09:10:06,2024-04-08 09:10:06,Savings Vault topup,-1.50,0.00,EUR,COMPLETED,67.97
Card Payment,Current,2024-04-07 17:57:04,2024-04-08 11:43:50,ALDI,-36.66,0.00,EUR,COMPLETED,31.31
Card Payment,Current,2024-04-07 17:10:07,2024-04-08 11:59:43,Applegreen,-10.00,0.00,EUR,COMPLETED,21.31
Transfer,Current,2024-04-08 17:13:24,2024-04-08 17:13:24,Savings Vault topup,-2.50,0.00,EUR,COMPLETED,18.81
Transfer,Current,2024-04-08 20:29:22,2024-04-08 20:29:22,Transfer from MARA DI RAIMONDO,9.27,0.00,EUR,COMPLETED,28.08
Transfer,Current,2024-04-09 08:34:20,2024-04-09 08:34:21,Savings Vault topup,-1.50,0.00,EUR,COMPLETED,26.58
Card Payment,Current,2024-04-08 17:13:24,2024-04-09 11:07:11,Centra,-8.50,0.00,EUR,COMPLETED,18.08
Card Payment,Current,2024-04-08 09:10:05,2024-04-09 11:54:29,Copper + Straw,-4.70,0.00,EUR,COMPLETED,13.38
Topup,Current,2024-04-10 08:11:36,2024-04-10 08:11:36,Payment from WORKDAY LIMITED,21.80,0.00,EUR,COMPLETED,35.18
Card Payment,Current,2024-04-09 08:34:20,2024-04-10 10:46:44,Copper + Straw,-4.70,0.00,EUR,COMPLETED,30.48
Transfer,Current,2024-04-10 17:11:39,2024-04-10 17:11:40,Transfer to MARA DI RAIMONDO,-3.71,0.00,EUR,COMPLETED,26.77
Transfer,Current,2024-04-10 17:19:35,2024-04-10 17:19:35,Savings Vault topup,-4.00,0.00,EUR,COMPLETED,22.77
Transfer,Current,2024-04-11 08:44:00,2024-04-11 08:44:00,From Flexible account,200.00,0.00,EUR,COMPLETED,222.77
Transfer,Current,2024-04-11 10:51:32,2024-04-11 10:51:32,Transfer from MARA DI RAIMONDO,30.00,0.00,EUR,COMPLETED,252.77
Transfer,Current,2024-04-11 17:35:14,2024-04-11 17:35:15,Savings Vault topup,-0.05,0.00,EUR,COMPLETED,252.72
Card Payment,Current,2024-04-10 17:19:35,2024-04-12 09:37:22,The Boar's Head Dublin,-13.20,0.00,EUR,COMPLETED,239.52
Card Payment,Current,2024-04-11 17:35:14,2024-04-12 11:11:45,Apple,-19.99,0.00,EUR,COMPLETED,219.53
Transfer,Current,2024-04-12 18:07:06,2024-04-12 18:07:06,Savings Vault topup,-5.00,0.00,EUR,COMPLETED,214.53
Transfer,Current,2024-04-12 18:08:58,2024-04-12 18:08:58,Savings Vault topup,-0.05,0.00,EUR,COMPLETED,214.48
Transfer,Current,2024-04-12 19:25:42,2024-04-12 19:25:42,Savings Vault topup,-0.05,0.00,EUR,COMPLETED,214.43
Transfer,Current,2024-04-12 20:48:18,2024-04-12 20:48:18,Savings Vault topup,-3.00,0.00,EUR,COMPLETED,211.43
Card Payment,Current,2024-04-12 18:08:54,2024-04-13 09:34:35,SuperValu,-4.99,0.00,EUR,COMPLETED,206.44
Card Payment,Current,2024-04-12 18:07:06,2024-04-13 10:34:23,Xl,-9.00,0.00,EUR,COMPLETED,197.44
Card Payment,Current,2024-04-12 19:25:42,2024-04-13 10:52:37,PlayStation,-79.99,0.00,EUR,COMPLETED,117.45
Transfer,Current,2024-04-13 16:16:07,2024-04-13 16:16:07,Transfer to MARA DI RAIMONDO,-2.95,0.00,EUR,COMPLETED,114.50
Transfer,Current,2024-04-13 16:16:09,2024-04-13 16:16:09,Transfer to MARA DI RAIMONDO,-19.90,0.00,EUR,COMPLETED,94.60
Transfer,Current,2024-04-13 16:16:28,2024-04-13 16:16:28,Transfer to JOHN DANIEL KIELY,-35.00,0.00,EUR,COMPLETED,59.60
Transfer,Current,2024-04-13 20:47:32,2024-04-13 20:47:32,Savings Vault topup,-2.50,0.00,EUR,COMPLETED,57.10
Transfer,Current,2024-04-13 22:06:12,2024-04-13 22:06:12,Savings Vault topup,-2.50,0.00,EUR,COMPLETED,54.60
Card Payment,Current,2024-04-13 20:47:31,2024-04-14 09:42:53,The Devlin,-13.50,0.00,EUR,COMPLETED,41.10
Card Payment,Current,2024-04-13 22:06:11,2024-04-14 09:43:10,The Devlin,-13.50,0.00,EUR,COMPLETED,27.60
Transfer,Current,2024-04-14 10:42:30,2024-04-14 10:42:30,From Flexible account,100.00,0.00,EUR,COMPLETED,127.60
Transfer,Current,2024-04-14 10:43:24,2024-04-14 10:43:24,Savings Vault topup,-0.75,0.00,EUR,COMPLETED,126.85
Card Payment,Current,2024-04-12 20:48:18,2024-04-14 15:16:47,Amazon,-8.40,0.00,EUR,COMPLETED,118.45
Transfer,Current,2024-04-14 16:59:03,2024-04-14 16:59:03,Savings Vault topup,-1.55,0.00,EUR,COMPLETED,116.90
Transfer,Current,2024-04-15 09:06:15,2024-04-15 09:06:15,Savings Vault topup,-1.50,0.00,EUR,COMPLETED,115.40
Card Payment,Current,2024-04-14 16:59:03,2024-04-15 11:41:12,SuperValu,-26.69,0.00,EUR,COMPLETED,88.71
Card Payment,Current,2024-04-14 10:43:24,2024-04-15 16:09:50,Hatch Coffee,-26.85,0.00,EUR,COMPLETED,61.86
Transfer,Current,2024-04-16 09:05:51,2024-04-16 09:05:51,Savings Vault topup,-1.50,0.00,EUR,COMPLETED,60.36
Card Payment,Current,2024-04-15 09:06:14,2024-04-16 11:48:34,Copper + Straw,-4.70,0.00,EUR,COMPLETED,55.66
Transfer,Current,2024-04-16 17:10:05,2024-04-16 17:10:06,Savings Vault topup,-2.50,0.00,EUR,COMPLETED,53.16
Transfer,Current,2024-04-16 17:13:59,2024-04-16 17:13:59,Savings Vault topup,-5.00,0.00,EUR,COMPLETED,48.16
Card Payment,Current,2024-04-16 17:13:59,2024-04-17 09:41:42,Marks & Spencer,-27.00,0.00,EUR,COMPLETED,21.16
Card Payment,Current,2024-04-16 17:10:05,2024-04-17 10:26:04,Centra,-8.50,0.00,EUR,COMPLETED,12.66
Card Payment,Current,2024-04-16 09:05:51,2024-04-17 11:44:50,Copper + Straw,-4.70,0.00,EUR,COMPLETED,7.96
Transfer,Current,2024-04-17 18:02:14,2024-04-17 18:02:14,Savings Vault topup,-0.40,0.00,EUR,COMPLETED,7.56
Transfer,Current,2024-04-17 19:55:14,2024-04-17 19:55:14,From Flexible account,200.00,0.00,EUR,COMPLETED,207.56
Transfer,Current,2024-04-17 21:14:22,2024-04-17 21:14:22,Savings Vault topup,-0.75,0.00,EUR,COMPLETED,206.81
Card Payment,Current,2024-04-17 18:02:14,2024-04-18 14:32:49,Amazon,-0.92,0.00,EUR,COMPLETED,205.89
Card Payment,Current,2024-04-17 21:14:21,2024-04-18 15:15:01,Altstore,-1.85,0.00,EUR,COMPLETED,204.04
Transfer,Current,2024-04-18 17:21:57,2024-04-18 17:21:57,Transfer to MARA DI RAIMONDO,-15.00,0.00,EUR,COMPLETED,189.04
Transfer,Current,2024-04-18 17:51:40,2024-04-18 17:51:40,Savings Vault topup,-4.50,0.00,EUR,COMPLETED,184.54
Transfer,Current,2024-04-18 19:23:54,2024-04-18 19:23:54,Savings Vault topup,-0.30,0.00,EUR,COMPLETED,184.24
Transfer,Current,2024-04-19 08:41:09,2024-04-19 08:41:09,Savings Vault topup,-5.00,0.00,EUR,COMPLETED,179.24
Card Payment,Current,2024-04-18 17:51:40,2024-04-19 09:07:11,SuperValu,-26.10,0.00,EUR,COMPLETED,153.14
Transfer,Current,2024-04-20 07:58:39,2024-04-20 07:58:39,Savings Vault topup,-5.00,0.00,EUR,COMPLETED,148.14
Transfer,Current,2024-04-20 08:01:19,2024-04-20 08:01:19,From Flexible account,100.00,0.00,EUR,COMPLETED,248.14
Card Payment,Current,2024-04-19 08:41:09,2024-04-20 12:39:27,Circle K Gas Station,-8.00,0.00,EUR,COMPLETED,240.14
Transfer,Current,2024-04-20 14:37:24,2024-04-20 14:37:24,Savings Vault topup,-1.85,0.00,EUR,COMPLETED,238.29
Transfer,Current,2024-04-20 16:39:37,2024-04-20 16:39:37,Savings Vault topup,-5.00,0.00,EUR,COMPLETED,233.29
Transfer,Current,2024-04-20 18:17:34,2024-04-20 18:17:34,From Flexible account,100.00,0.00,EUR,COMPLETED,333.29
Transfer,Current,2024-04-20 18:18:05,2024-04-20 18:18:05,Savings Vault topup,-3.90,0.00,EUR,COMPLETED,329.39
Transfer,Current,2024-04-21 14:19:12,2024-04-21 14:19:12,Savings Vault topup,-4.50,0.00,EUR,COMPLETED,324.89
Transfer,Current,2024-04-21 15:32:36,2024-04-21 15:32:36,Transfer to JOHN DANIEL KIELY,-26.00,0.00,EUR,COMPLETED,298.89
Transfer,Current,2024-04-21 15:32:54,2024-04-21 15:32:54,Transfer to RORY BOYLE,-4.00,0.00,EUR,COMPLETED,294.89
Transfer,Current,2024-04-21 15:49:43,2024-04-21 15:49:43,Savings Vault topup,-3.30,0.00,EUR,COMPLETED,291.59
Transfer,Current,2024-04-21 19:17:00,2024-04-21 19:17:00,Savings Vault topup,-3.90,0.00,EUR,COMPLETED,287.69
Transfer,Current,2024-04-21 19:17:17,2024-04-21 19:17:17,From Flexible account,100.00,0.00,EUR,COMPLETED,387.69
Transfer,Current,2024-04-22 06:42:50,2024-04-22 06:42:50,Savings Vault topup,-2.50,0.00,EUR,COMPLETED,385.19
Card Payment,Current,2024-04-18 19:23:53,2024-04-22 17:27:32,Amazon,-119.94,0.00,EUR,COMPLETED,265.25
Transfer,Current,2024-04-22 19:46:58,2024-04-22 19:46:58,Savings Vault topup,-4.00,0.00,EUR,COMPLETED,261.25
Card Payment,Current,2024-04-20 18:18:05,2024-04-22 21:06:23,Deliveroo,-19.22,0.00,EUR,COMPLETED,242.03
Card Payment,Current,2024-04-20 07:58:39,2024-04-22 22:03:09,Centra,-4.00,0.00,EUR,COMPLETED,238.03
Card Payment,Current,2024-04-20 16:39:36,2024-04-22 22:33:50,Heatons,-22.00,0.00,EUR,COMPLETED,216.03
Card Payment,Current,2024-04-20 14:37:24,2024-04-22 22:52:34,MYPROTEIN,-75.63,0.00,EUR,COMPLETED,140.40
Card Payment,Current,2024-04-21 15:49:43,2024-04-23 02:03:08,Donnybrook Fair,-7.34,0.00,EUR,COMPLETED,133.06
Card Payment,Current,2024-04-21 19:17:00,2024-04-23 02:25:01,Deliveroo,-19.22,0.00,EUR,COMPLETED,113.84
Card Payment,Current,2024-04-21 14:19:12,2024-04-23 08:58:10,Gibney's Of Malahide,-16.10,0.00,EUR,COMPLETED,97.74
Card Payment,Current,2024-04-22 06:42:49,2024-04-23 09:20:59,WHSmith,-2.50,0.00,EUR,COMPLETED,95.24
Card Payment,Current,2024-04-22 19:46:58,2024-04-23 13:58:36,Boots,-3.20,0.00,EUR,COMPLETED,92.04
Transfer,Current,2024-04-23 17:02:48,2024-04-23 17:02:48,Savings Vault topup,-2.50,0.00,EUR,COMPLETED,89.54
Transfer,Current,2024-04-23 21:12:43,2024-04-23 21:12:43,Savings Vault topup,-3.40,0.00,EUR,COMPLETED,86.14
Transfer,Current,2024-04-23 21:34:53,2024-04-23 21:34:53,Savings Vault topup,-4.25,0.00,EUR,COMPLETED,81.89
Transfer,Current,2024-04-24 01:00:00,2024-04-24 11:45:20,To eFlow,-14.03,0.00,EUR,COMPLETED,67.86
Card Payment,Current,2024-04-23 21:12:42,2024-04-24 13:24:27,Kiosk,-9.32,0.00,EUR,COMPLETED,58.54
Card Payment,Current,2024-04-23 17:02:48,2024-04-24 13:43:28,Junkyard Market,-3.50,0.00,EUR,COMPLETED,55.04
Card Payment,Current,2024-04-23 21:34:53,2024-04-24 13:43:31,Bacchus Wine Cellar,-3.15,0.00,EUR,COMPLETED,51.89
Transfer,Current,2024-04-24 15:20:46,2024-04-24 15:20:46,Savings Vault topup,-3.65,0.00,EUR,COMPLETED,48.24
Transfer,Current,2024-04-24 19:33:26,2024-04-24 19:33:27,From Flexible account,1500.00,0.00,EUR,COMPLETED,1548.24
Transfer,Current,2024-04-24 22:06:27,2024-04-24 22:06:27,Transfer from MARA DI RAIMONDO,550.00,0.00,EUR,COMPLETED,2098.24
Topup,Current,2024-04-25 08:06:04,2024-04-25 08:06:05,Payment from WORKDAY LIMITED,6038.85,0.00,EUR,COMPLETED,8137.09
Transfer,Current,2024-04-25 08:08:11,2024-04-25 08:08:11,Savings Vault topup,-4.00,0.00,EUR,COMPLETED,8133.09
Transfer,Current,2024-04-25 08:09:02,2024-04-25 08:09:02,Savings Vault topup,-5500.00,0.00,EUR,COMPLETED,2633.09
Transfer,Current,2024-04-25 08:25:51,2024-04-25 08:25:51,Savings Vault topup,-2.75,0.00,EUR,COMPLETED,2630.34
Transfer,Current,2024-04-25 08:08:37,2024-04-25 08:51:20,To Colm Quish,-94.80,0.00,EUR,COMPLETED,2535.54
Transfer,Current,2024-04-25 08:17:45,2024-04-25 08:51:31,To Finance Ireland,-1424.50,0.00,EUR,COMPLETED,1111.04
Transfer,Current,2024-04-25 11:31:18,2024-04-25 11:31:18,Savings Vault topup,-3.75,0.00,EUR,COMPLETED,1107.29
Card Payment,Current,2024-04-24 15:20:46,2024-04-25 14:10:02,WHSmith,-3.27,0.00,EUR,COMPLETED,1104.02
Card Payment,Current,2024-04-25 08:25:51,2024-04-26 08:52:49,SuperValu,-28.45,0.00,EUR,COMPLETED,1075.57
Card Payment,Current,2024-04-25 08:08:11,2024-04-26 08:53:46,Starbucks,-4.20,0.00,EUR,COMPLETED,1071.37
Card Payment,Current,2024-04-25 11:31:18,2024-04-26 11:49:54,Kiltubrid Gaa,-21.25,0.00,EUR,COMPLETED,1050.12
Transfer,Current,2024-04-26 12:10:45,2024-04-26 12:10:45,To pocket EUR Subscriptions from EUR,-400.00,0.00,EUR,COMPLETED,650.12
Transfer,Current,2024-04-26 20:33:18,2024-04-26 20:33:18,Savings Vault topup,-3.85,0.00,EUR,COMPLETED,646.27
Transfer,Current,2024-04-26 21:43:02,2024-04-26 21:43:02,Savings Vault topup,-5.00,0.00,EUR,COMPLETED,641.27
Transfer,Current,2024-04-26 21:57:32,2024-04-26 21:57:32,Savings Vault topup,-2.50,0.00,EUR,COMPLETED,638.77
Transfer,Current,2024-04-26 22:34:31,2024-04-26 22:34:31,Savings Vault topup,-3.85,0.00,EUR,COMPLETED,634.92
Transfer,Current,2024-04-26 22:44:08,2024-04-26 22:44:08,Savings Vault topup,-5.00,0.00,EUR,COMPLETED,629.92
Transfer,Current,2024-04-26 23:33:01,2024-04-26 23:33:01,From Flexible account,200.00,0.00,EUR,COMPLETED,829.92
Transfer,Current,2024-04-26 23:51:21,2024-04-26 23:51:21,Savings Vault topup,-5.00,0.00,EUR,COMPLETED,824.92
Transfer,Current,2024-04-27 03:09:05,2024-04-27 03:09:05,Savings Vault topup,-1.00,0.00,EUR,COMPLETED,823.92
Transfer,Current,2024-04-27 03:31:36,2024-04-27 03:31:36,Savings Vault topup,-5.00,0.00,EUR,COMPLETED,818.92
Transfer,Current,2024-04-27 10:19:02,2024-04-27 10:19:02,Savings Vault topup,-3.00,0.00,EUR,COMPLETED,815.92
Transfer,Current,2024-04-27 10:25:25,2024-04-27 10:25:25,Transfer from MARA DI RAIMONDO,300.00,0.00,EUR,COMPLETED,1115.92
Card Payment,Current,2024-04-26 20:33:18,2024-04-27 10:42:43,FREE NOW,-14.60,0.00,EUR,COMPLETED,1101.32
Card Payment,Current,2024-04-26 22:34:31,2024-04-27 10:42:46,FREE NOW,-22.00,0.00,EUR,COMPLETED,1079.32
Transfer,Current,2024-04-27 11:16:51,2024-04-27 11:16:51,Savings Vault topup,-0.05,0.00,EUR,COMPLETED,1079.27
Card Payment,Current,2024-04-26 23:51:21,2024-04-27 11:28:20,Booking.com,-600.00,0.00,EUR,COMPLETED,479.27
Card Payment,Current,2024-04-26 21:57:32,2024-04-27 11:47:27,The Wicked Wolf,-11.50,0.00,EUR,COMPLETED,467.77
Card Payment,Current,2024-04-26 22:44:08,2024-04-27 12:10:18,Applegreen,-8.00,0.00,EUR,COMPLETED,459.77
Transfer,Current,2024-04-27 14:02:10,2024-04-27 14:02:10,Transfer from BRYAN DALTON,54.50,0.00,EUR,COMPLETED,514.27
Transfer,Current,2024-04-27 19:19:14,2024-04-27 19:19:14,Savings Vault topup,-5.00,0.00,EUR,COMPLETED,509.27
Transfer,Current,2024-04-27 19:29:14,2024-04-27 19:29:14,Savings Vault topup,-0.10,0.00,EUR,COMPLETED,509.17
Card Payment,Current,2024-04-26 21:43:02,2024-04-28 08:55:41,The Blackrock Irish Pub,-82.00,0.00,EUR,COMPLETED,427.17
Card Payment,Current,2024-04-27 11:16:51,2024-04-28 09:39:56,Currys,-269.99,0.00,EUR,COMPLETED,157.18
Card Payment,Current,2024-04-27 10:19:02,2024-04-28 10:37:53,McDonald's,-7.40,0.00,EUR,COMPLETED,149.78
Card Payment,Current,2024-04-27 03:31:35,2024-04-28 10:47:29,Dún Laoghaire-Rathdown City Council,-40.00,0.00,EUR,COMPLETED,109.78
Card Payment,Current,2024-04-27 19:19:13,2024-04-28 10:47:57,Applegreen,-9.00,0.00,EUR,COMPLETED,100.78
Transfer,Current,2024-04-28 11:34:07,2024-04-28 11:34:07,Savings Vault topup,-4.80,0.00,EUR,COMPLETED,95.98
Transfer,Current,2024-04-28 15:38:05,2024-04-28 15:38:05,Transfer to RORY BOYLE,-15.00,0.00,EUR,COMPLETED,80.98
Card Payment,Current,2024-04-28 11:34:07,2024-04-29 10:37:20,Lidl,-40.04,0.00,EUR,COMPLETED,40.94
Card Payment,Current,2024-04-27 03:09:05,2024-04-29 10:58:16,FREE NOW,-13.40,0.00,EUR,COMPLETED,27.54
Card Payment,Current,2024-04-27 19:29:14,2024-04-29 11:18:55,Camile Thai,-18.98,0.00,EUR,COMPLETED,8.56
Transfer,Current,2024-04-29 15:49:53,2024-04-29 15:49:53,From Flexible account,1000.00,0.00,EUR,COMPLETED,1008.56
Transfer,Current,2024-04-29 19:15:55,2024-04-29 19:15:55,Savings Vault topup,-4.40,0.00,EUR,COMPLETED,1004.16
Transfer,Current,2024-04-29 15:50:21,2024-04-30 01:56:39,To Colm Quish,-842.23,0.00,EUR,COMPLETED,161.93
Transfer,Current,2024-04-30 07:46:38,2024-04-30 07:46:38,Savings Vault topup,-2.00,0.00,EUR,COMPLETED,159.93
Card Payment,Current,2024-04-29 19:15:55,2024-04-30 09:19:54,SuperValu,-12.12,0.00,EUR,COMPLETED,147.81
Transfer,Current,2024-04-30 19:21:01,2024-04-30 19:21:01,Savings Vault topup,-3.95,0.00,EUR,COMPLETED,143.86
Transfer,Current,2024-04-30 19:42:14,2024-04-30 19:42:14,Transfer from MARA DI RAIMONDO,258.00,0.00,EUR,COMPLETED,401.86
Transfer,Current,2024-04-30 19:42:18,2024-04-30 19:42:18,Transfer from MARA DI RAIMONDO,16.00,0.00,EUR,COMPLETED,417.86
Transfer,Current,2024-04-30 19:49:48,2024-04-30 19:49:48,Transfer from MARA DI RAIMONDO,33.58,0.00,EUR,COMPLETED,451.44
Transfer,Current,2024-04-30 19:50:59,2024-04-30 19:50:59,Transfer from MARA DI RAIMONDO,0.01,0.00,EUR,COMPLETED,451.45
Transfer,Current,2024-04-30 20:03:41,2024-04-30 20:03:41,Transfer to MARA DI RAIMONDO,-33.00,0.00,EUR,COMPLETED,418.45
Transfer,Current,2024-04-30 20:03:53,2024-04-30 20:03:53,Transfer to MARA DI RAIMONDO,-1.00,0.00,EUR,COMPLETED,417.45
Card Payment,Current,2024-04-30 19:21:00,2024-05-01 11:21:10,Deliveroo,-38.21,0.00,EUR,COMPLETED,379.24
Card Payment,Current,2024-04-30 07:46:38,2024-05-01 15:11:06,Hatch Coffee,-4.60,0.00,EUR,COMPLETED,374.64
Transfer,Current,2024-05-01 16:57:04,2024-05-01 16:57:04,Savings Vault topup,-2.50,0.00,EUR,COMPLETED,372.14
Transfer,Current,2024-05-01 18:34:23,2024-05-01 18:34:24,Savings Vault topup,-5.00,0.00,EUR,COMPLETED,367.14
Transfer,Current,2024-05-01 18:34:45,2024-05-01 18:34:45,Savings Vault topup,-3.20,0.00,EUR,COMPLETED,363.94
Transfer,Current,2024-05-02 08:51:22,2024-05-02 08:51:22,Savings Vault topup,-2.55,0.00,EUR,COMPLETED,361.39
Card Payment,Current,2024-05-01 16:57:04,2024-05-02 10:40:13,Centra,-8.50,0.00,EUR,COMPLETED,352.89
Card Payment,Current,2024-05-01 18:34:23,2024-05-02 11:16:18,Cut and Sew,-32.00,0.00,EUR,COMPLETED,320.89
Card Payment,Current,2024-05-01 18:34:44,2024-05-02 11:56:03,Strike Pay,-5.36,0.00,EUR,COMPLETED,315.53
Transfer,Current,2024-05-02 12:13:51,2024-05-02 12:13:51,Savings Vault topup,-2.35,0.00,EUR,COMPLETED,313.18
Transfer,Current,2024-05-02 19:25:20,2024-05-02 19:25:20,Savings Vault topup,-3.75,0.00,EUR,COMPLETED,309.43
Transfer,Current,2024-05-02 20:40:33,2024-05-02 20:40:34,Savings Vault topup,-5.00,0.00,EUR,COMPLETED,304.43
Transfer,Current,2024-05-03 07:52:08,2024-05-03 07:52:08,Savings Vault topup,-5.00,0.00,EUR,COMPLETED,299.43
Transfer,Current,2024-05-03 07:55:57,2024-05-03 07:55:57,Savings Vault topup,-2.25,0.00,EUR,COMPLETED,297.18
Card Payment,Current,2024-05-02 08:51:22,2024-05-03 10:25:06,HP,-14.49,0.00,EUR,COMPLETED,282.69
Card Payment,Current,2024-05-02 20:40:33,2024-05-03 11:05:47,Tv Licence,-160.00,0.00,EUR,COMPLETED,122.69
Card Payment,Current,2024-05-02 19:25:20,2024-05-03 12:14:13,Deliveroo,-22.25,0.00,EUR,COMPLETED,100.44
Card Payment,Current,2024-05-02 12:13:51,2024-05-03 14:53:04,Amazon,-10.53,0.00,EUR,COMPLETED,89.91
Transfer,Current,2024-05-03 23:02:35,2024-05-03 23:02:35,Savings Vault topup,-0.05,0.00,EUR,COMPLETED,89.86
Transfer,Current,2024-05-04 02:51:40,2024-05-04 02:51:40,Savings Vault topup,-0.05,0.00,EUR,COMPLETED,89.81
Transfer,Current,2024-05-04 08:20:33,2024-05-04 08:20:34,From Flexible account,400.00,0.00,EUR,COMPLETED,489.81
Transfer,Current,2024-05-04 08:20:40,2024-05-04 08:20:40,Savings Vault topup,-3.50,0.00,EUR,COMPLETED,486.31
Transfer,Current,2024-05-04 09:36:27,2024-05-04 09:36:27,Savings Vault topup,-0.35,0.00,EUR,COMPLETED,485.96
Card Payment,Current,2024-05-03 07:55:57,2024-05-04 10:00:24,SuperValu,-17.55,0.00,EUR,COMPLETED,468.41
Transfer,Current,2024-05-04 10:11:41,2024-05-04 10:11:41,Savings Vault topup,-0.75,0.00,EUR,COMPLETED,467.66
Transfer,Current,2024-05-04 10:23:11,2024-05-04 10:23:11,Savings Vault topup,-0.25,0.00,EUR,COMPLETED,467.41
Transfer,Current,2024-05-04 10:40:49,2024-05-04 10:40:49,Savings Vault topup,-5.00,0.00,EUR,COMPLETED,462.41
Card Payment,Current,2024-05-03 07:52:08,2024-05-04 10:41:00,Xl,-9.00,0.00,EUR,COMPLETED,453.41
Card Payment,Current,2024-05-03 23:02:35,2024-05-04 11:15:22,Netflix,-14.99,0.00,EUR,COMPLETED,438.42
Transfer,Current,2024-05-04 12:35:53,2024-05-04 12:35:54,From Flexible account,500.00,0.00,EUR,COMPLETED,938.42
Transfer,Current,2024-05-04 12:36:26,2024-05-04 12:36:26,Savings Vault topup,-0.95,0.00,EUR,COMPLETED,937.47
Transfer,Current,2024-05-04 13:27:55,2024-05-04 13:27:55,Savings Vault topup,-5.00,0.00,EUR,COMPLETED,932.47
Transfer,Current,2024-05-04 13:36:41,2024-05-04 13:36:41,Savings Vault topup,-1.75,0.00,EUR,COMPLETED,930.72
Transfer,Current,2024-05-04 13:38:02,2024-05-04 13:38:02,Savings Vault topup,-3.00,0.00,EUR,COMPLETED,927.72
Transfer,Current,2024-05-04 13:52:30,2024-05-04 13:52:30,Savings Vault topup,-0.05,0.00,EUR,COMPLETED,927.67
Transfer,Current,2024-05-04 14:07:34,2024-05-04 14:07:35,Transfer from MARA DI RAIMONDO,44.75,0.00,EUR,COMPLETED,972.42
Transfer,Current,2024-05-04 14:07:38,2024-05-04 14:07:38,Transfer from MARA DI RAIMONDO,80.00,0.00,EUR,COMPLETED,1052.42
Transfer,Current,2024-05-04 14:07:41,2024-05-04 14:07:41,Transfer from MARA DI RAIMONDO,41.91,0.00,EUR,COMPLETED,1094.33
Transfer,Current,2024-05-04 14:08:25,2024-05-04 14:08:25,Transfer from MARA DI RAIMONDO,20.90,0.00,EUR,COMPLETED,1115.23
Transfer,Current,2024-05-04 14:09:17,2024-05-04 14:09:17,Transfer to MARA DI RAIMONDO,-100.00,0.00,EUR,COMPLETED,1015.23
Transfer,Current,2024-05-04 14:09:22,2024-05-04 14:09:22,Transfer from MARA DI RAIMONDO,25.15,0.00,EUR,COMPLETED,1040.38
Transfer,Current,2024-05-04 14:09:27,2024-05-04 14:09:27,Transfer from MARA DI RAIMONDO,7.97,0.00,EUR,COMPLETED,1048.35
Transfer,Current,2024-05-04 14:11:10,2024-05-04 14:11:11,Transfer to MARA DI RAIMONDO,-22.99,0.00,EUR,COMPLETED,1025.36
Transfer,Current,2024-05-04 14:22:44,2024-05-04 14:22:44,Savings Vault topup,-1.00,0.00,EUR,COMPLETED,1024.36
Transfer,Current,2024-05-04 18:44:00,2024-05-04 18:44:00,Savings Vault topup,-3.50,0.00,EUR,COMPLETED,1020.86
Transfer,Current,2024-05-04 21:22:29,2024-05-04 21:22:29,Transfer to MARA DI RAIMONDO,-17.09,0.00,EUR,COMPLETED,1003.77
Transfer,Current,2024-05-04 21:24:00,2024-05-04 21:24:00,Savings Vault topup,-1.75,0.00,EUR,COMPLETED,1002.02
Card Payment,Current,2024-05-04 09:36:27,2024-05-05 02:58:16,YouTube,-0.93,0.01,EUR,COMPLETED,1001.08
Card Payment,Current,2024-05-04 10:23:11,2024-05-05 09:06:43,Superdrug,-15.95,0.00,EUR,COMPLETED,985.13
Transfer,Current,2024-05-05 09:08:06,2024-05-05 09:08:06,Savings Vault topup,-2.00,0.00,EUR,COMPLETED,983.13
Card Payment,Current,2024-05-04 08:20:39,2024-05-05 09:10:22,citytripbarcelona.com,-50.30,0.00,EUR,COMPLETED,932.83
Card Payment,Current,2024-05-04 13:27:54,2024-05-05 09:28:55,WHSmith,-4.00,0.00,EUR,COMPLETED,928.83
Card Payment,Current,2024-05-04 02:51:40,2024-05-05 09:47:18,Apple,-2.99,0.00,EUR,COMPLETED,925.84
Card Payment,Current,2024-05-04 21:23:59,2024-05-05 10:18:55,Restaurant Taverna del Bisbe,-77.65,0.00,EUR,COMPLETED,848.19
Card Payment,Current,2024-05-04 18:44:00,2024-05-05 10:30:35,Taxi Amb Llicencia 10451,-35.30,0.00,EUR,COMPLETED,812.89
Card Payment,Current,2024-05-04 10:11:41,2024-05-05 10:56:35,Massimo Dutti,-319.85,0.00,EUR,COMPLETED,493.04
Transfer,Current,2024-05-05 10:59:48,2024-05-05 10:59:48,Transfer to MARA DI RAIMONDO,-1.25,0.00,EUR,COMPLETED,491.79
Transfer,Current,2024-05-05 10:59:53,2024-05-05 10:59:53,Transfer to MARA DI RAIMONDO,-5.82,0.00,EUR,COMPLETED,485.97
Transfer,Current,2024-05-05 11:06:37,2024-05-05 11:06:37,Savings Vault topup,-5.00,0.00,EUR,COMPLETED,480.97
Transfer,Current,2024-05-05 11:08:07,2024-05-05 11:08:08,Transfer from MARA DI RAIMONDO,16.00,0.00,EUR,COMPLETED,496.97
Card Payment,Current,2024-05-04 13:52:29,2024-05-05 11:08:49,Apple,-9.99,0.00,EUR,COMPLETED,486.98
Transfer,Current,2024-05-05 11:25:46,2024-05-05 11:25:47,Savings Vault topup,-3.00,0.00,EUR,COMPLETED,483.98
Transfer,Current,2024-05-05 11:29:19,2024-05-05 11:29:19,Savings Vault topup,-5.00,0.00,EUR,COMPLETED,478.98
Transfer,Current,2024-05-05 13:30:31,2024-05-05 13:30:31,Savings Vault topup,-0.25,0.00,EUR,COMPLETED,478.73
Transfer,Current,2024-05-05 13:40:52,2024-05-05 13:40:52,Savings Vault topup,-0.05,0.00,EUR,COMPLETED,478.68
Card Payment,Current,2024-05-05 13:43:40,,FREE NOW,-10.49,0.00,EUR,REVERTED,
Transfer,Current,2024-05-05 13:43:41,2024-05-05 13:43:41,Savings Vault topup,-2.55,0.00,EUR,COMPLETED,476.13
Card Payment,Current,2024-05-05 13:50:55,,FREE NOW,-8.35,0.00,EUR,REVERTED,
Transfer,Current,2024-05-05 13:50:55,2024-05-05 13:50:56,Savings Vault topup,-3.25,0.00,EUR,COMPLETED,472.88
Transfer,Current,2024-05-05 14:06:33,2024-05-05 14:06:33,Savings Vault topup,-0.25,0.00,EUR,COMPLETED,472.63
Transfer,Current,2024-05-05 14:43:34,2024-05-05 14:43:34,Savings Vault topup,-2.50,0.00,EUR,COMPLETED,470.13
Transfer,Current,2024-05-06 01:03:23,2024-05-06 01:03:23,Savings Vault topup,-3.50,0.00,EUR,COMPLETED,466.63
Card Payment,Current,2024-05-04 12:36:26,2024-05-06 09:02:18,FREE NOW,-41.00,0.00,EUR,COMPLETED,425.63
Card Payment,Current,2024-05-05 14:06:33,2024-05-06 09:24:11,Licencia 1312,-11.95,0.00,EUR,COMPLETED,413.68
Card Payment,Current,2024-05-04 13:36:40,2024-05-06 09:40:28,Marqette,-23.65,0.00,EUR,COMPLETED,390.03
Card Payment,Current,2024-05-04 14:22:44,2024-05-06 09:40:28,Marqette,-16.80,0.00,EUR,COMPLETED,373.23
Card Payment,Current,2024-05-04 13:38:01,2024-05-06 09:40:30,Marqette,-6.40,0.00,EUR,COMPLETED,366.83
Card Payment,Current,2024-05-04 10:40:49,2024-05-06 09:43:05,Xl,-9.00,0.00,EUR,COMPLETED,357.83
Card Payment,Current,2024-05-05 11:29:19,2024-05-06 09:49:38,Easytrip,-10.00,0.00,EUR,COMPLETED,347.83
Card Payment,Current,2024-05-05 11:25:46,2024-05-06 10:27:20,Super Ciutat Vella,-4.40,0.00,EUR,COMPLETED,343.43
Card Payment,Current,2024-05-05 11:06:36,2024-05-06 10:27:24,Hobart Tasmania,-45.00,0.00,EUR,COMPLETED,298.43
Card Payment,Current,2024-05-05 09:08:06,2024-05-06 10:27:55,Couleur Cafè Barcelona,-5.60,0.00,EUR,COMPLETED,292.83
Card Payment,Current,2024-05-05 13:40:51,2024-05-06 10:55:57,Supermercado Nuruzzama,-12.99,0.00,EUR,COMPLETED,279.84
Card Payment,Current,2024-05-05 13:30:30,2024-05-06 10:59:29,Bakery and Tapas,-12.95,0.00,EUR,COMPLETED,266.89
Card Payment,Current,2024-05-05 14:43:34,2024-05-06 10:59:55,Taxi Licencia 4226,-11.50,0.00,EUR,COMPLETED,255.39
Transfer,Current,2024-05-06 11:35:05,2024-05-06 11:35:05,Savings Vault topup,-4.25,0.00,EUR,COMPLETED,251.14
Transfer,Current,2024-05-06 11:58:25,2024-05-06 11:58:25,Savings Vault topup,-2.50,0.00,EUR,COMPLETED,248.64
Transfer,Current,2024-05-06 13:28:29,2024-05-06 13:28:29,Savings Vault topup,-5.00,0.00,EUR,COMPLETED,243.64
Transfer,Current,2024-05-06 14:15:44,2024-05-06 14:15:44,Savings Vault topup,-3.50,0.00,EUR,COMPLETED,240.14
Transfer,Current,2024-05-06 17:16:32,2024-05-06 17:16:32,Savings Vault topup,-4.25,0.00,EUR,COMPLETED,235.89
Transfer,Current,2024-05-06 19:33:49,2024-05-06 19:33:49,Savings Vault topup,-2.50,0.00,EUR,COMPLETED,233.39
Transfer,Current,2024-05-06 20:08:06,2024-05-06 20:08:07,Savings Vault topup,-5.00,0.00,EUR,COMPLETED,228.39
Transfer,Current,2024-05-06 21:54:14,2024-05-06 21:54:14,Savings Vault topup,-5.00,0.00,EUR,COMPLETED,223.39
Transfer,Current,2024-05-06 22:40:03,2024-05-06 22:40:03,Savings Vault topup,-5.00,0.00,EUR,COMPLETED,218.39
Transfer,Current,2024-05-07 00:05:21,2024-05-07 00:05:21,Savings Vault topup,-5.00,0.00,EUR,COMPLETED,213.39
Transfer,Current,2024-05-07 00:40:30,2024-05-07 00:40:30,Savings Vault topup,-5.00,0.00,EUR,COMPLETED,208.39
Card Payment,Current,2024-05-06 11:58:25,2024-05-07 09:19:27,Fruits Mico,-2.50,0.00,EUR,COMPLETED,205.89
Card Payment,Current,2024-05-06 01:03:23,2024-05-07 09:19:30,Istanbul Grill Doner Kebab,-5.30,0.00,EUR,COMPLETED,200.59
Transfer,Current,2024-05-07 09:47:36,2024-05-07 09:47:36,Savings Vault topup,-3.00,0.00,EUR,COMPLETED,197.59
Card Payment,Current,2024-05-06 11:35:05,2024-05-07 10:18:47,Tabernnus,-19.15,0.00,EUR,COMPLETED,178.44
Card Payment,Current,2024-05-06 13:28:29,2024-05-07 10:45:21,Supermercat,-3.00,0.00,EUR,COMPLETED,175.44
Card Payment,Current,2024-05-06 14:15:43,2024-05-07 10:49:28,Puntal,-4.30,0.00,EUR,COMPLETED,171.14
Card Payment,Current,2024-05-06 19:33:49,2024-05-07 10:49:30,The Bullman,-8.50,0.00,EUR,COMPLETED,162.64
Card Payment,Current,2024-05-06 20:08:06,2024-05-07 10:50:56,The Bullman,-12.00,0.00,EUR,COMPLETED,150.64
Card Payment,Current,2024-05-06 21:54:14,2024-05-07 10:51:01,The Bullman,-6.00,0.00,EUR,COMPLETED,144.64
Card Payment,Current,2024-05-06 22:40:02,2024-05-07 10:51:23,The Bullman,-16.00,0.00,EUR,COMPLETED,128.64
Transfer,Current,2024-05-07 12:21:44,2024-05-07 12:21:44,Savings Vault topup,-3.75,0.00,EUR,COMPLETED,124.89
Transfer,Current,2024-05-07 12:59:10,2024-05-07 12:59:10,Savings Vault topup,-2.20,0.00,EUR,COMPLETED,122.69
Card Payment,Current,2024-05-06 17:16:32,2024-05-07 15:09:43,Splice,-9.15,0.00,EUR,COMPLETED,113.54
Transfer,Current,2024-05-07 18:37:22,2024-05-07 18:37:22,From Flexible account,170.00,0.00,EUR,COMPLETED,283.54
Transfer,Current,2024-05-07 18:40:34,2024-05-07 18:40:34,Savings Vault topup,-3.50,0.00,EUR,COMPLETED,280.04
Transfer,Current,2024-05-07 18:45:19,2024-05-07 18:45:19,Savings Vault topup,-3.95,0.00,EUR,COMPLETED,276.09
Transfer,Current,2024-05-07 20:40:29,2024-05-07 20:40:29,Transfer to MARA DI RAIMONDO,-25.00,0.00,EUR,COMPLETED,251.09
Transfer,Current,2024-05-07 20:40:31,2024-05-07 20:40:31,Transfer to MARA DI RAIMONDO,-10.00,0.00,EUR,COMPLETED,241.09
Transfer,Current,2024-05-07 20:41:11,2024-05-07 20:41:11,Transfer from MARA DI RAIMONDO,5.97,0.00,EUR,COMPLETED,247.06
Transfer,Current,2024-05-07 20:41:15,2024-05-07 20:41:15,Transfer from MARA DI RAIMONDO,10.20,0.00,EUR,COMPLETED,257.26
Transfer,Current,2024-05-07 20:41:20,2024-05-07 20:41:20,Transfer from MARA DI RAIMONDO,16.62,0.00,EUR,COMPLETED,273.88
Transfer,Current,2024-05-07 20:41:44,2024-05-07 20:41:44,Transfer from MARA DI RAIMONDO,17.65,0.00,EUR,COMPLETED,291.53
Transfer,Current,2024-05-07 20:41:48,2024-05-07 20:41:48,Transfer from MARA DI RAIMONDO,30.00,0.00,EUR,COMPLETED,321.53
Transfer,Current,2024-05-07 20:42:36,2024-05-07 20:42:36,Transfer from MARA DI RAIMONDO,10.00,0.00,EUR,COMPLETED,331.53
Transfer,Current,2024-05-07 20:42:40,2024-05-07 20:42:40,Transfer from MARA DI RAIMONDO,17.00,0.00,EUR,COMPLETED,348.53
Transfer,Current,2024-05-08 08:11:33,2024-05-08 08:11:33,Savings Vault topup,-5.00,0.00,EUR,COMPLETED,343.53
Transfer,Current,2024-05-08 09:00:56,2024-05-08 09:00:56,Savings Vault topup,-0.55,0.00,EUR,COMPLETED,342.98
Card Payment,Current,2024-05-07 18:40:34,2024-05-08 10:25:14,Syed Bilal Tajama,-44.30,0.00,EUR,COMPLETED,298.68
Card Payment,Current,2024-05-07 18:45:19,2024-05-08 11:11:19,Deliveroo,-38.21,0.00,EUR,COMPLETED,260.47
Card Payment,Current,2024-05-07 09:47:36,2024-05-08 11:24:59,Masala Cafe,-20.40,0.00,EUR,COMPLETED,240.07
Card Payment,Current,2024-05-07 00:40:29,2024-05-08 11:26:01,L'Ovella Negra Marina,-6.00,0.00,EUR,COMPLETED,234.07
Card Payment,Current,2024-05-07 00:05:21,2024-05-08 11:26:33,L'Ovella Negra Marina,-4.00,0.00,EUR,COMPLETED,230.07
Card Payment,Current,2024-05-07 12:21:44,2024-05-08 11:50:56,Lic Taxi 2796,-33.25,0.00,EUR,COMPLETED,196.82
Card Payment,Current,2024-05-07 12:59:09,2024-05-08 11:54:07,Barcelona Airport,-13.56,0.00,EUR,COMPLETED,183.26
Transfer,Current,2024-05-08 17:05:45,2024-05-08 17:05:45,From Flexible account,200.00,0.00,EUR,COMPLETED,383.26
Exchange,Current,2024-05-08 17:05:54,2024-05-08 17:05:54,Exchanged to GBP,-186.32,0.00,EUR,COMPLETED,196.94
Exchange,Current,2024-05-08 17:07:18,2024-05-08 17:07:18,Exchanged to GBP,-2.33,0.00,EUR,COMPLETED,194.61
Transfer,Current,2024-05-08 17:38:23,2024-05-08 17:38:23,Savings Vault topup,-0.65,0.00,EUR,COMPLETED,193.96
Transfer,Current,2024-05-09 09:03:02,2024-05-09 09:03:02,Savings Vault topup,-1.50,0.00,EUR,COMPLETED,192.46
Card Payment,Current,2024-05-08 08:11:33,2024-05-09 09:31:30,Transport for Ireland - TFI,-30.00,0.00,EUR,COMPLETED,162.46
Card Payment,Current,2024-05-08 17:38:23,2024-05-09 09:52:21,Lidl,-36.87,0.00,EUR,COMPLETED,125.59
Card Payment,Current,2024-05-08 09:00:56,2024-05-09 12:03:00,Centra,-4.89,0.00,EUR,COMPLETED,120.70
Card Payment,Current,2024-05-09 09:03:02,2024-05-10 11:59:34,Copper + Straw,-4.70,0.00,EUR,COMPLETED,116.00
Transfer,Current,2024-05-10 20:17:11,2024-05-10 20:17:11,Savings Vault topup,-5.00,0.00,EUR,COMPLETED,111.00
Transfer,Current,2024-05-11 08:45:09,2024-05-11 08:45:09,Savings Vault topup,-0.05,0.00,EUR,COMPLETED,110.95
Transfer,Current,2024-05-11 09:21:17,2024-05-11 09:21:17,Savings Vault topup,-5.00,0.00,EUR,COMPLETED,105.95
Transfer,Current,2024-05-11 10:11:17,2024-05-11 10:11:18,From Flexible account,200.00,0.00,EUR,COMPLETED,305.95
Transfer,Current,2024-05-11 10:11:23,2024-05-11 10:11:23,Savings Vault topup,-2.35,0.00,EUR,COMPLETED,303.60
Transfer,Current,2024-05-11 10:12:22,2024-05-11 10:12:22,Savings Vault topup,-0.05,0.00,EUR,COMPLETED,303.55
Transfer,Current,2024-05-11 15:36:47,2024-05-11 15:36:47,Savings Vault topup,-4.75,0.00,EUR,COMPLETED,298.80
Transfer,Current,2024-05-11 16:25:08,2024-05-11 16:25:08,Savings Vault topup,-3.25,0.00,EUR,COMPLETED,295.55
Transfer,Current,2024-05-11 21:22:10,2024-05-11 21:22:10,Transfer from MARA DI RAIMONDO,20.00,0.00,EUR,COMPLETED,315.55
Transfer,Current,2024-05-11 21:22:13,2024-05-11 21:22:13,Transfer from MARA DI RAIMONDO,9.00,0.00,EUR,COMPLETED,324.55
Transfer,Current,2024-05-11 21:22:25,2024-05-11 21:22:26,Transfer to MARA DI RAIMONDO,-32.50,0.00,EUR,COMPLETED,292.05
Card Payment,Current,2024-05-11 08:45:09,2024-05-12 08:48:12,Apple,-19.99,0.00,EUR,COMPLETED,272.06
Transfer,Current,2024-05-12 11:09:55,2024-05-12 11:09:55,Savings Vault topup,-2.50,0.00,EUR,COMPLETED,269.56
Card Payment,Current,2024-05-10 20:17:11,2024-05-12 11:17:24,The Merry Cobbler,-70.00,0.00,EUR,COMPLETED,199.56
Card Payment,Current,2024-05-11 09:25:04,2024-05-12 11:59:06,Hatch Coffee,-4.60,0.00,EUR,COMPLETED,194.96
Card Payment,Current,2024-05-11 16:25:08,2024-05-12 12:00:31,Hatch Coffee,-13.35,0.00,EUR,COMPLETED,181.61
Card Payment,Current,2024-05-11 15:36:46,2024-05-12 12:07:54,Centra,-2.05,0.00,EUR,COMPLETED,179.56
Transfer,Current,2024-05-12 12:44:41,2024-05-12 12:44:41,Savings Vault topup,-0.25,0.00,EUR,COMPLETED,179.31
Transfer,Current,2024-05-12 13:33:17,2024-05-12 13:33:17,Savings Vault topup,-5.00,0.00,EUR,COMPLETED,174.31
Transfer,Current,2024-05-12 14:46:51,2024-05-12 14:46:51,Savings Vault topup,-5.00,0.00,EUR,COMPLETED,169.31
Transfer,Current,2024-05-12 17:20:23,2024-05-12 17:20:23,Savings Vault topup,-3.80,0.00,EUR,COMPLETED,165.51
Transfer,Current,2024-05-12 17:28:00,2024-05-12 17:28:01,Savings Vault topup,-5.00,0.00,EUR,COMPLETED,160.51
Transfer,Current,2024-05-13 08:28:31,2024-05-13 08:28:31,Savings Vault topup,-1.50,0.00,EUR,COMPLETED,159.01
Card Payment,Current,2024-05-11 09:21:17,2024-05-13 10:09:27,Payzone,-10.00,0.00,EUR,COMPLETED,149.01
Card Payment,Current,2024-05-11 10:11:23,2024-05-13 10:46:34,SuperValu,-33.53,0.00,EUR,COMPLETED,115.48
Card Payment,Current,2024-05-11 10:12:22,2024-05-13 10:51:01,Xl,-3.99,0.00,EUR,COMPLETED,111.49
Transfer,Current,2024-05-13 10:57:48,2024-05-13 10:57:48,Transfer to IAN ALAN ARMSTRONG,-18.00,0.00,EUR,COMPLETED,93.49
Card Payment,Current,2024-05-12 17:28:00,2024-05-13 11:17:22,Easytrip,-10.00,0.00,EUR,COMPLETED,83.49
Card Payment,Current,2024-05-12 14:46:51,2024-05-13 12:34:06,Coffee & Cream,-23.00,0.00,EUR,COMPLETED,60.49
Card Payment,Current,2024-05-12 11:09:55,2024-05-13 12:34:10,Boots,-10.50,0.00,EUR,COMPLETED,49.99
Card Payment,Current,2024-05-12 13:33:16,2024-05-13 12:35:41,LVPS Car Park,-4.00,0.00,EUR,COMPLETED,45.99
Card Payment,Current,2024-05-12 12:44:41,2024-05-13 12:53:48,Donnybrook Fair,-3.95,0.00,EUR,COMPLETED,42.04
Card Payment,Current,2024-05-12 17:20:23,2024-05-13 12:59:59,ALDI,-17.24,0.00,EUR,COMPLETED,24.80
Transfer,Current,2024-05-13 13:01:00,2024-05-13 13:01:00,Savings Vault topup,-0.75,0.00,EUR,COMPLETED,24.05
Transfer,Current,2024-05-13 15:16:53,2024-05-13 15:16:54,Transfer from MARA DI RAIMONDO,5.25,0.00,EUR,COMPLETED,29.30
Transfer,Current,2024-05-13 20:34:07,2024-05-13 20:34:07,From Flexible account,100.00,0.00,EUR,COMPLETED,129.30
Transfer,Current,2024-05-14 08:45:27,2024-05-14 08:45:27,Savings Vault topup,-1.50,0.00,EUR,COMPLETED,127.80
Card Payment,Current,2024-05-13 13:01:00,2024-05-14 10:03:54,Chopped,-11.85,0.00,EUR,COMPLETED,115.95
Card Payment,Current,2024-05-13 15:46:44,2024-05-14 11:28:25,GoMo,-11.51,0.00,EUR,COMPLETED,104.44
Card Payment,Current,2024-05-13 08:28:31,2024-05-14 11:28:55,Copper + Straw,-4.70,0.00,EUR,COMPLETED,99.74
Transfer,Current,2024-05-14 13:29:21,2024-05-14 13:29:21,Savings Vault topup,-1.25,0.00,EUR,COMPLETED,98.49
Transfer,Current,2024-05-14 20:18:48,2024-05-14 20:18:48,From Flexible account,1000.00,0.00,EUR,COMPLETED,1098.49
Transfer,Current,2024-05-14 21:20:28,2024-05-14 21:20:29,Transfer from MARA DI RAIMONDO,291.00,0.00,EUR,COMPLETED,1389.49
Transfer,Current,2024-05-14 20:19:08,2024-05-15 01:53:22,To Colm Quish,-369.50,0.00,EUR,COMPLETED,1019.99
Card Payment,Current,2024-05-14 13:29:21,2024-05-15 09:03:41,Boojum,-8.75,0.00,EUR,COMPLETED,1011.24
Transfer,Current,2024-05-15 09:23:25,2024-05-15 10:11:11,To Colm Quish,-960.00,0.00,EUR,COMPLETED,51.24
Card Payment,Current,2024-05-14 08:45:27,2024-05-15 11:42:11,Copper + Straw,-4.70,0.00,EUR,COMPLETED,46.54
Transfer,Current,2024-05-16 08:56:43,2024-05-16 08:56:43,Savings Vault topup,-1.50,0.00,EUR,COMPLETED,45.04
Transfer,Current,2024-05-16 18:00:15,2024-05-16 18:00:15,Savings Vault topup,-2.50,0.00,EUR,COMPLETED,42.54
Transfer,Current,2024-05-16 20:21:59,2024-05-16 20:21:59,Savings Vault topup,-0.60,0.00,EUR,COMPLETED,41.94
Transfer,Current,2024-05-17 08:00:06,2024-05-17 08:00:06,From Flexible account,250.00,0.00,EUR,COMPLETED,291.94
Transfer,Current,2024-05-17 09:26:31,2024-05-17 09:26:31,Transfer from MARA DI RAIMONDO,30.00,0.00,EUR,COMPLETED,321.94
Card Payment,Current,2024-05-16 08:56:43,2024-05-17 12:30:34,KC Peaches,-4.70,0.00,EUR,COMPLETED,317.24
Card Payment,Current,2024-05-16 20:21:58,2024-05-17 12:35:27,Deliveroo,-20.88,0.00,EUR,COMPLETED,296.36
Card Payment,Current,2024-05-16 18:00:15,2024-05-17 14:00:08,Centra,-8.50,0.00,EUR,COMPLETED,287.86
Transfer,Current,2024-05-17 14:01:22,2024-05-17 14:01:22,Savings Vault topup,-5.00,0.00,EUR,COMPLETED,282.86
Transfer,Current,2024-05-17 14:14:29,2024-05-17 14:14:29,Savings Vault topup,-1.50,0.00,EUR,COMPLETED,281.36
Transfer,Current,2024-05-17 20:31:50,2024-05-17 20:31:50,Savings Vault topup,-5.00,0.00,EUR,COMPLETED,276.36
Card Payment,Current,2024-05-17 14:01:22,2024-05-18 10:04:00,Spar,-10.00,0.00,EUR,COMPLETED,266.36
Card Payment,Current,2024-05-17 14:14:29,2024-05-18 10:05:30,Butlers Chocolates,-24.70,0.00,EUR,COMPLETED,241.66
Transfer,Current,2024-05-18 10:25:59,2024-05-18 10:25:59,Savings Vault topup,-3.00,0.00,EUR,COMPLETED,238.66
Transfer,Current,2024-05-18 11:32:25,2024-05-18 11:32:25,From Flexible account,200.00,0.00,EUR,COMPLETED,438.66
Transfer,Current,2024-05-18 11:32:26,2024-05-18 11:32:27,From Flexible account,200.00,0.00,EUR,COMPLETED,638.66
Transfer,Current,2024-05-18 11:33:48,2024-05-18 11:33:48,Savings Vault topup,-4.85,0.00,EUR,COMPLETED,633.81
Transfer,Current,2024-05-18 11:35:27,2024-05-18 11:35:27,Savings Vault topup,-2.80,0.00,EUR,COMPLETED,631.01
Transfer,Current,2024-05-18 15:32:19,2024-05-18 15:32:19,Savings Vault topup,-2.50,0.00,EUR,COMPLETED,628.51
Transfer,Current,2024-05-19 00:22:12,2024-05-19 00:22:13,Savings Vault topup,-5.00,0.00,EUR,COMPLETED,623.51
Transfer,Current,2024-05-19 00:51:20,2024-05-19 00:51:20,Savings Vault topup,-5.00,0.00,EUR,COMPLETED,618.51
Transfer,Current,2024-05-19 01:44:16,2024-05-19 01:44:16,Savings Vault topup,-5.00,0.00,EUR,COMPLETED,613.51
Card Payment,Current,2024-05-17 20:31:50,2024-05-19 09:24:17,The Merry Cobbler,-75.00,0.00,EUR,COMPLETED,538.51
ATM,Current,2024-05-18 11:33:10,2024-05-19 10:26:16,Cash withdrawal at Applegreen Mount Merrion,-200.00,0.00,EUR,COMPLETED,338.51
Card Payment,Current,2024-05-18 11:33:48,2024-05-19 10:59:36,Applegreen,-68.03,0.00,EUR,COMPLETED,270.48
Card Payment,Current,2024-05-18 11:35:27,2024-05-19 10:59:38,Applegreen,-13.44,0.00,EUR,COMPLETED,257.04
Card Payment,Current,2024-05-18 10:25:59,2024-05-19 11:03:32,Gleesons,-3.40,0.00,EUR,COMPLETED,253.64
Transfer,Current,2024-05-19 16:56:06,2024-05-19 16:56:06,Savings Vault topup,-2.90,0.00,EUR,COMPLETED,250.74
Transfer,Current,2024-05-19 16:59:53,2024-05-19 16:59:53,Savings Vault topup,-1.25,0.00,EUR,COMPLETED,249.49
Card Payment,Current,2024-05-19 00:22:12,2024-05-20 09:14:07,Glasson Lakehouse,-20.00,0.00,EUR,COMPLETED,229.49
Card Payment,Current,2024-05-19 00:51:20,2024-05-20 09:14:14,Glasson Lakehouse,-26.00,0.00,EUR,COMPLETED,203.49
Card Payment,Current,2024-05-19 01:44:16,2024-05-20 09:14:17,Glasson Lakehouse,-18.00,0.00,EUR,COMPLETED,185.49
Transfer,Current,2024-05-20 09:56:40,2024-05-20 09:56:40,Savings Vault topup,-5.00,0.00,EUR,COMPLETED,180.49
Card Payment,Current,2024-05-19 16:56:06,2024-05-20 10:09:29,Xl,-10.42,0.00,EUR,COMPLETED,170.07
Transfer,Current,2024-05-20 10:25:03,2024-05-20 10:25:03,Savings Vault topup,-2.00,0.00,EUR,COMPLETED,168.07
Card Payment,Current,2024-05-19 16:59:53,2024-05-20 10:49:47,SuperValu,-7.75,0.00,EUR,COMPLETED,160.32
Transfer,Current,2024-05-20 11:02:03,2024-05-20 11:02:03,Savings Vault topup,-3.30,0.00,EUR,COMPLETED,157.02
Transfer,Current,2024-05-20 11:06:41,2024-05-20 11:06:41,Savings Vault topup,-1.25,0.00,EUR,COMPLETED,155.77
Card Payment,Current,2024-05-18 15:32:18,2024-05-20 11:45:46,Glasson Lakehouse,-6.50,0.00,EUR,COMPLETED,149.27
Transfer,Current,2024-05-20 20:44:16,2024-05-20 20:44:16,Savings Vault topup,-4.90,0.00,EUR,COMPLETED,144.37
Transfer,Current,2024-05-21 09:12:51,2024-05-21 09:12:52,Savings Vault topup,-1.50,0.00,EUR,COMPLETED,142.87
Card Payment,Current,2024-05-20 11:02:03,2024-05-21 11:07:54,ALDI,-15.34,0.00,EUR,COMPLETED,127.53
Card Payment,Current,2024-05-20 09:56:40,2024-05-21 11:24:49,Applegreen,-10.00,0.00,EUR,COMPLETED,117.53
Card Payment,Current,2024-05-20 10:25:03,2024-05-21 11:39:37,Hatch Coffee,-17.60,0.00,EUR,COMPLETED,99.93
Card Payment,Current,2024-05-20 11:06:41,2024-05-21 11:40:14,Hatch Coffee,-4.75,0.00,EUR,COMPLETED,95.18
Card Payment,Current,2024-05-20 20:44:15,2024-05-21 13:46:33,Amazon,-11.02,0.00,EUR,COMPLETED,84.16
Transfer,Current,2024-05-21 18:40:53,2024-05-21 18:40:53,Transfer from MARA DI RAIMONDO,10.00,0.00,EUR,COMPLETED,94.16
Transfer,Current,2024-05-21 18:41:01,2024-05-21 18:41:01,Transfer from MARA DI RAIMONDO,523.00,0.00,EUR,COMPLETED,617.16
Transfer,Current,2024-05-21 18:41:16,2024-05-21 18:41:16,Transfer from MARA DI RAIMONDO,30.00,0.00,EUR,COMPLETED,647.16
Transfer,Current,2024-05-21 18:41:25,2024-05-21 18:41:25,Transfer from MARA DI RAIMONDO,100.00,0.00,EUR,COMPLETED,747.16
Transfer,Current,2024-05-21 18:41:32,2024-05-21 18:41:33,Transfer from MARA DI RAIMONDO,25.00,0.00,EUR,COMPLETED,772.16
Transfer,Current,2024-05-21 18:51:15,2024-05-21 18:51:15,Savings Vault topup,-5.00,0.00,EUR,COMPLETED,767.16
Transfer,Current,2024-05-21 18:52:06,2024-05-21 18:52:06,Transfer from MARA DI RAIMONDO,37.50,0.00,EUR,COMPLETED,804.66
Transfer,Current,2024-05-21 18:42:04,2024-05-22 01:51:57,To Colm Quish,-678.27,0.00,EUR,COMPLETED,126.39
Transfer,Current,2024-05-22 09:00:39,2024-05-22 09:00:39,Savings Vault topup,-2.50,0.00,EUR,COMPLETED,123.89
Card Payment,Current,2024-05-21 18:51:15,2024-05-22 10:54:52,Yamamori,-75.00,0.00,EUR,COMPLETED,48.89
Card Payment,Current,2024-05-21 09:12:51,2024-05-22 11:36:59,Copper + Straw,-4.70,0.00,EUR,COMPLETED,44.19
Transfer,Current,2024-05-22 01:00:00,2024-05-22 11:43:59,To eFlow,-26.83,0.00,EUR,COMPLETED,17.36
Transfer,Current,2024-05-22 17:10:21,2024-05-22 17:10:21,Savings Vault topup,-2.50,0.00,EUR,COMPLETED,14.86
Transfer,Current,2024-05-22 22:09:01,2024-05-22 22:09:01,Pocket Withdrawal,80.00,0.00,EUR,COMPLETED,94.86
Card Payment,Current,2024-05-22 17:10:21,2024-05-23 10:54:11,Centra,-8.50,0.00,EUR,COMPLETED,86.36
Card Payment,Current,2024-05-22 09:00:39,2024-05-23 11:32:01,Copper + Straw,-4.50,0.00,EUR,COMPLETED,81.86
Transfer,Current,2024-05-23 18:03:19,2024-05-23 18:03:19,Savings Vault topup,-0.25,0.00,EUR,COMPLETED,81.61
Transfer,Current,2024-05-23 21:30:41,2024-05-23 21:30:41,Savings Vault topup,-4.85,0.00,EUR,COMPLETED,76.76
Topup,Current,2024-05-24 08:10:49,2024-05-24 08:10:49,Payment from WORKDAY LIMITED,2825.45,0.00,EUR,COMPLETED,2902.21
Transfer,Current,2024-05-24 08:30:35,2024-05-24 08:30:35,Savings Vault topup,-4.70,0.00,EUR,COMPLETED,2897.51
Card Payment,Current,2024-05-23 18:03:19,2024-05-24 09:43:46,Deliveroo,-21.95,0.00,EUR,COMPLETED,2875.56
Card Payment,Current,2024-05-23 21:30:41,2024-05-24 13:40:33,Amazon,-7.03,0.00,EUR,COMPLETED,2868.53
Transfer,Current,2024-05-24 14:29:39,2024-05-24 14:29:40,Transfer from MARA DI RAIMONDO,10.97,0.00,EUR,COMPLETED,2879.50
Transfer,Current,2024-05-24 19:08:19,2024-05-24 19:08:19,Savings Vault topup,-5.00,0.00,EUR,COMPLETED,2874.50
Transfer,Current,2024-05-24 19:18:05,2024-05-24 19:18:05,Savings Vault topup,-3.50,0.00,EUR,COMPLETED,2871.00
Transfer,Current,2024-05-24 19:20:30,2024-05-24 19:20:30,Savings Vault topup,-5.00,0.00,EUR,COMPLETED,2866.00
Card Payment,Current,2024-05-24 08:30:34,2024-05-25 09:39:03,SuperValu,-36.06,0.00,EUR,COMPLETED,2829.94
Card Payment,Current,2024-05-24 19:20:30,2024-05-25 10:23:05,MACE,-8.00,0.00,EUR,COMPLETED,2821.94
Card Payment,Current,2024-05-24 19:18:05,2024-05-25 11:09:02,Tesco,-5.30,0.00,EUR,COMPLETED,2816.64
Transfer,Current,2024-05-25 11:56:48,2024-05-25 11:56:48,Savings Vault topup,-4.50,0.00,EUR,COMPLETED,2812.14
Transfer,Current,2024-05-25 13:00:02,2024-05-25 13:00:02,Transfer from MARA DI RAIMONDO,550.00,0.00,EUR,COMPLETED,3362.14
Transfer,Current,2024-05-25 13:00:08,2024-05-25 13:00:08,Transfer from MARA DI RAIMONDO,25.00,0.00,EUR,COMPLETED,3387.14
Transfer,Current,2024-05-25 13:47:32,2024-05-25 13:47:32,Savings Vault topup,-1.25,0.00,EUR,COMPLETED,3385.89
Transfer,Current,2024-05-25 15:18:23,2024-05-25 15:18:23,Savings Vault topup,-5.00,0.00,EUR,COMPLETED,3380.89
Transfer,Current,2024-05-25 16:20:46,2024-05-25 16:20:46,Savings Vault topup,-3.00,0.00,EUR,COMPLETED,3377.89
Transfer,Current,2024-05-25 16:55:36,2024-05-25 16:55:36,Savings Vault topup,-5.00,0.00,EUR,COMPLETED,3372.89
Card Payment,Current,2024-05-24 19:08:19,2024-05-26 09:59:33,The Merry Cobbler,-70.00,0.00,EUR,COMPLETED,3302.89
Card Payment,Current,2024-05-25 11:56:48,2024-05-26 11:40:52,Gleesons,-8.10,0.00,EUR,COMPLETED,3294.79
Card Payment,Current,2024-05-25 13:47:32,2024-05-26 11:50:28,Hatch Coffee,-4.75,0.00,EUR,COMPLETED,3290.04
Transfer,Current,2024-05-26 11:54:40,2024-05-26 11:54:40,Savings Vault topup,-2.80,0.00,EUR,COMPLETED,3287.24
Transfer,Current,2024-05-26 12:12:14,2024-05-26 12:12:14,Transfer from MARA DI RAIMONDO,15.00,0.00,EUR,COMPLETED,3302.24
Transfer,Current,2024-05-26 12:40:46,2024-05-26 12:40:46,Savings Vault topup,-5.00,0.00,EUR,COMPLETED,3297.24
Transfer,Current,2024-05-26 13:51:37,2024-05-26 13:51:37,Savings Vault topup,-0.25,0.00,EUR,COMPLETED,3296.99
Transfer,Current,2024-05-26 16:15:32,2024-05-26 16:15:32,Savings Vault topup,-5.00,0.00,EUR,COMPLETED,3291.99
Transfer,Current,2024-05-26 17:33:08,2024-05-26 17:33:08,Savings Vault topup,-2.50,0.00,EUR,COMPLETED,3289.49
Transfer,Current,2024-05-26 18:49:44,2024-05-26 18:49:44,Savings Vault topup,-0.80,0.00,EUR,COMPLETED,3288.69
Transfer,Current,2024-05-25 08:16:47,2024-05-27 01:56:09,To Finance Ireland,-1424.50,0.00,EUR,COMPLETED,1864.19
Card Payment,Current,2024-05-25 16:20:46,2024-05-27 09:30:57,Cycle SuperStore,-263.40,0.00,EUR,COMPLETED,1600.79
Card Payment,Current,2024-05-25 15:18:23,2024-05-27 09:31:02,Cycle SuperStore,-210.00,0.00,EUR,COMPLETED,1390.79
Transfer,Current,2024-05-27 09:52:26,2024-05-27 09:52:26,To pocket EUR Subscriptions from EUR,-250.00,0.00,EUR,COMPLETED,1140.79
Card Payment,Current,2024-05-25 16:55:36,2024-05-27 09:58:55,SuperValu,-31.00,0.00,EUR,COMPLETED,1109.79
Card Payment,Current,2024-05-26 13:51:37,2024-05-27 10:11:03,SuperValu,-0.95,0.00,EUR,COMPLETED,1108.84
Card Payment,Current,2024-05-26 12:40:45,2024-05-27 10:36:42,Dunnes Stores,-29.00,0.00,EUR,COMPLETED,1079.84
Card Payment,Current,2024-05-26 18:49:43,2024-05-27 10:56:35,Deliveroo,-46.84,0.00,EUR,COMPLETED,1033.00
Card Payment,Current,2024-05-26 11:54:39,2024-05-27 11:15:26,Brownes of Sandymount,-44.44,0.00,EUR,COMPLETED,988.56
Card Payment,Current,2024-05-26 17:33:08,2024-05-27 11:21:27,The Wicked Wolf,-8.50,0.00,EUR,COMPLETED,980.06
Card Payment,Current,2024-05-26 16:15:32,2024-05-27 11:22:47,Gourmet Food Parlour,-58.00,0.00,EUR,COMPLETED,922.06
Transfer,Current,2024-05-27 14:37:56,2024-05-27 14:37:56,Savings Vault topup,-3.50,0.00,EUR,COMPLETED,918.56
Transfer,Current,2024-05-27 18:34:44,2024-05-27 18:34:45,Savings Vault topup,-1.85,0.00,EUR,COMPLETED,916.71
Transfer,Current,2024-05-27 18:38:37,2024-05-27 18:38:37,Transfer from MARA DI RAIMONDO,23.42,0.00,EUR,COMPLETED,940.13
Transfer,Current,2024-05-27 18:54:57,2024-05-27 18:54:57,Transfer to MARA DI RAIMONDO,-23.50,0.00,EUR,COMPLETED,916.63
Transfer,Current,2024-05-27 18:55:02,2024-05-27 18:55:02,Transfer to MARA DI RAIMONDO,-8.63,0.00,EUR,COMPLETED,908.00
Transfer,Current,2024-05-27 18:55:09,2024-05-27 18:55:09,Transfer to MARA DI RAIMONDO,-16.00,0.00,EUR,COMPLETED,892.00
Transfer,Current,2024-05-28 09:23:26,2024-05-28 09:23:26,Savings Vault topup,-1.50,0.00,EUR,COMPLETED,890.50
Card Payment,Current,2024-05-27 14:37:56,2024-05-28 10:07:39,Clark’s Newsagent,-4.30,0.00,EUR,COMPLETED,886.20
Card Payment,Current,2024-05-27 18:34:44,2024-05-28 11:23:06,ALDI,-35.63,0.00,EUR,COMPLETED,850.57
Transfer,Current,2024-05-28 17:28:04,2024-05-28 17:28:04,Savings Vault topup,-5.00,0.00,EUR,COMPLETED,845.57
Transfer,Current,2024-05-28 17:43:35,2024-05-28 17:43:35,Transfer to MARA DI RAIMONDO,-69.50,0.00,EUR,COMPLETED,776.07
Transfer,Current,2024-05-28 19:44:48,2024-05-28 19:44:48,Savings Vault topup,-1.45,0.00,EUR,COMPLETED,774.62
Card Payment,Current,2024-05-28 17:28:03,2024-05-29 09:37:30,Cut and Sew,-32.00,0.00,EUR,COMPLETED,742.62
Card Payment,Current,2024-05-28 09:23:25,2024-05-29 11:03:09,Copper + Straw,-4.70,0.00,EUR,COMPLETED,737.92
Card Payment,Current,2024-05-28 19:44:48,2024-05-29 14:48:55,Amazon,-33.71,0.00,EUR,COMPLETED,704.21
Transfer,Current,2024-05-29 20:15:29,2024-05-29 20:15:29,Savings Vault topup,-5.00,0.00,EUR,COMPLETED,699.21
Transfer,Current,2024-05-29 20:34:21,2024-05-29 20:34:21,Savings Vault topup,-3.50,0.00,EUR,COMPLETED,695.71
Transfer,Current,2024-05-29 22:45:35,2024-05-29 22:45:35,Savings Vault topup,-2.50,0.00,EUR,COMPLETED,693.21
Transfer,Current,2024-05-30 01:08:04,2024-05-30 01:08:04,Savings Vault topup,-5.00,0.00,EUR,COMPLETED,688.21
Card Payment,Current,2024-05-29 22:45:34,2024-05-30 10:02:43,Finnegans Wake,-13.50,0.00,EUR,COMPLETED,674.71
Card Payment,Current,2024-05-29 20:34:21,2024-05-30 10:02:43,Finnegans Wake,-17.30,0.00,EUR,COMPLETED,657.41
Card Payment,Current,2024-05-29 20:15:28,2024-05-30 11:44:58,SuperValu,-8.00,0.00,EUR,COMPLETED,649.41
Transfer,Current,2024-05-31 12:17:37,2024-05-31 12:17:37,Savings Vault topup,-0.05,0.00,EUR,COMPLETED,649.36
Card Payment,Current,2024-05-30 01:08:03,2024-05-31 12:28:50,FREE NOW,-30.00,0.00,EUR,COMPLETED,619.36
Transfer,Current,2024-05-31 18:12:47,2024-05-31 18:12:47,Savings Vault topup,-2.40,0.00,EUR,COMPLETED,616.96
Transfer,Current,2024-05-31 18:57:40,2024-05-31 18:57:40,Savings Vault topup,-1.75,0.00,EUR,COMPLETED,615.21
Transfer,Current,2024-05-31 19:20:35,2024-05-31 19:20:35,Transfer to MARA DI RAIMONDO,-2.64,0.00,EUR,COMPLETED,612.57
Transfer,Current,2024-05-31 19:20:50,2024-05-31 19:20:50,Savings Vault topup,-1.05,0.00,EUR,COMPLETED,611.52
Transfer,Current,2024-06-01 01:55:42,2024-06-01 01:55:42,Savings Vault topup,-0.60,0.00,EUR,COMPLETED,610.92
Transfer,Current,2024-06-01 08:19:14,2024-06-01 08:19:14,Savings Vault topup,-2.55,0.00,EUR,COMPLETED,608.37
Transfer,Current,2024-06-01 10:40:21,2024-06-01 10:40:21,Savings Vault topup,-0.50,0.00,EUR,COMPLETED,607.87
Transfer,Current,2024-06-01 10:42:58,2024-06-01 10:42:58,Savings Vault topup,-0.05,0.00,EUR,COMPLETED,607.82
Transfer,Current,2024-06-01 10:45:58,2024-06-01 10:45:58,Savings Vault topup,-5.00,0.00,EUR,COMPLETED,602.82
Card Payment,Current,2024-06-01 01:55:42,2024-06-01 10:54:29,geoguessr.com,-23.88,0.00,EUR,COMPLETED,578.94
Card Payment,Current,2024-05-31 19:20:22,2024-06-01 10:55:48,Deliveroo,-35.79,0.00,EUR,COMPLETED,543.15
Transfer,Current,2024-06-01 10:56:14,2024-06-01 10:56:14,Savings Vault topup,-3.75,0.00,EUR,COMPLETED,539.40
Transfer,Current,2024-06-01 11:07:01,2024-06-01 11:07:01,Savings Vault topup,-0.05,0.00,EUR,COMPLETED,539.35
Transfer,Current,2024-06-01 11:15:27,2024-06-01 11:15:27,Savings Vault topup,-5.00,0.00,EUR,COMPLETED,534.35
Card Payment,Current,2024-05-31 18:57:40,2024-06-01 11:45:06,Spar,-1.65,0.00,EUR,COMPLETED,532.70
Transfer,Current,2024-06-01 14:03:58,2024-06-01 14:03:58,Savings Vault topup,-4.00,0.00,EUR,COMPLETED,528.70
Transfer,Current,2024-06-01 14:22:37,2024-06-01 14:22:37,Savings Vault topup,-0.50,0.00,EUR,COMPLETED,528.20
Transfer,Current,2024-06-01 14:43:08,2024-06-01 14:43:08,Savings Vault topup,-2.50,0.00,EUR,COMPLETED,525.70
Card Payment,Current,2024-05-31 18:12:47,2024-06-01 15:01:17,Manchester United,-23.52,0.00,EUR,COMPLETED,502.18
Transfer,Current,2024-06-01 22:45:42,2024-06-01 22:45:42,Savings Vault topup,-4.85,0.00,EUR,COMPLETED,497.33
Transfer,Current,2024-06-01 23:16:53,2024-06-01 23:16:53,Savings Vault topup,-5.00,0.00,EUR,COMPLETED,492.33
Transfer,Current,2024-06-01 23:17:23,2024-06-01 23:17:23,Savings Vault topup,-5.00,0.00,EUR,COMPLETED,487.33
Transfer,Current,2024-06-02 08:31:48,2024-06-02 08:31:48,Savings Vault topup,-1.25,0.00,EUR,COMPLETED,486.08
Transfer,Current,2024-06-02 09:45:07,2024-06-02 09:45:08,From Flexible Cash Funds,100.00,0.00,EUR,COMPLETED,586.08
Transfer,Current,2024-06-02 09:49:32,2024-06-02 09:49:32,Savings Vault topup,-0.50,0.00,EUR,COMPLETED,585.58
Transfer,Current,2024-06-02 09:49:47,2024-06-02 09:49:47,Savings Vault topup,-1.65,0.00,EUR,COMPLETED,583.93
Transfer,Current,2024-06-02 10:28:56,2024-06-02 10:28:56,Savings Vault topup,-5.00,0.00,EUR,COMPLETED,578.93
Card Payment,Current,2024-06-01 10:42:57,2024-06-02 11:05:30,Dublin Dundrum Centre,-17.99,0.00,EUR,COMPLETED,560.94
Card Payment,Current,2024-06-01 08:19:13,2024-06-02 11:33:10,HP,-1.49,0.00,EUR,COMPLETED,559.45
Card Refund,Current,2024-06-01 22:48:13,2024-06-02 11:41:48,EasyPark,0.03,0.00,EUR,COMPLETED,559.48
Card Payment,Current,2024-06-01 22:45:42,2024-06-02 11:41:54,EasyPark,-0.03,0.00,EUR,COMPLETED,559.45
Transfer,Current,2024-06-02 11:49:58,2024-06-02 11:49:58,Savings Vault topup,-5.00,0.00,EUR,COMPLETED,554.45
Card Payment,Current,2024-06-01 11:07:01,2024-06-02 12:10:10,Boots,-12.99,0.00,EUR,COMPLETED,541.46
Card Payment,Current,2024-06-01 10:45:58,2024-06-02 12:10:39,Brown Thomas,-65.00,0.00,EUR,COMPLETED,476.46
Transfer,Current,2024-06-02 12:39:01,2024-06-02 12:39:01,Savings Vault topup,-2.05,0.00,EUR,COMPLETED,474.41
Transfer,Current,2024-06-02 13:29:35,2024-06-02 13:29:35,Transfer from MARA DI RAIMONDO,7.87,0.00,EUR,COMPLETED,482.28
Transfer,Current,2024-06-02 13:29:43,2024-06-02 13:29:43,Transfer from MARA DI RAIMONDO,24.00,0.00,EUR,COMPLETED,506.28
Transfer,Current,2024-06-02 13:29:52,2024-06-02 13:29:52,Savings Vault topup,-2.75,0.00,EUR,COMPLETED,503.53
Transfer,Current,2024-06-02 13:30:31,2024-06-02 13:30:32,Transfer from MARA DI RAIMONDO,23.25,0.00,EUR,COMPLETED,526.78
Transfer,Current,2024-06-02 13:30:37,2024-06-02 13:30:37,Transfer from MARA DI RAIMONDO,12.99,0.00,EUR,COMPLETED,539.77
Transfer,Current,2024-06-02 13:30:43,2024-06-02 13:30:43,Transfer from MARA DI RAIMONDO,65.00,0.00,EUR,COMPLETED,604.77
Transfer,Current,2024-06-02 13:30:49,2024-06-02 13:30:49,Transfer from MARA DI RAIMONDO,14.50,0.00,EUR,COMPLETED,619.27
Transfer,Current,2024-06-02 15:05:07,2024-06-02 15:05:07,Savings Vault topup,-2.50,0.00,EUR,COMPLETED,616.77
Transfer,Current,2024-06-02 15:06:53,2024-06-02 15:06:54,Savings Vault topup,-2.50,0.00,EUR,COMPLETED,614.27
Card Payment,Current,2024-06-01 10:40:21,2024-06-02 15:27:09,Massimo Dutti,-195.90,0.00,EUR,COMPLETED,418.37
Transfer,Current,2024-06-02 16:09:54,2024-06-02 16:09:54,Savings Vault topup,-5.00,0.00,EUR,COMPLETED,413.37
Transfer,Current,2024-06-02 16:14:41,2024-06-02 16:14:41,Savings Vault topup,-4.00,0.00,EUR,COMPLETED,409.37
Transfer,Current,2024-06-02 18:28:05,2024-06-02 18:28:05,Savings Vault topup,-2.85,0.00,EUR,COMPLETED,406.52
Transfer,Current,2024-06-02 20:12:11,2024-06-02 20:12:11,From Flexible Cash Funds,100.00,0.00,EUR,COMPLETED,506.52
Transfer,Current,2024-06-02 20:26:37,2024-06-02 20:26:37,Savings Vault topup,-2.50,0.00,EUR,COMPLETED,504.02
Transfer,Current,2024-06-03 03:14:08,2024-06-03 03:14:08,Savings Vault topup,-0.05,0.00,EUR,COMPLETED,503.97
Card Payment,Current,2024-06-02 18:28:04,2024-06-03 10:00:15,Sorelle A Mare,-25.43,0.00,EUR,COMPLETED,478.54
Card Payment,Current,2024-06-01 14:43:08,2024-06-03 10:11:15,FREE NOW,-46.50,0.00,EUR,COMPLETED,432.04
Card Payment,Current,2024-06-02 16:09:54,2024-06-03 10:30:02,Ricevitoria Signorino,-10.00,0.00,EUR,COMPLETED,422.04
Card Payment,Current,2024-06-01 14:03:58,2024-06-03 10:37:20,Marqette,-16.20,0.00,EUR,COMPLETED,405.84
Card Payment,Current,2024-06-01 10:56:13,2024-06-03 10:52:08,Bagel Factory,-12.25,0.00,EUR,COMPLETED,393.59
Transfer,Current,2024-06-03 10:52:46,2024-06-03 10:52:46,From Flexible Cash Funds,100.00,0.00,EUR,COMPLETED,493.59
Transfer,Current,2024-06-03 10:53:42,2024-06-03 10:53:42,Savings Vault topup,-5.00,0.00,EUR,COMPLETED,488.59
Card Payment,Current,2024-06-01 14:22:36,2024-06-03 10:57:44,Marqette,-11.90,0.00,EUR,COMPLETED,476.69
Card Payment,Current,2024-06-01 11:15:26,2024-06-03 11:01:36,Easytrip,-10.00,0.00,EUR,COMPLETED,466.69
Transfer,Current,2024-06-03 11:20:04,2024-06-03 11:20:04,Savings Vault topup,-5.00,0.00,EUR,COMPLETED,461.69
Card Payment,Current,2024-06-02 10:28:56,2024-06-03 11:39:37,Sudest,-48.00,0.00,EUR,COMPLETED,413.69
Card Payment,Current,2024-06-02 13:29:51,2024-06-03 11:45:20,EasyPark,-13.45,0.00,EUR,COMPLETED,400.24
Card Payment,Current,2024-06-02 13:12:54,2024-06-03 11:45:20,EasyPark,-3.45,0.00,EUR,COMPLETED,396.79
Transfer,Current,2024-06-03 12:16:32,2024-06-03 12:16:32,Savings Vault topup,-5.00,0.00,EUR,COMPLETED,391.79
Card Payment,Current,2024-06-03 03:14:08,2024-06-03 12:20:17,Netflix,-14.99,0.00,EUR,COMPLETED,376.80
Card Payment,Current,2024-06-01 23:16:53,2024-06-03 12:28:07,Al Paninazzo,-13.00,0.00,EUR,COMPLETED,363.80
Card Payment,Current,2024-06-01 23:17:23,2024-06-03 12:28:09,Al Paninazzo,-4.00,0.00,EUR,COMPLETED,359.80
Transfer,Current,2024-06-03 12:32:39,2024-06-03 12:32:39,Savings Vault topup,-0.35,0.00,EUR,COMPLETED,359.45
Card Payment,Current,2024-06-02 09:49:32,2024-06-03 12:45:06,Autogrill,-3.90,0.00,EUR,COMPLETED,355.55
Card Payment,Current,2024-06-02 09:49:46,2024-06-03 12:45:09,Autogrill,-30.67,0.00,EUR,COMPLETED,324.88
Card Payment,Current,2024-06-02 11:49:57,2024-06-03 12:51:32,Autogrill,-5.00,0.00,EUR,COMPLETED,319.88
Transfer,Current,2024-06-03 13:02:58,2024-06-03 13:02:58,From Flexible Cash Funds,100.00,0.00,EUR,COMPLETED,419.88
Card Payment,Current,2024-06-02 20:26:37,2024-06-03 13:08:43,Trattoria Kalliope,-54.50,0.00,EUR,COMPLETED,365.38
Card Payment,Current,2024-06-02 12:39:00,2024-06-03 13:32:49,Amazon,-10.59,0.11,EUR,COMPLETED,354.68
Transfer,Current,2024-06-03 13:53:43,2024-06-03 13:53:43,Savings Vault topup,-5.00,0.00,EUR,COMPLETED,349.68
Transfer,Current,2024-06-03 14:18:52,2024-06-03 14:18:52,Savings Vault topup,-5.00,0.00,EUR,COMPLETED,344.68
Transfer,Current,2024-06-03 17:01:02,2024-06-03 17:01:02,Savings Vault topup,-2.50,0.00,EUR,COMPLETED,342.18
Transfer,Current,2024-06-03 19:08:14,2024-06-03 19:08:28,Transfer from MARA DI RAIMONDO,5.00,0.00,EUR,COMPLETED,347.18
Transfer,Current,2024-06-03 19:08:27,2024-06-03 19:08:36,Transfer from MARA DI RAIMONDO,3.00,0.00,EUR,COMPLETED,350.18
Transfer,Current,2024-06-03 19:08:08,2024-06-03 19:08:36,Transfer from MARA DI RAIMONDO,10.00,0.00,EUR,COMPLETED,360.18
Transfer,Current,2024-06-03 19:08:22,2024-06-03 19:08:36,Transfer from MARA DI RAIMONDO,8.00,0.00,EUR,COMPLETED,368.18
Transfer,Current,2024-06-03 19:09:08,2024-06-03 19:10:39,Transfer from MARA DI RAIMONDO,19.50,0.00,EUR,COMPLETED,387.68
Transfer,Current,2024-06-03 19:08:59,2024-06-03 19:10:41,Transfer from MARA DI RAIMONDO,25.00,0.00,EUR,COMPLETED,412.68
Card Payment,Current,2024-06-02 08:31:48,2024-06-03 19:11:24,Ryanair,-15.75,0.00,EUR,COMPLETED,396.93
Card Payment,Current,2024-06-02 15:05:07,2024-06-03 19:16:43,Optuyia,-47.50,0.00,EUR,COMPLETED,349.43
Card Payment,Current,2024-06-02 15:06:53,2024-06-03 19:16:52,Optuyia,-7.50,0.00,EUR,COMPLETED,341.93
Card Payment,Current,2024-06-02 16:14:41,2024-06-03 19:20:01,Coop,-1.20,0.00,EUR,COMPLETED,340.73
Transfer,Current,2024-06-03 19:56:24,2024-06-03 19:56:24,Savings Vault topup,-2.50,0.00,EUR,COMPLETED,338.23
Transfer,Current,2024-06-04 02:51:45,2024-06-04 02:51:45,Savings Vault topup,-0.05,0.00,EUR,COMPLETED,338.18
Transfer,Current,2024-06-04 09:10:39,2024-06-04 09:10:39,Savings Vault topup,-0.50,0.00,EUR,COMPLETED,337.68
Transfer,Current,2024-06-04 09:36:30,2024-06-04 09:36:30,Savings Vault topup,-0.20,0.00,EUR,COMPLETED,337.48
Card Payment,Current,2024-06-03 10:22:07,2024-06-04 11:24:12,Sudest,-50.00,0.00,EUR,COMPLETED,287.48
Card Payment,Current,2024-06-03 12:16:32,2024-06-04 11:26:38,Burgio Salumeria,-21.00,0.00,EUR,COMPLETED,266.48
Card Payment,Current,2024-06-03 19:56:24,2024-06-04 11:26:41,A Putia,-42.50,0.00,EUR,COMPLETED,223.98
Card Payment,Current,2024-06-03 13:53:43,2024-06-04 11:26:47,Pianeta Mare,-20.00,0.00,EUR,COMPLETED,203.98
Transfer,Current,2024-06-04 11:36:51,2024-06-04 11:36:51,From Flexible Cash Funds,100.00,0.00,EUR,COMPLETED,303.98
Card Payment,Current,2024-06-03 11:20:04,2024-06-04 11:43:35,Di Paola Danny,-10.00,0.00,EUR,COMPLETED,293.98
Transfer,Current,2024-06-04 14:13:16,2024-06-04 14:13:16,Savings Vault topup,-4.00,0.00,EUR,COMPLETED,289.98
Transfer,Current,2024-06-04 15:37:16,2024-06-04 15:37:16,Savings Vault topup,-5.00,0.00,EUR,COMPLETED,284.98
Transfer,Current,2024-06-04 15:55:33,2024-06-04 15:55:33,Transfer to MARA DI RAIMONDO,-16.50,0.00,EUR,COMPLETED,268.48
Transfer,Current,2024-06-04 15:57:47,2024-06-04 15:57:47,Transfer from MARA DI RAIMONDO,8.00,0.00,EUR,COMPLETED,276.48
Transfer,Current,2024-06-04 15:57:48,2024-06-04 15:57:48,Transfer to MARA DI RAIMONDO,-6.00,0.00,EUR,COMPLETED,270.48
Exchange,Current,2024-06-04 16:29:00,2024-06-04 16:29:00,Exchanged to EUR,8472.20,0.00,EUR,COMPLETED,8742.68
Transfer,Current,2024-06-04 16:29:17,2024-06-04 16:29:17,Savings Vault topup,-8472.20,0.00,EUR,COMPLETED,270.48
Card Payment,Current,2024-06-03 10:53:41,2024-06-04 17:08:48,Viola Espresso Bar,-9.00,0.00,EUR,COMPLETED,261.48
Card Payment,Current,2024-06-03 14:18:52,2024-06-04 17:08:54,Lido Camomilla,-10.00,0.00,EUR,COMPLETED,251.48
Card Payment,Current,2024-06-03 17:01:02,2024-06-04 17:10:37,Viola Espresso Bar,-13.50,0.00,EUR,COMPLETED,237.98
Card Payment,Current,2024-06-03 12:32:39,2024-06-04 17:10:49,Coop,-9.93,0.00,EUR,COMPLETED,228.05
ATM,Current,2024-06-03 13:03:44,2024-06-04 17:32:21,Cash withdrawal at Via Cavour 71,-53.95,0.00,EUR,COMPLETED,174.10
Transfer,Current,2024-06-04 18:38:59,2024-06-04 18:39:00,Savings Vault topup,-5.00,0.00,EUR,COMPLETED,169.10
Transfer,Current,2024-06-04 18:45:03,2024-06-04 18:45:03,Savings Vault topup,-1.65,0.00,EUR,COMPLETED,167.45
Transfer,Current,2024-06-04 20:31:27,2024-06-04 20:31:27,From Flexible Cash Funds,100.00,0.00,EUR,COMPLETED,267.45
Transfer,Current,2024-06-04 20:31:38,2024-06-04 20:31:38,Savings Vault topup,-5.00,0.00,EUR,COMPLETED,262.45
Transfer,Current,2024-06-04 21:42:00,2024-06-04 21:42:00,Transfer to MARA DI RAIMONDO,-4.30,0.00,EUR,COMPLETED,258.15
Transfer,Current,2024-06-04 21:43:09,2024-06-04 21:43:09,Transfer from MARA DI RAIMONDO,25.50,0.00,EUR,COMPLETED,283.65
Transfer,Current,2024-06-04 22:11:43,2024-06-04 22:11:43,Transfer from MARA DI RAIMONDO,41.91,0.00,EUR,COMPLETED,325.56
Transfer,Current,2024-06-04 22:12:12,2024-06-04 22:12:12,Transfer from MARA DI RAIMONDO,44.75,0.00,EUR,COMPLETED,370.31
Card Payment,Current,2024-06-04 09:36:30,2024-06-05 02:57:54,YouTube,-1.96,0.00,EUR,COMPLETED,368.35
Card Payment,Current,2024-05-31 12:17:37,2024-06-05 09:36:07,Ryanair,-46.99,0.00,EUR,COMPLETED,321.36
Card Payment,Current,2024-06-04 15:37:16,2024-06-05 10:09:29,Lantieri Luca,-26.00,0.00,EUR,COMPLETED,295.36
Card Payment,Current,2024-06-04 02:51:44,2024-06-05 10:34:39,Apple,-2.99,0.00,EUR,COMPLETED,292.37
Card Payment,Current,2024-06-04 18:38:59,2024-06-05 10:55:17,Tabacchi Riv 12,-8.00,0.00,EUR,COMPLETED,284.37
Card Payment,Current,2024-06-04 14:13:15,2024-06-05 10:55:51,Trattoria Archimede,-14.20,0.00,EUR,COMPLETED,270.17
Transfer,Current,2024-06-05 11:03:31,2024-06-05 11:03:31,Savings Vault topup,-2.50,0.00,EUR,COMPLETED,267.67
Transfer,Current,2024-06-05 11:08:49,2024-06-05 11:08:49,Savings Vault topup,-0.05,0.00,EUR,COMPLETED,267.62
Card Payment,Current,2024-06-04 09:10:39,2024-06-05 11:56:53,Pharmacy Mangiafico Dr. Serafina,-19.90,0.00,EUR,COMPLETED,247.72
Card Payment,Current,2024-06-04 20:31:38,2024-06-05 12:01:59,S.r.f. Srl Via Cavo..,-59.00,0.00,EUR,COMPLETED,188.72
Transfer,Current,2024-06-05 12:54:29,2024-06-05 12:54:29,Savings Vault topup,-5.00,0.00,EUR,COMPLETED,183.72
Transfer,Current,2024-06-05 14:00:45,2024-06-05 14:00:45,Savings Vault topup,-5.00,0.00,EUR,COMPLETED,178.72
Transfer,Current,2024-06-05 14:36:52,2024-06-05 14:36:52,Savings Vault topup,-2.25,0.00,EUR,COMPLETED,176.47
Transfer,Current,2024-06-05 14:46:29,2024-06-05 14:46:29,Savings Vault topup,-5.00,0.00,EUR,COMPLETED,171.47
Card Payment,Current,2024-06-04 18:45:03,2024-06-05 17:19:46,Coop,-8.67,0.00,EUR,COMPLETED,162.80
Transfer,Current,2024-06-05 21:15:13,2024-06-05 21:15:13,From Flexible Cash Funds,200.00,0.00,EUR,COMPLETED,362.80
Transfer,Current,2024-06-05 21:18:21,2024-06-05 21:18:21,Savings Vault topup,-5.00,0.00,EUR,COMPLETED,357.80
Transfer,Current,2024-06-06 05:49:39,2024-06-06 05:49:39,Savings Vault topup,-0.50,0.00,EUR,COMPLETED,357.30
Transfer,Current,2024-06-06 07:36:25,2024-06-06 07:36:25,Savings Vault topup,-1.00,0.00,EUR,COMPLETED,356.30
Card Payment,Current,2024-06-05 14:00:45,2024-06-06 10:01:30,Sabbinirica Bistr,-39.00,0.00,EUR,COMPLETED,317.30
Transfer,Current,2024-06-06 11:17:46,2024-06-06 11:17:46,Savings Vault topup,-4.30,0.00,EUR,COMPLETED,313.00
Transfer,Current,2024-06-06 12:03:09,2024-06-06 12:03:09,Savings Vault topup,-2.65,0.00,EUR,COMPLETED,310.35
Transfer,Current,2024-06-06 12:07:06,2024-06-06 12:07:06,Savings Vault topup,-3.00,0.00,EUR,COMPLETED,307.35
Card Payment,Current,2024-06-05 12:54:29,2024-06-06 12:18:46,Caffè Sicilia,-2.00,0.00,EUR,COMPLETED,305.35
Card Payment,Current,2024-06-05 21:18:21,2024-06-06 12:18:48,Pizzeria Ristorante L..,-115.00,0.00,EUR,COMPLETED,190.35
Card Payment,Current,2024-06-05 14:36:52,2024-06-06 12:18:48,Caffè Sicilia,-13.55,0.00,EUR,COMPLETED,176.80
Transfer,Current,2024-06-06 12:53:01,2024-06-06 12:53:01,Savings Vault topup,-5.00,0.00,EUR,COMPLETED,171.80
Transfer,Current,2024-06-06 15:00:14,2024-06-06 15:00:14,Savings Vault topup,-1.50,0.00,EUR,COMPLETED,170.30
Transfer,Current,2024-06-06 15:22:09,2024-06-06 15:22:09,To pocket EUR Subscriptions from EUR,-50.00,0.00,EUR,COMPLETED,120.30
Transfer,Current,2024-06-06 17:16:33,2024-06-06 17:16:33,Savings Vault topup,-4.70,0.00,EUR,COMPLETED,115.60
Transfer,Current,2024-06-06 19:43:28,2024-06-06 19:43:28,From Flexible Cash Funds,100.00,0.00,EUR,COMPLETED,215.60
Transfer,Current,2024-06-06 19:52:11,2024-06-06 19:52:11,Savings Vault topup,-2.50,0.00,EUR,COMPLETED,213.10
Transfer,Current,2024-06-07 08:55:59,2024-06-07 08:55:59,Savings Vault topup,-0.50,0.00,EUR,COMPLETED,212.60
Transfer,Current,2024-06-07 09:21:22,2024-06-07 09:21:22,Savings Vault topup,-5.00,0.00,EUR,COMPLETED,207.60
Transfer,Current,2024-06-07 09:27:06,2024-06-07 09:27:06,Savings Vault topup,-3.20,0.00,EUR,COMPLETED,204.40
Transfer,Current,2024-06-07 10:23:01,2024-06-07 10:23:01,Savings Vault topup,-5.00,0.00,EUR,COMPLETED,199.40
Card Payment,Current,2024-06-05 14:46:29,2024-06-07 10:40:10,Caia Marco,-5.00,0.00,EUR,COMPLETED,194.40
Card Payment,Current,2024-06-05 11:08:48,2024-06-07 10:45:52,Coop,-2.99,0.00,EUR,COMPLETED,191.41
Card Payment,Current,2024-06-05 11:03:31,2024-06-07 10:45:54,Viola Espresso Bar,-10.50,0.00,EUR,COMPLETED,180.91
Transfer,Current,2024-06-07 11:41:34,2024-06-07 11:41:35,Transfer to MARA DI RAIMONDO,-7.00,0.00,EUR,COMPLETED,173.91
Transfer,Current,2024-06-07 11:41:37,2024-06-07 11:41:37,Transfer from MARA DI RAIMONDO,10.00,0.00,EUR,COMPLETED,183.91
Transfer,Current,2024-06-07 11:41:38,2024-06-07 11:41:38,Transfer to MARA DI RAIMONDO,-2.50,0.00,EUR,COMPLETED,181.41
Transfer,Current,2024-06-07 11:41:42,2024-06-07 11:41:42,Transfer to MARA DI RAIMONDO,-7.50,0.00,EUR,COMPLETED,173.91
Transfer,Current,2024-06-07 11:41:56,2024-06-07 11:41:56,Transfer from MARA DI RAIMONDO,10.00,0.00,EUR,COMPLETED,183.91
Transfer,Current,2024-06-07 11:42:06,2024-06-07 11:42:06,Transfer from MARA DI RAIMONDO,3.73,0.00,EUR,COMPLETED,187.64
Transfer,Current,2024-06-07 11:42:13,2024-06-07 11:42:13,Transfer from MARA DI RAIMONDO,3.68,0.00,EUR,COMPLETED,191.32
Transfer,Current,2024-06-07 11:42:18,2024-06-07 11:42:18,Transfer from MARA DI RAIMONDO,3.50,0.00,EUR,COMPLETED,194.82
Transfer,Current,2024-06-07 11:59:47,2024-06-07 11:59:47,Savings Vault topup,-5.00,0.00,EUR,COMPLETED,189.82
Transfer,Current,2024-06-07 12:12:20,2024-06-07 12:12:20,Savings Vault topup,-3.00,0.00,EUR,COMPLETED,186.82
Card Payment,Current,2024-06-06 19:52:11,2024-06-07 12:51:09,A Putia,-42.50,0.00,EUR,COMPLETED,144.32
Transfer,Current,2024-06-07 14:52:17,2024-06-07 14:52:17,Savings Vault topup,-5.00,0.00,EUR,COMPLETED,139.32
Card Payment,Current,2024-06-06 11:17:45,2024-06-07 15:07:26,Amazon,-7.14,0.00,EUR,COMPLETED,132.18
Transfer,Current,2024-06-07 15:13:28,2024-06-07 15:13:28,From Flexible Cash Funds,100.00,0.00,EUR,COMPLETED,232.18
Transfer,Current,2024-06-07 15:13:35,2024-06-07 15:13:35,Savings Vault topup,-5.00,0.00,EUR,COMPLETED,227.18
Card Payment,Current,2024-06-06 17:16:32,2024-06-07 15:51:13,Splice,-9.06,0.00,EUR,COMPLETED,218.12
Card Payment,Current,2024-06-06 12:03:09,2024-06-07 17:43:16,Coop,-7.47,0.00,EUR,COMPLETED,210.65
Card Payment,Current,2024-06-06 07:36:24,2024-06-07 17:43:18,Viola Espresso Bar,-8.80,0.00,EUR,COMPLETED,201.85
Card Payment,Current,2024-06-06 15:00:13,2024-06-07 17:43:32,Lido Fontane Bianche,-7.70,0.00,EUR,COMPLETED,194.15
Card Payment,Current,2024-06-06 05:49:39,2024-06-07 17:43:37,Caffè Aretusa,-7.90,0.00,EUR,COMPLETED,186.25
Card Payment,Current,2024-06-06 12:07:06,2024-06-07 17:44:41,Viola Espresso Bar,-2.40,0.00,EUR,COMPLETED,183.85
Card Payment,Current,2024-06-06 12:53:01,2024-06-07 17:45:43,Lido Fontane Bianche,-20.00,0.00,EUR,COMPLETED,163.85
Transfer,Current,2024-06-07 18:17:36,2024-06-07 18:17:36,Savings Vault topup,-2.50,0.00,EUR,COMPLETED,161.35
Transfer,Current,2024-06-07 19:21:46,2024-06-07 19:21:46,Savings Vault topup,-5.00,0.00,EUR,COMPLETED,156.35
Transfer,Current,2024-06-07 19:53:24,2024-06-07 19:53:24,Savings Vault topup,-5.00,0.00,EUR,COMPLETED,151.35
Transfer,Current,2024-06-07 21:37:28,2024-06-07 21:37:28,From Flexible Cash Funds,100.00,0.00,EUR,COMPLETED,251.35
Transfer,Current,2024-06-07 21:37:39,2024-06-07 21:37:39,Savings Vault topup,-5.00,0.00,EUR,COMPLETED,246.35
Transfer,Current,2024-06-07 22:08:47,2024-06-07 22:08:47,Savings Vault topup,-2.50,0.00,EUR,COMPLETED,243.85
Transfer,Current,2024-06-08 07:25:49,2024-06-08 07:25:49,Savings Vault topup,-0.05,0.00,EUR,COMPLETED,243.80
Transfer,Current,2024-06-08 09:25:53,2024-06-08 09:25:53,Savings Vault topup,-3.50,0.00,EUR,COMPLETED,240.30
Transfer,Current,2024-06-08 10:21:13,2024-06-08 10:21:13,From Flexible Cash Funds,25.00,0.00,EUR,COMPLETED,265.30
Transfer,Current,2024-06-08 10:32:56,2024-06-08 10:32:56,From Flexible Cash Funds,100.00,0.00,EUR,COMPLETED,365.30
Transfer,Current,2024-06-08 10:33:53,2024-06-08 10:33:53,Savings Vault topup,-4.55,0.00,EUR,COMPLETED,360.75
Card Payment,Current,2024-06-07 19:53:24,2024-06-08 11:18:30,Qbo Pets,-25.00,0.00,EUR,COMPLETED,335.75
Card Payment,Current,2024-06-07 21:37:39,2024-06-08 11:32:59,La Tavernetta Uno Da Sim,-57.00,0.00,EUR,COMPLETED,278.75
Transfer,Current,2024-06-08 14:21:56,2024-06-08 14:21:56,Savings Vault topup,-3.55,0.00,EUR,COMPLETED,275.20
Transfer,Current,2024-06-08 15:54:19,2024-06-08 15:54:19,Savings Vault topup,-5.00,0.00,EUR,COMPLETED,270.20
Transfer,Current,2024-06-08 17:06:04,2024-06-08 17:06:04,Transfer from MARA DI RAIMONDO,2.00,0.00,EUR,COMPLETED,272.20
Transfer,Current,2024-06-08 17:06:07,2024-06-08 17:06:07,Transfer from MARA DI RAIMONDO,12.50,0.00,EUR,COMPLETED,284.70
Transfer,Current,2024-06-08 17:06:10,2024-06-08 17:06:10,Transfer from MARA DI RAIMONDO,22.49,0.00,EUR,COMPLETED,307.19
Transfer,Current,2024-06-08 17:06:14,2024-06-08 17:06:14,Transfer from MARA DI RAIMONDO,4.15,0.00,EUR,COMPLETED,311.34
Transfer,Current,2024-06-08 17:06:18,2024-06-08 17:06:18,Transfer from MARA DI RAIMONDO,22.00,0.00,EUR,COMPLETED,333.34
Transfer,Current,2024-06-08 17:06:21,2024-06-08 17:06:21,Transfer from MARA DI RAIMONDO,13.00,0.00,EUR,COMPLETED,346.34
Transfer,Current,2024-06-08 17:06:25,2024-06-08 17:06:25,Transfer from MARA DI RAIMONDO,5.67,0.00,EUR,COMPLETED,352.01
Transfer,Current,2024-06-08 17:06:35,2024-06-08 17:06:35,Transfer from MARA DI RAIMONDO,18.00,0.00,EUR,COMPLETED,370.01
Transfer,Current,2024-06-08 17:07:09,2024-06-08 17:07:10,Transfer from MARA DI RAIMONDO,57.50,0.00,EUR,COMPLETED,427.51
Transfer,Current,2024-06-08 17:07:13,2024-06-08 17:07:13,Transfer from MARA DI RAIMONDO,19.50,0.00,EUR,COMPLETED,447.01
Transfer,Current,2024-06-08 17:08:16,2024-06-08 17:08:16,Transfer to MARA DI RAIMONDO,-6.50,0.00,EUR,COMPLETED,440.51
Transfer,Current,2024-06-08 17:08:28,2024-06-08 17:08:28,Transfer to MARA DI RAIMONDO,-1.00,0.00,EUR,COMPLETED,439.51
Transfer,Current,2024-06-08 17:09:04,2024-06-08 17:09:04,Transfer from MARA DI RAIMONDO,32.00,0.00,EUR,COMPLETED,471.51
Card Payment,Current,2024-06-07 22:08:47,2024-06-08 17:17:27,Molla Amdad,-1.50,0.00,EUR,COMPLETED,470.01
Card Payment,Current,2024-06-07 09:27:06,2024-06-08 17:43:58,Coop,-7.36,0.00,EUR,COMPLETED,462.65
Card Payment,Current,2024-06-07 10:23:01,2024-06-08 17:44:28,Lido Fontane Bianche,-20.00,0.00,EUR,COMPLETED,442.65
Transfer,Current,2024-06-08 17:44:45,2024-06-08 17:44:45,Savings Vault topup,-4.90,0.00,EUR,COMPLETED,437.75
Card Payment,Current,2024-06-07 19:21:45,2024-06-08 17:46:31,BOATS,-9.00,0.00,EUR,COMPLETED,428.75
Card Payment,Current,2024-06-07 09:21:22,2024-06-08 17:47:14,Viola Espresso Bar,-10.00,0.00,EUR,COMPLETED,418.75
Card Payment,Current,2024-06-07 08:55:59,2024-06-08 17:47:15,Coop,-12.90,0.00,EUR,COMPLETED,405.85
Card Payment,Current,2024-06-07 11:59:47,2024-06-08 17:47:36,Lido Fontane Bianche,-7.00,0.00,EUR,COMPLETED,398.85
Card Payment,Current,2024-06-07 14:52:17,2024-06-08 17:47:37,Lido Fontane Bianche,-8.00,0.00,EUR,COMPLETED,390.85
Card Payment,Current,2024-06-07 12:12:19,2024-06-08 17:47:37,Lido Fontane Bianche,-2.40,0.00,EUR,COMPLETED,388.45
Card Payment,Current,2024-06-07 15:13:35,2024-06-08 17:47:37,Lido Fontane Bianche,-4.00,0.00,EUR,COMPLETED,384.45
Card Payment,Current,2024-06-07 18:17:36,2024-06-08 17:47:45,Viola Espresso Bar,-10.50,0.00,EUR,COMPLETED,373.95
Transfer,Current,2024-06-08 18:09:52,2024-06-08 18:09:52,Savings Vault topup,-4.50,0.00,EUR,COMPLETED,369.45
Transfer,Current,2024-06-08 18:44:28,2024-06-08 18:44:28,Savings Vault topup,-3.00,0.00,EUR,COMPLETED,366.45
Transfer,Current,2024-06-08 18:50:35,2024-06-08 18:50:35,Savings Vault topup,-3.50,0.00,EUR,COMPLETED,362.95
Transfer,Current,2024-06-09 00:02:18,2024-06-09 00:02:18,Savings Vault topup,-4.50,0.00,EUR,COMPLETED,358.45
Card Payment,Current,2024-06-08 14:21:55,2024-06-09 09:14:35,EasyPark,-1.29,0.00,EUR,COMPLETED,357.16
Card Payment,Current,2024-06-08 15:54:18,2024-06-09 11:20:53,Q8,-64.00,0.00,EUR,COMPLETED,293.16
Card Payment,Current,2024-06-08 18:44:27,2024-06-09 11:20:59,Discover Sicily,-5.40,0.00,EUR,COMPLETED,287.76
Card Payment,Current,2024-06-08 09:25:52,2024-06-09 12:08:48,Viola Espresso Bar,-8.30,0.00,EUR,COMPLETED,279.46
Transfer,Current,2024-06-09 12:18:58,2024-06-09 12:18:58,Savings Vault topup,-1.95,0.00,EUR,COMPLETED,277.51
Transfer,Current,2024-06-09 12:34:09,2024-06-09 12:34:09,Savings Vault topup,-0.45,0.00,EUR,COMPLETED,277.06
Card Payment,Current,2024-06-08 17:44:45,2024-06-09 12:56:56,Amazon,-8.02,0.08,EUR,COMPLETED,268.96
Transfer,Current,2024-06-09 13:10:43,2024-06-09 13:10:44,Transfer from MARA DI RAIMONDO,22.55,0.00,EUR,COMPLETED,291.51
Transfer,Current,2024-06-09 13:12:32,2024-06-09 13:12:32,Transfer to MARA DI RAIMONDO,-1.00,0.00,EUR,COMPLETED,290.51
Transfer,Current,2024-06-09 13:23:35,2024-06-09 13:23:35,Transfer from MARA DI RAIMONDO,3.50,0.00,EUR,COMPLETED,294.01
Transfer,Current,2024-06-09 13:23:43,2024-06-09 13:23:44,Transfer from MARA DI RAIMONDO,4.33,0.00,EUR,COMPLETED,298.34
Transfer,Current,2024-06-09 13:23:47,2024-06-09 13:23:47,Transfer from MARA DI RAIMONDO,15.00,0.00,EUR,COMPLETED,313.34
Transfer,Current,2024-06-09 13:23:50,2024-06-09 13:23:50,Transfer from MARA DI RAIMONDO,6.75,0.00,EUR,COMPLETED,320.09
Transfer,Current,2024-06-09 13:23:54,2024-06-09 13:23:54,Transfer from MARA DI RAIMONDO,15.00,0.00,EUR,COMPLETED,335.09
Transfer,Current,2024-06-09 16:58:17,2024-06-09 16:58:18,Savings Vault topup,-0.15,0.00,EUR,COMPLETED,334.94
Transfer,Current,2024-06-09 17:28:44,2024-06-09 17:28:44,Savings Vault topup,-5.00,0.00,EUR,COMPLETED,329.94
Card Payment,Current,2024-06-09 17:28:44,2024-06-10 09:40:40,Blackrock Village Centre,-1.00,0.00,EUR,COMPLETED,328.94
Card Payment,Current,2024-06-09 12:18:58,2024-06-10 10:08:05,Lidl,-50.61,0.00,EUR,COMPLETED,278.33
Card Payment,Current,2024-06-09 12:34:09,2024-06-10 10:37:57,SuperValu,-23.91,0.00,EUR,COMPLETED,254.42
Card Payment,Current,2024-06-09 16:58:17,2024-06-10 10:49:41,Camile Thai,-34.97,0.00,EUR,COMPLETED,219.45
Card Payment,Current,2024-06-08 10:22:10,2024-06-10 11:41:53,Eni,-25.02,0.00,EUR,COMPLETED,194.43
Card Payment,Current,2024-06-08 10:20:00,2024-06-10 11:41:53,Eni,-11.34,0.00,EUR,COMPLETED,183.09
Card Payment,Current,2024-06-08 18:09:52,2024-06-10 11:42:47,Autogrill,-8.10,0.00,EUR,COMPLETED,174.99
Card Payment,Current,2024-06-08 18:50:35,2024-06-10 11:42:49,Autogrill,-4.30,0.00,EUR,COMPLETED,170.69
Card Payment,Current,2024-06-09 00:02:18,2024-06-10 12:04:10,Bilal Pasha/taxi,-45.10,0.00,EUR,COMPLETED,125.59
Card Payment,Current,2024-06-08 10:33:53,2024-06-10 12:14:29,Autogrill Bagali Est Ss,-5.09,0.00,EUR,COMPLETED,120.50
Transfer,Current,2024-06-11 08:25:20,2024-06-11 08:25:20,Savings Vault topup,-0.05,0.00,EUR,COMPLETED,120.45
Transfer,Current,2024-06-11 08:43:54,2024-06-11 08:43:54,From Flexible Cash Funds,100.00,0.00,EUR,COMPLETED,220.45
Transfer,Current,2024-06-11 08:51:43,2024-06-11 08:51:43,Savings Vault topup,-2.75,0.00,EUR,COMPLETED,217.70
Card Payment,Current,2024-06-08 07:25:49,2024-06-11 09:14:44,Ryanair,-44.99,0.00,EUR,COMPLETED,172.71
Transfer,Current,2024-06-11 01:00:00,2024-06-11 11:44:47,To Virgin Media Ireland Limited,-60.00,0.00,EUR,COMPLETED,112.71
Transfer,Current,2024-06-11 12:28:43,2024-06-11 12:28:44,Transfer from MARA DI RAIMONDO,15.99,0.00,EUR,COMPLETED,128.70
Transfer,Current,2024-06-11 12:28:46,2024-06-11 12:28:46,Transfer from MARA DI RAIMONDO,7.00,0.00,EUR,COMPLETED,135.70
Transfer,Current,2024-06-11 12:29:23,2024-06-11 12:29:23,Transfer from MARA DI RAIMONDO,30.00,0.00,EUR,COMPLETED,165.70
Transfer,Current,2024-06-11 16:40:43,2024-06-11 16:40:43,Savings Vault topup,-0.05,0.00,EUR,COMPLETED,165.65
Card Payment,Current,2024-06-11 08:25:20,2024-06-12 08:48:12,Apple,-6.99,0.00,EUR,COMPLETED,158.66
Card Payment,Current,2024-06-11 16:40:43,2024-06-12 08:56:52,Apple,-19.99,0.00,EUR,COMPLETED,138.67
Card Payment,Current,2024-06-11 08:51:43,2024-06-12 12:53:26,OXMANTOWN,-4.45,0.00,EUR,COMPLETED,134.22
Transfer,Current,2024-06-12 14:23:06,2024-06-12 14:23:06,Savings Vault topup,-1.25,0.00,EUR,COMPLETED,132.97
Transfer,Current,2024-06-12 16:41:00,2024-06-12 16:41:00,Savings Vault topup,-5.00,0.00,EUR,COMPLETED,127.97
Transfer,Current,2024-06-12 18:23:25,2024-06-12 18:23:25,Savings Vault topup,-2.00,0.00,EUR,COMPLETED,125.97
Transfer,Current,2024-06-12 19:54:36,2024-06-12 19:54:36,Transfer to JOHN DANIEL KIELY,-20.00,0.00,EUR,COMPLETED,105.97
Transfer,Current,2024-06-13 09:01:46,2024-06-13 09:01:46,Transfer to JOHN DANIEL KIELY,-5.00,0.00,EUR,COMPLETED,100.97
Card Payment,Current,2024-06-12 18:23:25,2024-06-13 09:49:33,Kehoes Pub,-13.60,0.00,EUR,COMPLETED,87.37
Card Payment,Current,2024-06-12 14:23:06,2024-06-13 10:46:02,Ryanair,-8.75,0.00,EUR,COMPLETED,78.62
Card Payment,Current,2024-06-12 16:41:00,2024-06-14 10:53:13,The Ferryman,-7.00,0.00,EUR,COMPLETED,71.62
Card Payment,Current,2024-06-13 22:16:28,2024-06-14 12:51:11,GoMo,-9.99,0.00,EUR,COMPLETED,61.63
Transfer,Current,2024-06-14 17:54:53,2024-06-14 17:54:53,Savings Vault topup,-0.55,0.00,EUR,COMPLETED,61.08
Transfer,Current,2024-06-14 19:05:00,2024-06-14 19:05:01,Savings Vault topup,-2.55,0.00,EUR,COMPLETED,58.53
Transfer,Current,2024-06-14 19:13:37,2024-06-14 19:13:37,Savings Vault topup,-2.25,0.00,EUR,COMPLETED,56.28
Transfer,Current,2024-06-14 20:33:53,2024-06-14 20:33:53,Transfer to SAM GREEN,-17.00,0.00,EUR,COMPLETED,39.28
Transfer,Current,2024-06-14 20:39:59,2024-06-14 20:39:59,From Flexible Cash Funds,100.00,0.00,EUR,COMPLETED,139.28
Transfer,Current,2024-06-14 20:40:50,2024-06-14 20:40:50,Savings Vault topup,-5.00,0.00,EUR,COMPLETED,134.28
Transfer,Current,2024-06-14 22:38:56,2024-06-14 22:38:56,Savings Vault topup,-5.00,0.00,EUR,COMPLETED,129.28
Transfer,Current,2024-06-15 00:25:57,2024-06-15 00:25:57,From Flexible Cash Funds,100.00,0.00,EUR,COMPLETED,229.28
Transfer,Current,2024-06-15 00:27:35,2024-06-15 00:27:35,Savings Vault topup,-5.00,0.00,EUR,COMPLETED,224.28
Transfer,Current,2024-06-15 02:00:32,2024-06-15 02:00:32,Savings Vault topup,-5.00,0.00,EUR,COMPLETED,219.28
Transfer,Current,2024-06-15 02:51:07,2024-06-15 02:51:07,Savings Vault topup,-3.00,0.00,EUR,COMPLETED,216.28
Transfer,Current,2024-06-15 09:10:47,2024-06-15 09:10:47,Savings Vault topup,-2.55,0.00,EUR,COMPLETED,213.73
Transfer,Current,2024-06-15 09:19:25,2024-06-15 09:19:25,From Flexible Cash Funds,100.00,0.00,EUR,COMPLETED,313.73
Transfer,Current,2024-06-15 09:19:39,2024-06-15 09:19:39,Savings Vault topup,-4.30,0.00,EUR,COMPLETED,309.43
Card Payment,Current,2024-06-14 19:13:36,2024-06-15 11:30:16,Bambino,-11.55,0.00,EUR,COMPLETED,297.88
Card Payment,Current,2024-06-14 19:05:00,2024-06-15 16:35:09,Craft Central,-9.49,0.00,EUR,COMPLETED,288.39
Card Payment,Current,2024-06-14 17:54:53,2024-06-15 16:35:14,Craft Central,-13.89,0.00,EUR,COMPLETED,274.50
Card Payment,Current,2024-06-15 02:00:32,2024-06-15 16:39:29,4 Dame Lane,-39.00,0.00,EUR,COMPLETED,235.50
Card Payment,Current,2024-06-14 20:40:50,2024-06-16 09:47:45,The Workman's Club,-24.00,0.00,EUR,COMPLETED,211.50
Card Payment,Current,2024-06-14 22:38:56,2024-06-16 09:48:09,The Workman's Club,-36.00,0.00,EUR,COMPLETED,175.50
Card Payment,Current,2024-06-15 00:27:35,2024-06-16 09:48:29,The Liquor Rooms,-30.00,0.00,EUR,COMPLETED,145.50
Card Payment,Current,2024-06-15 09:10:47,2024-06-16 11:23:50,Apple,-27.49,0.00,EUR,COMPLETED,118.01
Card Payment,Current,2024-06-15 02:51:07,2024-06-16 11:30:29,Taxi Driver,-19.40,0.00,EUR,COMPLETED,98.61
Transfer,Current,2024-06-16 19:51:36,2024-06-16 19:51:36,Savings Vault topup,-4.40,0.00,EUR,COMPLETED,94.21
Transfer,Current,2024-06-17 08:27:46,2024-06-17 08:27:46,Savings Vault topup,-4.25,0.00,EUR,COMPLETED,89.96
Card Payment,Current,2024-06-15 09:19:39,2024-06-17 10:17:21,Uber Eats,-14.14,0.00,EUR,COMPLETED,75.82
Card Payment,Current,2024-06-16 19:51:35,2024-06-17 17:34:08,ALDI,-42.12,0.00,EUR,COMPLETED,33.70
Card Payment,Current,2024-06-17 08:27:46,2024-06-18 09:48:46,SuperValu,-23.15,0.00,EUR,COMPLETED,10.55
Transfer,Current,2024-06-18 18:31:02,2024-06-18 18:31:02,Pocket Withdrawal,80.00,0.00,EUR,COMPLETED,90.55
Transfer,Current,2024-06-18 18:31:34,2024-06-18 18:31:34,Savings Vault topup,-0.05,0.00,EUR,COMPLETED,90.50
Transfer,Current,2024-06-18 20:15:38,2024-06-18 20:15:38,From Flexible Cash Funds,100.00,0.00,EUR,COMPLETED,190.50
Transfer,Current,2024-06-18 20:15:45,2024-06-18 20:15:45,Savings Vault topup,-0.05,0.00,EUR,COMPLETED,190.45
Transfer,Current,2024-06-19 08:06:35,2024-06-19 08:06:35,Savings Vault topup,-2.00,0.00,EUR,COMPLETED,188.45
Transfer,Current,2024-06-19 09:53:00,2024-06-19 09:53:00,From Flexible Cash Funds,100.00,0.00,EUR,COMPLETED,288.45
Transfer,Current,2024-06-19 09:54:59,2024-06-19 09:54:59,Savings Vault topup,-3.25,0.00,EUR,COMPLETED,285.20
Transfer,Current,2024-06-19 10:46:47,2024-06-19 10:46:47,Savings Vault topup,-1.25,0.00,EUR,COMPLETED,283.95
Transfer,Current,2024-06-19 10:57:54,2024-06-19 10:57:54,Savings Vault topup,-5.00,0.00,EUR,COMPLETED,278.95
Card Payment,Current,2024-06-18 18:31:33,2024-06-19 11:49:30,PlayStation,-39.99,0.00,EUR,COMPLETED,238.96
Card Payment,Current,2024-06-18 20:15:44,2024-06-19 12:03:01,Dublin Dundrum Centre,-139.99,0.00,EUR,COMPLETED,98.97
Transfer,Current,2024-06-20 05:56:38,2024-06-20 05:56:38,From Flexible Cash Funds,100.00,0.00,EUR,COMPLETED,198.97
Transfer,Current,2024-06-20 05:58:09,2024-06-20 05:58:09,Savings Vault topup,-4.50,0.00,EUR,COMPLETED,194.47
Card Payment,Current,2024-06-19 10:57:53,2024-06-20 12:09:03,Centra,-12.00,0.00,EUR,COMPLETED,182.47
Card Payment,Current,2024-06-19 08:06:35,2024-06-20 14:46:11,Hatch Coffee,-4.60,0.00,EUR,COMPLETED,177.87
Card Payment,Current,2024-06-19 09:54:59,2024-06-20 14:46:16,Hatch Coffee,-30.35,0.00,EUR,COMPLETED,147.52
Card Payment,Current,2024-06-19 10:46:47,2024-06-20 14:46:23,Hatch Coffee,-4.75,0.00,EUR,COMPLETED,142.77
Transfer,Current,2024-06-21 08:57:38,2024-06-21 08:57:39,Savings Vault topup,-4.20,0.00,EUR,COMPLETED,138.57
Transfer,Current,2024-06-21 09:54:37,2024-06-21 09:54:37,Transfer from MARA DI RAIMONDO,143.84,0.00,EUR,COMPLETED,282.41
Card Payment,Current,2024-06-20 05:58:09,2024-06-21 11:43:43,Applegreen,-50.10,0.00,EUR,COMPLETED,232.31
Transfer,Current,2024-06-21 19:38:13,2024-06-21 19:38:13,Savings Vault topup,-3.85,0.00,EUR,COMPLETED,228.46
Transfer,Current,2024-06-21 19:57:00,2024-06-21 19:57:00,Savings Vault topup,-4.75,0.00,EUR,COMPLETED,223.71
Card Payment,Current,2024-06-21 19:57:00,2024-06-22 09:41:01,O'Briens Wine,-13.05,0.00,EUR,COMPLETED,210.66
Card Payment,Current,2024-06-21 08:57:38,2024-06-22 09:49:43,SuperValu,-60.16,0.00,EUR,COMPLETED,150.50
Card Payment,Current,2024-06-21 19:38:12,2024-06-22 11:56:21,Zakura,-76.23,0.00,EUR,COMPLETED,74.27
Transfer,Current,2024-06-22 12:11:39,2024-06-22 12:11:39,From Flexible Cash Funds,150.00,0.00,EUR,COMPLETED,224.27
Transfer,Current,2024-06-22 12:11:52,2024-06-22 12:11:52,Savings Vault topup,-0.55,0.00,EUR,COMPLETED,223.72
Transfer,Current,2024-06-22 15:14:55,2024-06-22 15:14:55,Savings Vault topup,-3.00,0.00,EUR,COMPLETED,220.72
Transfer,Current,2024-06-22 16:58:15,2024-06-22 16:58:15,Transfer from MARA DI RAIMONDO,34.30,0.00,EUR,COMPLETED,255.02
Transfer,Current,2024-06-23 07:53:10,2024-06-23 07:53:10,Transfer to MARA DI RAIMONDO,-5.68,0.00,EUR,COMPLETED,249.34
Transfer,Current,2024-06-23 08:00:02,2024-06-23 08:00:02,From Flexible Cash Funds,250.00,0.00,EUR,COMPLETED,499.34
Transfer,Current,2024-06-23 10:19:53,2024-06-23 10:19:53,Savings Vault topup,-2.50,0.00,EUR,COMPLETED,496.84
Card Payment,Current,2024-06-22 15:14:55,2024-06-23 11:02:23,Gleesons,-7.40,0.00,EUR,COMPLETED,489.44
Transfer,Current,2024-06-23 12:41:42,2024-06-23 12:41:42,Savings Vault topup,-0.45,0.00,EUR,COMPLETED,488.99
Transfer,Current,2024-06-23 12:42:05,2024-06-23 12:42:05,Savings Vault topup,-1.75,0.00,EUR,COMPLETED,487.24
Transfer,Current,2024-06-23 13:00:40,2024-06-23 13:00:40,Savings Vault topup,-2.75,0.00,EUR,COMPLETED,484.49
Transfer,Current,2024-06-23 14:17:46,2024-06-23 14:17:46,Transfer from MARGARET MARY BRENNAN,8.00,0.00,EUR,COMPLETED,492.49
Transfer,Current,2024-06-23 19:08:48,2024-06-23 19:08:48,Transfer to MARA DI RAIMONDO,-2.00,0.00,EUR,COMPLETED,490.49
Transfer,Current,2024-06-23 19:08:50,2024-06-23 19:08:50,Transfer to MARA DI RAIMONDO,-1.32,0.00,EUR,COMPLETED,489.17
Transfer,Current,2024-06-23 21:09:00,2024-06-23 21:09:01,Savings Vault topup,-5.00,0.00,EUR,COMPLETED,484.17
Transfer,Current,2024-06-23 08:00:22,2024-06-24 01:58:50,To Colm Quish,-250.83,0.00,EUR,COMPLETED,233.34
Card Payment,Current,2024-06-23 10:19:53,2024-06-24 10:36:34,3FE,-3.50,0.00,EUR,COMPLETED,229.84
Card Payment,Current,2024-06-23 12:42:04,2024-06-24 10:36:45,Poppies,-2.65,0.00,EUR,COMPLETED,227.19
Card Payment,Current,2024-06-23 12:41:42,2024-06-24 10:36:51,Poppies,-19.91,0.00,EUR,COMPLETED,207.28
Card Payment,Current,2024-06-23 13:00:40,2024-06-24 10:47:14,Spar,-2.45,0.00,EUR,COMPLETED,204.83
Transfer,Current,2024-06-24 01:00:00,2024-06-24 11:45:02,To eFlow,-8.03,0.00,EUR,COMPLETED,196.80
Transfer,Current,2024-06-24 12:04:38,2024-06-24 12:04:38,Transfer from MARA DI RAIMONDO,550.00,0.00,EUR,COMPLETED,746.80
Transfer,Current,2024-06-24 14:35:17,2024-06-24 14:35:18,Transfer to JOSEPH WILLIAM OBRIEN,-69.90,0.00,EUR,COMPLETED,676.90
Card Payment,Current,2024-06-22 12:11:51,2024-06-24 16:31:19,Amazon,-117.89,1.18,EUR,COMPLETED,557.83
Transfer,Current,2024-06-24 19:58:38,2024-06-24 19:58:39,Savings Vault topup,-4.50,0.00,EUR,COMPLETED,553.33
Transfer,Current,2024-06-24 19:59:24,2024-06-24 19:59:25,Savings Vault topup,-3.50,0.00,EUR,COMPLETED,549.83
Transfer,Current,2024-06-24 20:41:29,2024-06-24 20:41:29,From Flexible Cash Funds,1000.00,0.00,EUR,COMPLETED,1549.83
Topup,Current,2024-06-25 07:21:03,2024-06-25 07:21:03,Payment from WORKDAY LIMITED,2265.71,0.00,EUR,COMPLETED,3815.54
Transfer,Current,2024-06-25 08:17:55,2024-06-25 08:52:36,To Finance Ireland,-1424.50,0.00,EUR,COMPLETED,2391.04
Transfer,Current,2024-06-25 09:18:18,2024-06-25 09:18:18,Savings Vault topup,-5.00,0.00,EUR,COMPLETED,2386.04
Transfer,Current,2024-06-25 09:54:05,2024-06-25 09:54:05,Savings Vault topup,-2.75,0.00,EUR,COMPLETED,2383.29
Transfer,Current,2024-06-25 11:09:36,2024-06-25 11:09:36,To pocket EUR Subscriptions from EUR,-2096.50,0.00,EUR,COMPLETED,286.79
Card Payment,Current,2024-06-24 19:59:24,2024-06-25 11:30:38,Boojum,-2.30,0.00,EUR,COMPLETED,284.49
Card Payment,Current,2024-06-24 19:58:38,2024-06-25 11:30:40,Boojum,-14.10,0.00,EUR,COMPLETED,270.39
Card Payment,Current,2024-06-23 21:09:00,2024-06-25 11:33:18,The Merry Cobbler,-60.00,0.00,EUR,COMPLETED,210.39
Transfer,Current,2024-06-25 01:00:00,2024-06-25 11:45:19,To Royal London,-16.72,0.00,EUR,COMPLETED,193.67
Transfer,Current,2024-06-25 15:26:12,2024-06-25 15:26:12,Savings Vault topup,-2.55,0.00,EUR,COMPLETED,191.12
Transfer,Current,2024-06-26 09:06:22,2024-06-26 09:06:23,Savings Vault topup,-2.75,0.00,EUR,COMPLETED,188.37
Card Payment,Current,2024-06-25 09:18:18,2024-06-26 09:32:54,Ann Griffin,-15.00,0.00,EUR,COMPLETED,173.37
Card Payment,Current,2024-06-25 15:26:12,2024-06-26 11:57:49,Centra,-13.49,0.00,EUR,COMPLETED,159.88
Card Payment,Current,2024-06-25 09:54:05,2024-06-26 12:19:20,OXMANTOWN,-4.45,0.00,EUR,COMPLETED,155.43
Transfer,Current,2024-06-26 17:33:55,2024-06-26 17:33:55,Savings Vault topup,-3.00,0.00,EUR,COMPLETED,152.43
Transfer,Current,2024-06-26 17:36:41,2024-06-26 17:36:41,Savings Vault topup,-5.00,0.00,EUR,COMPLETED,147.43
Transfer,Current,2024-06-26 20:32:51,2024-06-26 20:32:51,Savings Vault topup,-5.00,0.00,EUR,COMPLETED,142.43
Transfer,Current,2024-06-26 21:49:03,2024-06-26 21:49:03,Savings Vault topup,-5.00,0.00,EUR,COMPLETED,137.43
Transfer,Current,2024-06-27 00:51:25,2024-06-27 00:51:25,Savings Vault topup,-2.75,0.00,EUR,COMPLETED,134.68
Transfer,Current,2024-06-27 01:05:27,2024-06-27 01:05:27,Pocket Withdrawal,100.00,0.00,EUR,COMPLETED,234.68
Transfer,Current,2024-06-27 01:14:43,2024-06-27 01:14:43,Savings Vault topup,-4.00,0.00,EUR,COMPLETED,230.68
Transfer,Current,2024-06-27 08:55:07,2024-06-27 08:55:07,Savings Vault topup,-4.00,0.00,EUR,COMPLETED,226.68
Card Payment,Current,2024-06-27 00:51:25,2024-06-27 11:05:29,Burger King,-12.45,0.00,EUR,COMPLETED,214.23
Card Payment,Current,2024-06-26 09:06:22,2024-06-27 11:14:02,OXMANTOWN,-4.45,0.00,EUR,COMPLETED,209.78
Card Payment,Current,2024-06-26 21:49:03,2024-06-27 11:14:36,Central Fusion,-33.00,0.00,EUR,COMPLETED,176.78
Card Payment,Current,2024-06-26 20:32:51,2024-06-27 11:14:37,Central Fusion,-28.00,0.00,EUR,COMPLETED,148.78
Transfer,Current,2024-06-27 18:48:53,2024-06-27 18:48:53,Savings Vault topup,-3.05,0.00,EUR,COMPLETED,145.73
Card Payment,Current,2024-06-27 18:48:53,2024-06-28 10:30:21,Deliveroo,-55.39,0.00,EUR,COMPLETED,90.34
Topup,Current,2024-06-28 10:35:42,2024-06-28 10:35:42,Payment from PATRICIA        QUISH,2268.00,0.00,EUR,COMPLETED,2358.34
Card Payment,Current,2024-06-26 17:33:55,2024-06-28 10:38:10,Gibney's Of Malahide,-22.40,0.00,EUR,COMPLETED,2335.94
Card Payment,Current,2024-06-26 17:36:41,2024-06-28 10:38:10,Gibney's Of Malahide,-10.00,0.00,EUR,COMPLETED,2325.94
Card Payment,Current,2024-06-27 08:55:07,2024-06-28 11:35:46,Copper + Straw,-9.20,0.00,EUR,COMPLETED,2316.74
Card Payment,Current,2024-06-27 01:14:43,2024-06-28 13:11:36,Taxi,-17.20,0.00,EUR,COMPLETED,2299.54
Transfer,Current,2024-06-28 17:10:27,2024-06-28 17:10:27,Savings Vault topup,-2.50,0.00,EUR,COMPLETED,2297.04
Transfer,Current,2024-06-28 17:37:05,2024-06-28 17:37:05,Savings Vault topup,-5.00,0.00,EUR,COMPLETED,2292.04
Transfer,Current,2024-06-29 10:15:54,2024-06-29 10:15:54,Savings Vault topup,-3.00,0.00,EUR,COMPLETED,2289.04
Card Payment,Current,2024-06-28 17:10:27,2024-06-29 11:31:23,Poolside Cafe,-7.50,0.00,EUR,COMPLETED,2281.54
Card Payment,Current,2024-06-28 17:37:04,2024-06-29 11:33:33,Ucd Bikes,-45.00,0.00,EUR,COMPLETED,2236.54
Transfer,Current,2024-06-29 13:49:26,2024-06-29 13:49:26,Savings Vault topup,-0.05,0.00,EUR,COMPLETED,2236.49
Transfer,Current,2024-06-29 13:51:21,2024-06-29 13:51:21,Savings Vault topup,-5.00,0.00,EUR,COMPLETED,2231.49
Transfer,Current,2024-06-29 13:56:59,2024-06-29 13:56:59,Savings Vault topup,-4.00,0.00,EUR,COMPLETED,2227.49
Transfer,Current,2024-06-29 14:36:02,2024-06-29 14:36:02,Savings Vault topup,-3.00,0.00,EUR,COMPLETED,2224.49
Transfer,Current,2024-06-29 19:13:20,2024-06-29 19:13:21,Savings Vault topup,-4.50,0.00,EUR,COMPLETED,2219.99
Transfer,Current,2024-06-29 19:56:20,2024-06-29 19:56:20,Pocket Withdrawal,300.00,0.00,EUR,COMPLETED,2519.99
Transfer,Current,2024-06-29 20:01:18,2024-06-29 20:01:18,Pocket Withdrawal,100.00,0.00,EUR,COMPLETED,2619.99
Transfer,Current,2024-06-29 20:01:35,2024-06-29 20:01:35,Savings Vault topup,-5.00,0.00,EUR,COMPLETED,2614.99
Card Payment,Current,2024-06-28 08:49:05,2024-06-29 20:06:59,Lidl,-28.29,0.00,EUR,COMPLETED,2586.70
Transfer,Current,2024-06-29 22:08:55,2024-06-29 22:08:55,Pocket Withdrawal,100.00,0.00,EUR,COMPLETED,2686.70
Transfer,Current,2024-06-29 22:13:14,2024-06-29 22:13:14,Savings Vault topup,-5.00,0.00,EUR,COMPLETED,2681.70
Transfer,Current,2024-06-30 08:15:07,2024-06-30 08:15:07,Savings Vault topup,-5.00,0.00,EUR,COMPLETED,2676.70
ATM,Current,2024-06-29 19:52:29,2024-06-30 09:31:34,Cash withdrawal at Kebad Da Vila,-100.00,0.00,EUR,COMPLETED,2576.70
Card Payment,Current,2024-06-29 13:51:21,2024-06-30 10:13:25,WHSmith,-4.00,0.00,EUR,COMPLETED,2572.70
Card Payment,Current,2024-06-29 19:13:20,2024-06-30 12:02:06,Padaria Lisboa,-11.10,0.00,EUR,COMPLETED,2561.60
Card Payment,Current,2024-06-29 13:49:25,2024-06-30 12:40:15,Boots,-3.99,0.00,EUR,COMPLETED,2557.61
Transfer,Current,2024-06-30 14:14:43,2024-06-30 14:14:43,Pocket Withdrawal,100.00,0.00,EUR,COMPLETED,2657.61
Transfer,Current,2024-06-30 14:15:50,2024-06-30 14:15:50,Savings Vault topup,-3.00,0.00,EUR,COMPLETED,2654.61
Card Payment,Current,2024-06-29 20:01:35,2024-06-30 15:45:04,Vg Ericeira,-2334.00,0.00,EUR,COMPLETED,320.61
Card Payment,Current,2024-06-29 10:15:54,2024-06-30 17:44:35,Gleesons,-3.40,0.00,EUR,COMPLETED,317.21
Card Payment,Current,2024-06-30 12:00:22,2024-07-01 10:05:22,Oslo,-70.05,0.00,EUR,COMPLETED,247.16
Card Payment,Current,2024-06-29 14:36:01,2024-07-01 10:34:21,FREE NOW,-57.40,0.00,EUR,COMPLETED,189.76
Topup,Current,2024-07-01 10:45:00,2024-07-01 10:45:00,Payment from PATRICIA        QUISH,100.00,0.00,EUR,COMPLETED,289.76
Card Payment,Current,2024-06-29 22:13:14,2024-07-01 11:30:42,Tik-Tak,-66.00,0.00,EUR,COMPLETED,223.76
Card Payment,Current,2024-06-30 08:15:07,2024-07-01 11:32:51,Ryanair,-6.00,0.00,EUR,COMPLETED,217.76
Card Payment,Current,2024-06-29 13:56:58,2024-07-01 11:57:47,Marqette,-16.20,0.00,EUR,COMPLETED,201.56
Transfer,Current,2024-07-01 13:05:59,2024-07-01 13:05:59,Transfer from MARA DI RAIMONDO,28.70,0.00,EUR,COMPLETED,230.26
Transfer,Current,2024-07-01 16:40:01,2024-07-01 16:40:01,Savings Vault topup,-5.00,0.00,EUR,COMPLETED,225.26
Transfer,Current,2024-07-01 17:30:41,2024-07-01 17:30:41,Savings Vault topup,-5.00,0.00,EUR,COMPLETED,220.26
Transfer,Current,2024-07-01 18:38:37,2024-07-01 18:38:37,Savings Vault topup,-2.50,0.00,EUR,COMPLETED,217.76
Card Payment,Current,2024-06-30 14:15:50,2024-07-01 18:38:50,Vg Ericeira,-18.40,0.00,EUR,COMPLETED,199.36
Transfer,Current,2024-07-01 18:50:08,2024-07-01 18:50:08,Savings Vault topup,-5.00,0.00,EUR,COMPLETED,194.36
Transfer,Current,2024-07-01 19:04:45,2024-07-01 19:04:45,Savings Vault topup,-1.50,0.00,EUR,COMPLETED,192.86
Transfer,Current,2024-07-01 19:18:17,2024-07-01 19:18:17,Transfer to DAVID KEVIN SMYTH,-35.00,0.00,EUR,COMPLETED,157.86
Card Payment,Current,2024-07-01 17:30:40,2024-07-02 10:11:41,Taberna Ó Balcão,-6.00,0.00,EUR,COMPLETED,151.86
Card Payment,Current,2024-07-01 19:04:44,2024-07-02 11:43:48,Pinóquio,-3.70,0.00,EUR,COMPLETED,148.16
Card Payment,Current,2024-07-01 16:40:00,2024-07-02 11:49:29,Dear Breakfast,-90.00,0.00,EUR,COMPLETED,58.16
Card Payment,Current,2024-07-01 18:38:36,2024-07-02 11:49:51,Nós é mais bolos,-4.50,0.00,EUR,COMPLETED,53.66
Card Payment,Current,2024-07-01 18:50:07,2024-07-02 11:49:58,Asia,-14.00,0.00,EUR,COMPLETED,39.66
Transfer,Current,2024-07-02 13:07:22,2024-07-02 13:07:22,Savings Vault topup,-1.85,0.00,EUR,COMPLETED,37.81
Transfer,Current,2024-07-02 16:07:46,2024-07-02 16:07:46,Savings Vault topup,-2.55,0.00,EUR,COMPLETED,35.26
Transfer,Current,2024-07-03 09:56:04,2024-07-03 09:56:04,Transfer from MARA DI RAIMONDO,41.91,0.00,EUR,COMPLETED,77.17
Transfer,Current,2024-07-03 09:56:19,2024-07-03 09:56:20,Savings Vault topup,-0.05,0.00,EUR,COMPLETED,77.12
Transfer,Current,2024-07-03 09:56:25,2024-07-03 09:56:25,Transfer from MARA DI RAIMONDO,44.75,0.00,EUR,COMPLETED,121.87
Card Payment,Current,2024-07-02 16:07:46,2024-07-03 11:55:03,HP,-1.49,0.00,EUR,COMPLETED,120.38
Card Payment,Current,2024-07-02 13:07:22,2024-07-03 12:23:36,Amazon,-10.63,0.00,EUR,COMPLETED,109.75
Transfer,Current,2024-07-03 16:04:00,2024-07-03 16:04:00,Savings Vault topup,-1.25,0.00,EUR,COMPLETED,108.50
Transfer,Current,2024-07-03 18:56:33,2024-07-03 18:56:33,Savings Vault topup,-1.00,0.00,EUR,COMPLETED,107.50
Transfer,Current,2024-07-04 02:51:45,2024-07-04 02:51:45,Savings Vault topup,-0.05,0.00,EUR,COMPLETED,107.45
Card Payment,Current,2024-07-03 09:56:19,2024-07-04 09:19:10,Apple,-32.99,0.00,EUR,COMPLETED,74.46
Transfer,Current,2024-07-04 09:36:25,2024-07-04 09:36:26,Savings Vault topup,-0.30,0.00,EUR,COMPLETED,74.16
Card Payment,Current,2024-07-03 16:03:59,2024-07-04 09:36:59,Justino Alexandre,-6.75,0.00,EUR,COMPLETED,67.41
Topup,Current,2024-07-04 10:35:59,2024-07-04 10:35:59,Payment from PATRICIA        QUISH,100.00,0.00,EUR,COMPLETED,167.41
Transfer,Current,2024-07-04 10:48:59,2024-07-04 10:48:59,Savings Vault topup,-5.00,0.00,EUR,COMPLETED,162.41
Transfer,Current,2024-07-04 15:15:03,2024-07-04 15:15:03,Savings Vault topup,-3.00,0.00,EUR,COMPLETED,159.41
Card Payment,Current,2024-07-03 18:56:33,2024-07-04 15:31:43,Vg Ericeira,-9.80,0.00,EUR,COMPLETED,149.61
Transfer,Current,2024-07-04 17:42:29,2024-07-04 17:42:29,Savings Vault topup,-3.00,0.00,EUR,COMPLETED,146.61
Transfer,Current,2024-07-04 18:51:13,2024-07-04 18:51:13,Savings Vault topup,-0.15,0.00,EUR,COMPLETED,146.46
Transfer,Current,2024-07-04 21:55:05,2024-07-04 21:55:05,Savings Vault topup,-1.00,0.00,EUR,COMPLETED,145.46
Card Payment,Current,2024-07-04 09:36:25,2024-07-05 03:05:12,YouTube,-1.93,0.00,EUR,COMPLETED,143.53
Card Payment,Current,2024-07-04 02:51:44,2024-07-05 09:47:25,Apple,-2.99,0.00,EUR,COMPLETED,140.54
Card Payment,Current,2024-07-04 18:51:13,2024-07-05 10:06:29,Uber,-26.97,0.00,EUR,COMPLETED,113.57
Card Payment,Current,2024-07-04 10:48:59,2024-07-05 12:55:36,Piscinas M Ericeira,-24.00,0.00,EUR,COMPLETED,89.57
Card Payment,Current,2024-07-04 17:42:28,2024-07-05 13:35:23,C7,-43.40,0.00,EUR,COMPLETED,46.17
Transfer,Current,2024-07-05 14:09:32,2024-07-05 14:09:32,Pocket Withdrawal,100.00,0.00,EUR,COMPLETED,146.17
Transfer,Current,2024-07-05 14:09:37,2024-07-05 14:09:37,Savings Vault topup,-4.00,0.00,EUR,COMPLETED,142.17
Transfer,Current,2024-07-05 15:45:04,2024-07-05 15:45:04,Savings Vault topup,-0.75,0.00,EUR,COMPLETED,141.42
Card Payment,Current,2024-07-04 15:15:03,2024-07-05 17:40:05,Vg Ericeira,-7.40,0.00,EUR,COMPLETED,134.02
Transfer,Current,2024-07-05 20:26:08,2024-07-05 20:26:08,Savings Vault topup,-4.05,0.00,EUR,COMPLETED,129.97
Card Payment,Current,2024-07-04 21:55:05,2024-07-06 08:50:25,Cafe Terminal 2,-7.80,0.00,EUR,COMPLETED,122.17
Transfer,Current,2024-07-06 17:47:19,2024-07-06 17:47:19,Savings Vault topup,-5.00,0.00,EUR,COMPLETED,117.17
Transfer,Current,2024-07-06 19:05:48,2024-07-06 19:05:49,Transfer to JOHN DANIEL KIELY,-35.00,0.00,EUR,COMPLETED,82.17
Transfer,Current,2024-07-06 19:10:04,2024-07-06 19:10:04,Savings Vault topup,-5.00,0.00,EUR,COMPLETED,77.17
Card Payment,Current,2024-07-05 15:45:04,2024-07-06 21:39:44,Circle K Gas Station,-9.85,0.00,EUR,COMPLETED,67.32
Card Payment,Current,2024-07-05 14:09:37,2024-07-06 22:00:20,Centra,-23.20,0.00,EUR,COMPLETED,44.12
Card Payment,Current,2024-07-06 17:47:19,2024-07-07 10:41:30,Vapeworx Killarney,-7.00,0.00,EUR,COMPLETED,37.12
Transfer,Current,2024-07-07 11:14:09,2024-07-07 11:14:09,Savings Vault topup,-4.50,0.00,EUR,COMPLETED,32.62
Card Payment,Current,2024-07-05 20:26:07,2024-07-07 11:47:41,Applegreen,-5.19,0.00,EUR,COMPLETED,27.43
Card Payment,Current,2024-07-06 19:10:04,2024-07-07 13:07:46,SuperValu,-5.00,0.00,EUR,COMPLETED,22.43
Transfer,Current,2024-07-07 13:09:17,2024-07-07 13:09:17,Savings Vault topup,-4.50,0.00,EUR,COMPLETED,17.93
Transfer,Current,2024-07-07 15:16:32,2024-07-07 15:16:32,Pocket Withdrawal,100.00,0.00,EUR,COMPLETED,117.93
Transfer,Current,2024-07-07 15:16:59,2024-07-07 15:16:59,Savings Vault topup,-0.75,0.00,EUR,COMPLETED,117.18
Transfer,Current,2024-07-07 19:40:42,2024-07-07 19:40:42,Transfer to MARA DI RAIMONDO,-13.46,0.00,EUR,COMPLETED,103.72
Card Payment,Current,2024-07-07 13:09:17,2024-07-08 11:20:52,Supermac's,-4.10,0.00,EUR,COMPLETED,99.62
Card Payment,Current,2024-07-07 15:16:58,2024-07-08 12:32:49,Deliveroo,-20.85,0.00,EUR,COMPLETED,78.77
Transfer,Current,2024-07-08 19:11:42,2024-07-08 19:11:43,Savings Vault topup,-2.50,0.00,EUR,COMPLETED,76.27
Card Payment,Current,2024-07-07 11:14:09,2024-07-08 20:22:13,Centra,-2.10,0.00,EUR,COMPLETED,74.17
Transfer,Current,2024-07-09 09:08:30,2024-07-09 09:08:30,Savings Vault topup,-1.50,0.00,EUR,COMPLETED,72.67
Transfer,Current,2024-07-09 12:57:56,2024-07-09 12:57:57,Savings Vault topup,-1.25,0.00,EUR,COMPLETED,71.42
Card Payment,Current,2024-07-08 19:11:42,2024-07-09 17:45:26,Poolside Cafe,-4.50,0.00,EUR,COMPLETED,66.92
Transfer,Current,2024-07-09 20:43:19,2024-07-09 20:43:19,Transfer to MARA DI RAIMONDO,-2.19,0.00,EUR,COMPLETED,64.73
Transfer,Current,2024-07-09 20:43:21,2024-07-09 20:43:21,Transfer to MARA DI RAIMONDO,-15.00,0.00,EUR,COMPLETED,49.73
Transfer,Current,2024-07-09 20:52:16,2024-07-09 20:52:16,Pocket Withdrawal,100.00,0.00,EUR,COMPLETED,149.73
Transfer,Current,2024-07-09 20:55:13,2024-07-09 20:55:13,Savings Vault topup,-0.15,0.00,EUR,COMPLETED,149.58
Transfer,Current,2024-07-09 21:02:08,2024-07-09 21:02:08,Savings Vault topup,-5.00,0.00,EUR,COMPLETED,144.58
Transfer,Current,2024-07-09 22:31:50,2024-07-09 22:31:50,Transfer from MARA DI RAIMONDO,5.00,0.00,EUR,COMPLETED,149.58
Transfer,Current,2024-07-09 22:34:38,2024-07-09 22:34:38,Transfer from MARA DI RAIMONDO,42.48,0.00,EUR,COMPLETED,192.06
Card Payment,Current,2024-07-09 12:57:56,2024-07-10 11:00:46,Boojum,-8.75,0.00,EUR,COMPLETED,183.31
Transfer,Current,2024-07-10 14:00:50,2024-07-10 14:00:50,Savings Vault topup,-2.05,0.00,EUR,COMPLETED,181.26
Card Payment,Current,2024-07-09 21:02:07,2024-07-10 16:54:13,University College Dublin,-10.00,0.00,EUR,COMPLETED,171.26
Card Payment,Current,2024-07-09 09:08:29,2024-07-10 16:56:48,Copper + Straw,-4.70,0.00,EUR,COMPLETED,166.56
Card Payment,Current,2024-07-09 20:55:13,2024-07-10 18:57:58,Amazon,-84.97,0.00,EUR,COMPLETED,81.59
Transfer,Current,2024-07-10 21:15:41,2024-07-10 21:15:41,Savings Vault topup,-5.00,0.00,EUR,COMPLETED,76.59
Transfer,Current,2024-07-11 08:43:24,2024-07-11 08:43:24,Savings Vault topup,-0.05,0.00,EUR,COMPLETED,76.54
Transfer,Current,2024-07-11 08:46:59,2024-07-11 08:46:59,Savings Vault topup,-2.75,0.00,EUR,COMPLETED,73.79
Card Payment,Current,2024-07-10 21:15:41,2024-07-11 12:35:16,Spar,-10.00,0.00,EUR,COMPLETED,63.79
Transfer,Current,2024-07-11 13:59:34,2024-07-11 13:59:34,Savings Vault topup,-5.00,0.00,EUR,COMPLETED,58.79
Transfer,Current,2024-07-11 15:53:10,2024-07-11 15:53:10,Pocket Withdrawal,100.00,0.00,EUR,COMPLETED,158.79
Transfer,Current,2024-07-11 15:54:35,2024-07-11 15:54:35,Savings Vault topup,-2.60,0.00,EUR,COMPLETED,156.19
Transfer,Current,2024-07-11 23:06:20,2024-07-11 23:06:20,Savings Vault topup,-0.55,0.00,EUR,COMPLETED,155.64
Transfer,Current,2024-07-12 08:39:25,2024-07-12 08:39:25,Transfer to MARA DI RAIMONDO,-10.61,0.00,EUR,COMPLETED,145.03
Transfer,Current,2024-07-12 08:39:30,2024-07-12 08:39:30,Savings Vault topup,-2.90,0.00,EUR,COMPLETED,142.13
Transfer,Current,2024-07-12 08:40:28,2024-07-12 08:40:29,Savings Vault topup,-5.00,0.00,EUR,COMPLETED,137.13
Card Payment,Current,2024-07-11 08:46:59,2024-07-12 09:56:51,OXMANTOWN,-4.45,0.00,EUR,COMPLETED,132.68
Card Payment,Current,2024-07-11 08:43:24,2024-07-12 10:35:18,Apple,-19.99,0.00,EUR,COMPLETED,112.69
Card Payment,Current,2024-07-11 13:59:34,2024-07-12 11:29:36,Chopped,-13.00,0.00,EUR,COMPLETED,99.69
Card Payment,Current,2024-07-11 23:06:20,2024-07-12 15:54:54,Amazon,-3.89,0.00,EUR,COMPLETED,95.80
Transfer,Current,2024-07-12 18:24:16,2024-07-12 18:24:16,Savings Vault topup,-3.00,0.00,EUR,COMPLETED,92.80
Transfer,Current,2024-07-12 19:33:25,2024-07-12 19:33:25,Savings Vault topup,-0.60,0.00,EUR,COMPLETED,92.20
Card Payment,Current,2024-07-12 19:33:25,2024-07-13 08:50:33,Deliveroo,-20.88,0.00,EUR,COMPLETED,71.32
Transfer,Current,2024-07-13 08:58:26,2024-07-13 08:58:26,Pocket Withdrawal,100.00,0.00,EUR,COMPLETED,171.32
Transfer,Current,2024-07-13 09:00:19,2024-07-13 09:00:19,Savings Vault topup,-0.25,0.00,EUR,COMPLETED,171.07
Card Payment,Current,2024-07-10 14:00:50,2024-07-13 09:55:49,Tokyo Kitchen,-13.59,0.00,EUR,COMPLETED,157.48
Card Payment,Current,2024-07-11 15:54:34,2024-07-13 10:31:44,GoMo,-11.48,0.00,EUR,COMPLETED,146.00
Transfer,Current,2024-07-13 10:57:17,2024-07-13 10:57:17,Savings Vault topup,-1.00,0.00,EUR,COMPLETED,145.00
Card Payment,Current,2024-07-12 08:39:30,2024-07-13 11:08:12,SuperValu,-23.42,0.00,EUR,COMPLETED,121.58
Transfer,Current,2024-07-13 11:32:58,2024-07-13 11:32:58,Savings Vault topup,-2.50,0.00,EUR,COMPLETED,119.08
Card Payment,Current,2024-07-12 08:40:28,2024-07-13 11:49:07,Xl,-9.00,0.00,EUR,COMPLETED,110.08
Card Payment,Current,2024-07-12 18:24:16,2024-07-13 16:24:25,Gleesons,-3.40,0.00,EUR,COMPLETED,106.68
Transfer,Current,2024-07-13 21:08:57,2024-07-13 21:08:57,Pocket Withdrawal,100.00,0.00,EUR,COMPLETED,206.68
Transfer,Current,2024-07-13 21:11:51,2024-07-13 21:11:51,Savings Vault topup,-1.50,0.00,EUR,COMPLETED,205.18
Transfer,Current,2024-07-13 21:14:11,2024-07-13 21:14:11,Savings Vault topup,-2.50,0.00,EUR,COMPLETED,202.68
Transfer,Current,2024-07-13 22:40:33,2024-07-13 22:40:33,Savings Vault topup,-0.50,0.00,EUR,COMPLETED,202.18
Transfer,Current,2024-07-14 00:01:18,2024-07-14 00:01:18,Savings Vault topup,-2.50,0.00,EUR,COMPLETED,199.68
Transfer,Current,2024-07-14 00:41:30,2024-07-14 00:41:30,Savings Vault topup,-4.00,0.00,EUR,COMPLETED,195.68
Transfer,Current,2024-07-14 10:16:14,2024-07-14 10:16:14,Savings Vault topup,-3.50,0.00,EUR,COMPLETED,192.18
Transfer,Current,2024-07-14 13:18:27,2024-07-14 13:18:27,Pocket Withdrawal,50.00,0.00,EUR,COMPLETED,242.18
Transfer,Current,2024-07-14 13:18:41,2024-07-14 13:18:41,Savings Vault topup,-0.75,0.00,EUR,COMPLETED,241.43
Transfer,Current,2024-07-14 14:20:55,2024-07-14 14:20:55,Savings Vault topup,-3.05,0.00,EUR,COMPLETED,238.38
Transfer,Current,2024-07-14 14:38:31,2024-07-14 14:38:31,Pocket Withdrawal,100.00,0.00,EUR,COMPLETED,338.38
Card Payment,Current,2024-07-13 21:11:50,2024-07-14 15:05:19,Sfuso,-76.70,0.00,EUR,COMPLETED,261.68
Card Payment,Current,2024-07-13 09:00:18,2024-07-14 15:06:12,Gleesons,-7.95,0.00,EUR,COMPLETED,253.73
Transfer,Current,2024-07-14 18:06:05,2024-07-14 18:06:05,Savings Vault topup,-3.00,0.00,EUR,COMPLETED,250.73
Transfer,Current,2024-07-14 22:23:10,2024-07-14 22:23:10,Savings Vault topup,-4.85,0.00,EUR,COMPLETED,245.88
Transfer,Current,2024-07-15 08:29:54,2024-07-15 08:29:54,Savings Vault topup,-4.30,0.00,EUR,COMPLETED,241.58
Card Payment,Current,2024-07-14 18:06:05,2024-07-15 09:21:33,Gleesons,-3.40,0.00,EUR,COMPLETED,238.18
Card Payment,Current,2024-07-14 13:18:41,2024-07-15 09:46:37,Hatch Coffee,-29.85,0.00,EUR,COMPLETED,208.33
Card Payment,Current,2024-07-13 10:57:17,2024-07-15 11:06:22,Cycle SuperStore,-10.80,0.00,EUR,COMPLETED,197.53
Card Payment,Current,2024-07-13 21:14:10,2024-07-15 11:55:13,Spar,-8.50,0.00,EUR,COMPLETED,189.03
Card Payment,Current,2024-07-14 10:16:14,2024-07-15 12:00:47,Mint,-12.30,0.00,EUR,COMPLETED,176.73
Card Payment,Current,2024-07-13 11:32:58,2024-07-15 12:04:20,Mint,-8.50,0.00,EUR,COMPLETED,168.23
Card Payment,Current,2024-07-14 00:01:18,2024-07-15 12:08:36,Wigwam,-8.50,0.00,EUR,COMPLETED,159.73
Card Payment,Current,2024-07-13 22:40:33,2024-07-15 12:08:42,Wigwam,-13.90,0.00,EUR,COMPLETED,145.83
Card Payment,Current,2024-07-14 00:41:30,2024-07-15 12:54:23,Taxi 20236,-16.20,0.00,EUR,COMPLETED,129.63
Transfer,Current,2024-07-15 13:00:57,2024-07-15 13:00:57,Savings Vault topup,-1.20,0.00,EUR,COMPLETED,128.43
Card Payment,Current,2024-07-14 22:23:10,2024-07-15 17:13:40,Amazon,-11.03,0.11,EUR,COMPLETED,117.29
Transfer,Current,2024-07-15 19:03:48,2024-07-15 19:03:48,Savings Vault topup,-2.15,0.00,EUR,COMPLETED,115.14
Card Payment,Current,2024-07-14 14:20:54,2024-07-15 19:38:19,ALDI,-37.39,0.00,EUR,COMPLETED,77.75
Transfer,Current,2024-07-15 20:17:09,2024-07-15 20:17:09,Transfer from MARA DI RAIMONDO,13.50,0.00,EUR,COMPLETED,91.25
Transfer,Current,2024-07-15 20:17:52,2024-07-15 20:17:52,Transfer from MARA DI RAIMONDO,35.00,0.00,EUR,COMPLETED,126.25
Transfer,Current,2024-07-15 20:19:02,2024-07-15 20:19:02,Savings Vault topup,-3.60,0.00,EUR,COMPLETED,122.65
Transfer,Current,2024-07-15 20:19:08,2024-07-15 20:19:08,Transfer from MARA DI RAIMONDO,19.28,0.00,EUR,COMPLETED,141.93
Card Payment,Current,2024-07-15 20:19:01,2024-07-16 10:55:20,Deliveroo,-19.28,0.00,EUR,COMPLETED,122.65
Card Payment,Current,2024-07-15 08:29:53,2024-07-16 12:53:28,Lidl,-3.14,0.00,EUR,COMPLETED,119.51
Transfer,Current,2024-07-16 14:28:16,2024-07-16 14:28:16,Savings Vault topup,-2.75,0.00,EUR,COMPLETED,116.76
Card Payment,Current,2024-07-15 19:03:47,2024-07-16 17:17:35,Amazon,-3.57,0.00,EUR,COMPLETED,113.19
Transfer,Current,2024-07-16 17:32:15,2024-07-16 17:32:16,Savings Vault topup,-5.00,0.00,EUR,COMPLETED,108.19
Transfer,Current,2024-07-16 17:32:46,2024-07-16 17:32:46,Savings Vault topup,-3.80,0.00,EUR,COMPLETED,104.39
Card Payment,Current,2024-07-15 13:00:56,2024-07-16 18:13:54,Amazon,-42.76,0.00,EUR,COMPLETED,61.63
Transfer,Current,2024-07-16 19:24:17,2024-07-16 19:24:17,Pocket Withdrawal,100.00,0.00,EUR,COMPLETED,161.63
Transfer,Current,2024-07-16 19:24:22,2024-07-16 19:24:22,Savings Vault topup,-5.00,0.00,EUR,COMPLETED,156.63
Card Payment,Current,2024-07-16 17:32:46,2024-07-17 09:55:57,Strike Pay,-3.24,0.00,EUR,COMPLETED,153.39
Transfer,Current,2024-07-17 10:56:44,2024-07-17 10:56:44,Pocket Withdrawal,50.00,0.00,EUR,COMPLETED,203.39
Transfer,Current,2024-07-17 10:56:54,2024-07-17 10:56:54,Savings Vault topup,-1.45,0.00,EUR,COMPLETED,201.94
Card Payment,Current,2024-07-16 17:32:15,2024-07-17 11:07:45,Cut and Sew,-32.00,0.00,EUR,COMPLETED,169.94
Card Payment,Current,2024-07-16 19:24:22,2024-07-17 11:15:12,Br Physiotherapy,-65.00,0.00,EUR,COMPLETED,104.94
Card Payment,Current,2024-07-16 14:28:15,2024-07-17 12:23:48,OXMANTOWN,-4.45,0.00,EUR,COMPLETED,100.49
Transfer,Current,2024-07-17 20:19:01,2024-07-17 20:19:01,From Flexible Cash Funds,100.00,0.00,EUR,COMPLETED,200.49
Transfer,Current,2024-07-17 20:19:16,2024-07-17 20:19:16,Savings Vault topup,-4.65,0.00,EUR,COMPLETED,195.84
Transfer,Current,2024-07-18 08:43:40,2024-07-18 08:43:40,Savings Vault topup,-1.50,0.00,EUR,COMPLETED,194.34
Transfer,Current,2024-07-18 09:11:41,2024-07-18 09:11:41,Savings Vault topup,-0.40,0.00,EUR,COMPLETED,193.94
Transfer,Current,2024-07-18 17:30:24,2024-07-18 17:30:24,Savings Vault topup,-1.10,0.00,EUR,COMPLETED,192.84
Transfer,Current,2024-07-19 08:21:25,2024-07-19 08:21:25,Pocket Withdrawal,50.00,0.00,EUR,COMPLETED,242.84
Transfer,Current,2024-07-19 08:41:04,2024-07-19 08:41:04,Savings Vault topup,-1.00,0.00,EUR,COMPLETED,241.84
Transfer,Current,2024-07-19 09:08:10,2024-07-19 09:08:10,Savings Vault topup,-4.35,0.00,EUR,COMPLETED,237.49
Card Payment,Current,2024-07-18 08:43:40,2024-07-19 09:20:13,Copper + Straw,-4.70,0.00,EUR,COMPLETED,232.79
Card Payment,Current,2024-07-18 17:30:24,2024-07-19 12:30:49,Boots,-12.78,0.00,EUR,COMPLETED,220.01
Card Payment,Current,2024-07-17 10:56:54,2024-07-19 12:56:36,Amazon,-59.71,0.00,EUR,COMPLETED,160.30
Transfer,Current,2024-07-19 19:19:03,2024-07-19 19:19:03,Savings Vault topup,-3.00,0.00,EUR,COMPLETED,157.30
Transfer,Current,2024-07-19 19:58:11,2024-07-19 19:58:11,Pocket Withdrawal,29.00,0.00,EUR,COMPLETED,186.30
Transfer,Current,2024-07-19 20:46:36,2024-07-19 20:46:36,Savings Vault topup,-2.80,0.00,EUR,COMPLETED,183.50
Card Payment,Current,2024-07-19 19:19:03,2024-07-20 09:37:48,Gleesons,-3.40,0.00,EUR,COMPLETED,180.10
Card Payment,Current,2024-07-19 08:41:04,2024-07-20 10:49:02,Mint,-12.80,0.00,EUR,COMPLETED,167.30
Card Payment,Current,2024-07-19 09:08:09,2024-07-20 10:50:49,SuperValu,-24.13,0.00,EUR,COMPLETED,143.17
Card Payment,Current,2024-07-19 20:46:36,2024-07-20 11:19:57,Deliveroo,-2.44,0.00,EUR,COMPLETED,140.73
Card Payment,Current,2024-07-19 19:57:45,2024-07-20 11:19:59,Deliveroo,-26.24,0.00,EUR,COMPLETED,114.49
Transfer,Current,2024-07-20 11:23:53,2024-07-20 11:23:54,Savings Vault topup,-5.00,0.00,EUR,COMPLETED,109.49
Transfer,Current,2024-07-20 19:11:46,2024-07-20 19:11:46,From Flexible Cash Funds,100.00,0.00,EUR,COMPLETED,209.49
Transfer,Current,2024-07-20 19:12:47,2024-07-20 19:12:47,Savings Vault topup,-3.50,0.00,EUR,COMPLETED,205.99
Transfer,Current,2024-07-20 21:25:29,2024-07-20 21:25:29,From Flexible Cash Funds,50.00,0.00,EUR,COMPLETED,255.99
Transfer,Current,2024-07-20 21:39:14,2024-07-20 21:39:14,Savings Vault topup,-5.00,0.00,EUR,COMPLETED,250.99
Transfer,Current,2024-07-20 22:58:00,2024-07-20 22:58:00,Savings Vault topup,-2.00,0.00,EUR,COMPLETED,248.99
Transfer,Current,2024-07-21 00:19:00,2024-07-21 00:19:00,Savings Vault topup,-5.00,0.00,EUR,COMPLETED,243.99
Transfer,Current,2024-07-21 01:34:18,2024-07-21 01:34:18,Transfer from MARA DI RAIMONDO,5.00,0.00,EUR,COMPLETED,248.99
Transfer,Current,2024-07-21 01:36:42,2024-07-21 01:36:42,From Flexible Cash Funds,400.00,0.00,EUR,COMPLETED,648.99
Transfer,Current,2024-07-21 01:37:06,2024-07-21 01:37:06,Savings Vault topup,-0.05,0.00,EUR,COMPLETED,648.94
Transfer,Current,2024-07-21 01:42:51,2024-07-21 01:42:51,Savings Vault topup,-0.75,0.00,EUR,COMPLETED,648.19
Card Payment,Current,2024-07-21 01:37:05,2024-07-21 09:51:52,Wahoo Fitness EU,-384.99,0.00,EUR,COMPLETED,263.20
Transfer,Current,2024-07-21 11:48:17,2024-07-21 11:48:17,Transfer to MARA DI RAIMONDO,-22.05,0.00,EUR,COMPLETED,241.15
Transfer,Current,2024-07-21 11:48:24,2024-07-21 11:48:24,Transfer from MARA DI RAIMONDO,54.85,0.00,EUR,COMPLETED,296.00
Card Payment,Current,2024-07-20 11:23:53,2024-07-21 11:49:08,University College Dublin,-10.00,0.00,EUR,COMPLETED,286.00
Transfer,Current,2024-07-21 12:53:20,2024-07-21 12:53:21,Savings Vault topup,-2.65,0.00,EUR,COMPLETED,283.35
Card Payment,Current,2024-07-20 22:58:00,2024-07-22 10:13:04,Kehoes Pub,-13.60,0.00,EUR,COMPLETED,269.75
Card Payment,Current,2024-07-21 00:19:00,2024-07-22 10:13:24,Foley's Bar,-27.00,0.00,EUR,COMPLETED,242.75
Card Payment,Current,2024-07-20 21:39:14,2024-07-22 10:23:11,Spar,-9.00,0.00,EUR,COMPLETED,233.75
Card Payment,Current,2024-07-20 19:12:47,2024-07-22 10:25:19,Searsons Bar,-12.30,0.00,EUR,COMPLETED,221.45
Card Payment,Current,2024-07-21 12:53:20,2024-07-22 10:29:17,Dunnes Stores,-20.47,0.00,EUR,COMPLETED,200.98
Card Payment,Current,2024-07-21 01:42:50,2024-07-22 14:11:42,Amazon,-54.85,0.55,EUR,COMPLETED,145.58
Transfer,Current,2024-07-22 14:46:45,2024-07-22 14:46:45,Transfer to MARA DI RAIMONDO,-9.50,0.00,EUR,COMPLETED,136.08
Transfer,Current,2024-07-22 14:46:52,2024-07-22 14:46:52,From Flexible Cash Funds,100.00,0.00,EUR,COMPLETED,236.08
Transfer,Current,2024-07-22 14:47:07,2024-07-22 14:47:07,Savings Vault topup,-1.35,0.00,EUR,COMPLETED,234.73
Transfer,Current,2024-07-22 17:05:30,2024-07-22 17:05:30,Savings Vault topup,-4.10,0.00,EUR,COMPLETED,230.63
Transfer,Current,2024-07-22 17:06:37,2024-07-22 17:06:37,Savings Vault topup,-3.60,0.00,EUR,COMPLETED,227.03
Transfer,Current,2024-07-22 22:16:22,2024-07-22 22:16:22,Transfer from MARA DI RAIMONDO,17.28,0.00,EUR,COMPLETED,244.31
Transfer,Current,2024-07-23 09:13:20,2024-07-23 09:13:20,Savings Vault topup,-1.50,0.00,EUR,COMPLETED,242.81
Card Payment,Current,2024-07-22 17:06:36,2024-07-23 09:57:45,Deliveroo,-17.28,0.00,EUR,COMPLETED,225.53
Card Payment,Current,2024-07-22 17:05:30,2024-07-23 10:20:46,Deliveroo,-24.18,0.00,EUR,COMPLETED,201.35
Card Payment,Current,2024-07-18 09:11:41,2024-07-23 11:24:39,Amazon,-28.92,0.00,EUR,COMPLETED,172.43
Card Payment,Current,2024-07-17 20:19:16,2024-07-23 13:30:00,Amazon,-61.07,0.00,EUR,COMPLETED,111.36
Card Payment,Current,2024-07-22 14:47:06,2024-07-23 13:30:01,Amazon,-78.73,0.00,EUR,COMPLETED,32.63
Transfer,Current,2024-07-23 16:59:55,2024-07-23 16:59:55,Savings Vault topup,-3.95,0.00,EUR,COMPLETED,28.68
Transfer,Current,2024-07-23 18:49:43,2024-07-23 18:49:43,From Flexible Cash Funds,100.00,0.00,EUR,COMPLETED,128.68
Transfer,Current,2024-07-23 18:49:49,2024-07-23 18:49:50,Savings Vault topup,-5.00,0.00,EUR,COMPLETED,123.68
Transfer,Current,2024-07-24 06:48:29,2024-07-24 06:48:29,Transfer from MARA DI RAIMONDO,20.00,0.00,EUR,COMPLETED,143.68
Transfer,Current,2024-07-24 09:03:08,2024-07-24 09:03:08,Savings Vault topup,-1.50,0.00,EUR,COMPLETED,142.18
Transfer,Current,2024-07-24 01:00:00,2024-07-24 11:42:38,To eFlow,-1.23,0.00,EUR,COMPLETED,140.95
Card Payment,Current,2024-07-23 09:13:20,2024-07-24 12:02:12,Copper + Straw,-4.70,0.00,EUR,COMPLETED,136.25
Transfer,Current,2024-07-24 18:32:20,2024-07-24 18:32:20,Savings Vault topup,-1.50,0.00,EUR,COMPLETED,134.75
Topup,Current,2024-07-25 06:25:36,2024-07-25 06:25:36,Payment from WORKDAY LIMITED,3098.27,0.00,EUR,COMPLETED,3233.02
Transfer,Current,2024-07-25 08:26:40,2024-07-25 08:26:40,Savings Vault topup,-300.00,0.00,EUR,COMPLETED,2933.02
Transfer,Current,2024-07-25 08:26:48,2024-07-25 08:26:49,Savings Vault topup,-43.00,0.00,EUR,COMPLETED,2890.02
Transfer,Current,2024-07-25 08:33:27,2024-07-25 08:33:27,Savings Vault topup,-2.30,0.00,EUR,COMPLETED,2887.72
Transfer,Current,2024-07-25 08:40:15,2024-07-25 08:40:15,Savings Vault topup,-2.50,0.00,EUR,COMPLETED,2885.22
Transfer,Current,2024-07-25 08:19:29,2024-07-25 08:49:05,To Finance Ireland,-1424.50,0.00,EUR,COMPLETED,1460.72
Transfer,Current,2024-07-25 08:26:20,2024-07-25 08:49:30,To Colm Quish,-398.34,0.00,EUR,COMPLETED,1062.38
Card Payment,Current,2024-07-24 18:32:20,2024-07-25 09:55:07,SuperValu,-15.70,0.00,EUR,COMPLETED,1046.68
Card Payment,Current,2024-07-23 18:49:49,2024-07-25 10:04:30,The Merry Cobbler,-60.00,0.00,EUR,COMPLETED,986.68
Transfer,Current,2024-07-25 11:12:09,2024-07-25 11:12:09,To pocket EUR Subscriptions from EUR,-700.00,0.00,EUR,COMPLETED,286.68
Transfer,Current,2024-07-25 01:00:00,2024-07-25 11:41:58,To Royal London,-16.72,0.00,EUR,COMPLETED,269.96
Card Payment,Current,2024-07-24 09:03:08,2024-07-25 12:07:18,Copper + Straw,-4.70,0.00,EUR,COMPLETED,265.26
Card Payment,Current,2024-07-23 16:59:55,2024-07-25 12:23:53,Amazon,-23.21,0.00,EUR,COMPLETED,242.05
Topup,Current,2024-07-25 14:24:45,2024-07-25 14:24:46,Payment from VHI CLAIMS,24.00,0.00,EUR,COMPLETED,266.05
Transfer,Current,2024-07-25 17:58:28,2024-07-25 17:58:28,Savings Vault topup,-5.00,0.00,EUR,COMPLETED,261.05
Transfer,Current,2024-07-25 22:09:57,2024-07-25 22:09:57,Savings Vault topup,-3.00,0.00,EUR,COMPLETED,258.05
Transfer,Current,2024-07-25 22:13:48,2024-07-25 22:13:48,Transfer from JOHN DANIEL KIELY,15.00,0.00,EUR,COMPLETED,273.05
Transfer,Current,2024-07-25 23:50:38,2024-07-25 23:50:38,Savings Vault topup,-0.25,0.00,EUR,COMPLETED,272.80
Transfer,Current,2024-07-26 00:13:02,2024-07-26 00:13:02,Savings Vault topup,-4.00,0.00,EUR,COMPLETED,268.80
Card Payment,Current,2024-07-25 08:40:15,2024-07-26 10:10:52,Mint,-8.50,0.00,EUR,COMPLETED,260.30
Card Payment,Current,2024-07-25 08:33:27,2024-07-26 10:13:41,SuperValu,-2.54,0.00,EUR,COMPLETED,257.76
Card Payment,Current,2024-07-25 17:58:28,2024-07-26 10:39:45,Kehoes Pub,-34.00,0.00,EUR,COMPLETED,223.76
Card Payment,Current,2024-07-25 22:09:57,2024-07-26 10:40:05,Lemon & Duke,-63.40,0.00,EUR,COMPLETED,160.36
Card Payment,Current,2024-07-25 23:50:38,2024-07-26 12:14:42,Burger King,-5.95,0.00,EUR,COMPLETED,154.41
Transfer,Current,2024-07-26 12:26:31,2024-07-26 12:26:31,Savings Vault topup,-5.00,0.00,EUR,COMPLETED,149.41
Transfer,Current,2024-07-26 19:05:40,2024-07-26 19:05:40,Savings Vault topup,-5.00,0.00,EUR,COMPLETED,144.41
Transfer,Current,2024-07-26 19:12:59,2024-07-26 19:12:59,Savings Vault topup,-4.75,0.00,EUR,COMPLETED,139.66
Card Payment,Current,2024-07-26 19:05:40,2024-07-27 10:06:57,Junction 14 Mayfield,-60.00,0.00,EUR,COMPLETED,79.66
Card Payment,Current,2024-07-26 19:12:59,2024-07-27 10:08:11,Texaco,-7.05,0.00,EUR,COMPLETED,72.61
Card Payment,Current,2024-07-26 00:13:02,2024-07-27 10:50:31,Pat Brennan Taxi,-14.20,0.00,EUR,COMPLETED,58.41
Transfer,Current,2024-07-27 13:55:54,2024-07-27 13:55:55,Savings Vault topup,-3.25,0.00,EUR,COMPLETED,55.16
Card Payment,Current,2024-07-26 12:26:30,2024-07-27 15:51:07,SuperValu,-14.00,0.00,EUR,COMPLETED,41.16
Transfer,Current,2024-07-27 18:13:05,2024-07-27 18:13:05,Savings Vault topup,-2.50,0.00,EUR,COMPLETED,38.66
Transfer,Current,2024-07-27 18:41:35,2024-07-27 18:41:35,Pocket Withdrawal,80.00,0.00,EUR,COMPLETED,118.66
Transfer,Current,2024-07-27 18:43:15,2024-07-27 18:43:15,Savings Vault topup,-5.00,0.00,EUR,COMPLETED,113.66
Transfer,Current,2024-07-27 18:44:24,2024-07-27 18:44:25,Savings Vault topup,-2.50,0.00,EUR,COMPLETED,111.16
Transfer,Current,2024-07-27 19:09:39,2024-07-27 19:09:39,Savings Vault topup,-5.00,0.00,EUR,COMPLETED,106.16
Transfer,Current,2024-07-27 19:52:11,2024-07-27 19:52:11,Savings Vault topup,-5.00,0.00,EUR,COMPLETED,101.16
Transfer,Current,2024-07-27 22:11:33,2024-07-27 22:11:33,Savings Vault topup,-2.50,0.00,EUR,COMPLETED,98.66
Transfer,Current,2024-07-27 22:11:56,2024-07-27 22:11:56,Pocket Withdrawal,80.00,0.00,EUR,COMPLETED,178.66
Transfer,Current,2024-07-27 22:43:42,2024-07-27 22:43:42,Savings Vault topup,-3.00,0.00,EUR,COMPLETED,175.66
Transfer,Current,2024-07-27 23:10:32,2024-07-27 23:10:32,Savings Vault topup,-3.00,0.00,EUR,COMPLETED,172.66
Card Payment,Current,2024-07-27 13:55:54,2024-07-28 11:15:38,Centra,-13.35,0.00,EUR,COMPLETED,159.31
Card Payment,Current,2024-07-27 19:09:39,2024-07-28 11:42:00,Tobaccoland,-10.00,0.00,EUR,COMPLETED,149.31
Card Payment,Current,2024-07-27 18:44:24,2024-07-28 11:56:20,The Locke Bar,-4.50,0.00,EUR,COMPLETED,144.81
Card Payment,Current,2024-07-27 18:43:14,2024-07-28 11:56:20,The Locke Bar,-12.00,0.00,EUR,COMPLETED,132.81
Card Payment,Current,2024-07-27 18:13:04,2024-07-28 11:56:22,The Locke Bar,-3.50,0.00,EUR,COMPLETED,129.31
Card Payment,Current,2024-07-27 22:11:32,2024-07-28 11:56:23,The Locke Bar,-15.50,0.00,EUR,COMPLETED,113.81
Card Payment,Current,2024-07-27 19:52:11,2024-07-28 11:56:27,The Locke Bar,-12.00,0.00,EUR,COMPLETED,101.81
Card Payment,Current,2024-07-27 23:10:32,2024-07-28 11:56:57,The Locke Bar,-7.40,0.00,EUR,COMPLETED,94.41
Card Payment,Current,2024-07-27 22:43:42,2024-07-28 11:57:00,The Locke Bar,-7.40,0.00,EUR,COMPLETED,87.01
Transfer,Current,2024-07-28 17:40:22,2024-07-28 17:40:22,Savings Vault topup,-4.75,0.00,EUR,COMPLETED,82.26
Transfer,Current,2024-07-28 17:48:54,2024-07-28 17:48:54,Savings Vault topup,-1.05,0.00,EUR,COMPLETED,81.21
Transfer,Current,2024-07-29 08:45:45,2024-07-29 08:45:45,Savings Vault topup,-1.25,0.00,EUR,COMPLETED,79.96
Card Payment,Current,2024-07-28 17:40:21,2024-07-29 10:23:06,Zakura,-50.05,0.00,EUR,COMPLETED,29.91
Card Payment,Current,2024-07-28 17:48:54,2024-07-29 10:28:23,Tesco,-2.79,0.00,EUR,COMPLETED,27.12
Transfer,Current,2024-07-29 18:30:21,2024-07-29 18:30:21,Savings Vault topup,-3.00,0.00,EUR,COMPLETED,24.12
Transfer,Current,2024-07-29 20:03:52,2024-07-29 20:03:52,Pocket Withdrawal,40.00,0.00,EUR,COMPLETED,64.12
Transfer,Current,2024-07-29 20:04:05,2024-07-29 20:04:05,Savings Vault topup,-0.55,0.00,EUR,COMPLETED,63.57
Transfer,Current,2024-07-30 08:58:41,2024-07-30 08:58:42,Savings Vault topup,-1.50,0.00,EUR,COMPLETED,62.07
Card Payment,Current,2024-07-29 18:30:21,2024-07-30 09:02:31,Gleesons,-3.40,0.00,EUR,COMPLETED,58.67
Card Payment,Current,2024-07-29 20:04:04,2024-07-30 10:08:34,Tesco,-17.89,0.00,EUR,COMPLETED,40.78
Card Payment,Current,2024-07-29 08:45:44,2024-07-30 10:36:33,SuperValu,-18.75,0.00,EUR,COMPLETED,22.03
Transfer,Current,2024-07-31 09:08:36,2024-07-31 09:08:36,Savings Vault topup,-1.50,0.00,EUR,COMPLETED,20.53
Card Payment,Current,2024-07-30 08:58:41,2024-07-31 12:18:55,Copper + Straw,-4.70,0.00,EUR,COMPLETED,15.83
Transfer,Current,2024-07-31 13:17:41,2024-07-31 13:17:41,Pocket Withdrawal,10.00,0.00,EUR,COMPLETED,25.83
Transfer,Current,2024-07-31 13:17:51,2024-07-31 13:17:51,Savings Vault topup,-1.50,0.00,EUR,COMPLETED,24.33
Transfer,Current,2024-07-31 18:37:33,2024-07-31 18:37:34,Transfer from MARA DI RAIMONDO,25.02,0.00,EUR,COMPLETED,49.35
Transfer,Current,2024-07-31 18:37:37,2024-07-31 18:37:38,Transfer from MARA DI RAIMONDO,30.00,0.00,EUR,COMPLETED,79.35
Transfer,Current,2024-07-31 18:37:54,2024-07-31 18:37:55,Transfer from MARA DI RAIMONDO,550.00,0.00,EUR,COMPLETED,629.35
Transfer,Current,2024-07-31 18:38:35,2024-07-31 18:38:35,Transfer to MARA DI RAIMONDO,-44.00,0.00,EUR,COMPLETED,585.35
Transfer,Current,2024-07-31 18:41:00,2024-07-31 18:41:00,Savings Vault topup,-0.05,0.00,EUR,COMPLETED,585.30
Transfer,Current,2024-07-31 19:08:30,2024-07-31 19:08:30,Transfer from MARA DI RAIMONDO,10.00,0.00,EUR,COMPLETED,595.30
Transfer,Current,2024-08-01 08:26:41,2024-08-01 08:26:41,Savings Vault topup,-2.55,0.00,EUR,COMPLETED,592.75
Card Payment,Current,2024-07-31 09:08:35,2024-08-01 08:53:26,Copper + Straw,-4.70,0.00,EUR,COMPLETED,588.05
Transfer,Current,2024-08-01 10:14:46,2024-08-01 10:14:46,From Flexible Cash Funds,1000.00,0.00,EUR,COMPLETED,1588.05
Transfer,Current,2024-08-01 10:32:38,2024-08-01 10:32:38,Savings Vault topup,-0.35,0.00,EUR,COMPLETED,1587.70
Transfer,Current,2024-08-01 10:15:08,2024-08-01 10:49:50,To Colm Quish,-1440.00,0.00,EUR,COMPLETED,147.70
Card Payment,Current,2024-07-31 18:41:00,2024-08-01 11:03:58,Deliveroo,-29.99,0.00,EUR,COMPLETED,117.71
Card Payment,Current,2024-07-31 13:17:51,2024-08-01 12:18:56,Tesco,-12.70,0.00,EUR,COMPLETED,105.01
Transfer,Current,2024-08-01 23:01:55,2024-08-01 23:01:55,Savings Vault topup,-0.50,0.00,EUR,COMPLETED,104.51
Transfer,Current,2024-08-02 08:43:25,2024-08-02 08:43:25,Savings Vault topup,-4.85,0.00,EUR,COMPLETED,99.66
Transfer,Current,2024-08-02 08:49:56,2024-08-02 08:49:56,Savings Vault topup,-2.50,0.00,EUR,COMPLETED,97.16
Transfer,Current,2024-08-02 12:16:14,2024-08-02 12:16:14,Savings Vault topup,-1.95,0.00,EUR,COMPLETED,95.21
Card Payment,Current,2024-08-01 10:32:38,2024-08-02 12:21:44,SuperValu,-23.93,0.00,EUR,COMPLETED,71.28
Transfer,Current,2024-08-02 13:27:39,2024-08-02 13:27:39,Savings Vault topup,-5.00,0.00,EUR,COMPLETED,66.28
Transfer,Current,2024-08-02 14:09:36,2024-08-02 14:09:36,Transfer from MARA DI RAIMONDO,44.75,0.00,EUR,COMPLETED,111.03
Transfer,Current,2024-08-02 14:09:41,2024-08-02 14:09:41,Transfer from MARA DI RAIMONDO,41.91,0.00,EUR,COMPLETED,152.94
Transfer,Current,2024-08-02 14:11:18,2024-08-02 14:11:18,Savings Vault topup,-3.60,0.00,EUR,COMPLETED,149.34
Transfer,Current,2024-08-02 14:12:19,2024-08-02 14:12:20,Transfer from MARA DI RAIMONDO,18.28,0.00,EUR,COMPLETED,167.62
Card Payment,Current,2024-08-01 08:26:40,2024-08-02 15:36:44,HP,-1.49,0.00,EUR,COMPLETED,166.13
Card Payment,Current,2024-08-01 23:01:55,2024-08-02 16:31:57,Audible,-13.90,0.00,EUR,COMPLETED,152.23
Transfer,Current,2024-08-03 09:37:06,2024-08-03 09:37:06,Savings Vault topup,-4.00,0.00,EUR,COMPLETED,148.23
Card Payment,Current,2024-08-02 08:49:56,2024-08-03 10:34:39,Mint,-8.50,0.00,EUR,COMPLETED,139.73
Card Payment,Current,2024-08-02 08:43:25,2024-08-03 10:35:22,SuperValu,-12.03,0.00,EUR,COMPLETED,127.70
Card Payment,Current,2024-08-02 14:11:18,2024-08-03 11:36:01,Deliveroo,-18.28,0.00,EUR,COMPLETED,109.42
Transfer,Current,2024-08-03 11:42:57,2024-08-03 11:42:57,Savings Vault topup,-2.50,0.00,EUR,COMPLETED,106.92
Card Payment,Current,2024-08-02 12:16:13,2024-08-03 13:55:04,Amazon,-10.61,0.00,EUR,COMPLETED,96.31
Transfer,Current,2024-08-03 14:04:01,2024-08-03 14:04:01,Savings Vault topup,-5.00,0.00,EUR,COMPLETED,91.31
Transfer,Current,2024-08-03 15:01:33,2024-08-03 15:01:33,Transfer to PATRICK JOHN BYRNE,-10.00,0.00,EUR,COMPLETED,81.31
Card Payment,Current,2024-08-02 13:27:39,2024-08-03 15:15:16,The Bike Hub,-5.00,0.00,EUR,COMPLETED,76.31
Transfer,Current,2024-08-03 15:22:47,2024-08-03 15:22:47,Savings Vault topup,-0.50,0.00,EUR,COMPLETED,75.81
Transfer,Current,2024-08-03 20:53:51,2024-08-03 20:53:51,Pocket Withdrawal,84.00,0.00,EUR,COMPLETED,159.81
Transfer,Current,2024-08-03 20:56:14,2024-08-03 20:56:14,Transfer from BRYAN DALTON,52.00,0.00,EUR,COMPLETED,211.81
Transfer,Current,2024-08-03 20:56:18,2024-08-03 20:56:18,Transfer from EMMA LOUISE WALSH,85.00,0.00,EUR,COMPLETED,296.81
Transfer,Current,2024-08-03 20:57:01,2024-08-03 20:57:01,Transfer from EMMA LOUISE WALSH,5.60,0.00,EUR,COMPLETED,302.41
Transfer,Current,2024-08-03 20:58:17,2024-08-03 20:58:17,Pocket Withdrawal,50.00,0.00,EUR,COMPLETED,352.41
Transfer,Current,2024-08-03 20:58:36,2024-08-03 20:58:36,Savings Vault topup,-0.65,0.00,EUR,COMPLETED,351.76
Transfer,Current,2024-08-03 21:57:21,2024-08-03 21:57:21,Savings Vault topup,-2.50,0.00,EUR,COMPLETED,349.26
Transfer,Current,2024-08-03 22:01:43,2024-08-03 22:01:43,Savings Vault topup,-2.50,0.00,EUR,COMPLETED,346.76
Transfer,Current,2024-08-03 23:58:24,2024-08-03 23:58:24,Pocket Withdrawal,50.00,0.00,EUR,COMPLETED,396.76
Transfer,Current,2024-08-03 23:59:22,2024-08-03 23:59:22,Savings Vault topup,-2.00,0.00,EUR,COMPLETED,394.76
Transfer,Current,2024-08-04 02:14:01,2024-08-04 02:14:01,From Flexible Cash Funds,100.00,0.00,EUR,COMPLETED,494.76
Transfer,Current,2024-08-04 02:17:06,2024-08-04 02:17:06,Savings Vault topup,-5.00,0.00,EUR,COMPLETED,489.76
Transfer,Current,2024-08-04 02:51:54,2024-08-04 02:51:54,Savings Vault topup,-0.05,0.00,EUR,COMPLETED,489.71
Transfer,Current,2024-08-04 03:14:43,2024-08-04 03:14:43,Transfer to PATRICK JOHN BYRNE,-15.00,0.00,EUR,COMPLETED,474.71
Card Payment,Current,2024-08-03 15:22:47,2024-08-04 09:30:32,Finnegans Wake,-20.90,0.00,EUR,COMPLETED,453.81
Transfer,Current,2024-08-04 09:36:34,2024-08-04 09:36:34,Savings Vault topup,-0.50,0.00,EUR,COMPLETED,453.31
Card Payment,Current,2024-08-03 20:58:36,2024-08-04 09:46:20,Roberta's,-254.87,0.00,EUR,COMPLETED,198.44
Card Payment,Current,2024-08-03 14:04:01,2024-08-04 10:56:14,SuperValu,-8.00,0.00,EUR,COMPLETED,190.44
Card Payment,Current,2024-08-03 23:59:22,2024-08-04 11:35:44,Jack Nealons,-24.60,0.00,EUR,COMPLETED,165.84
Card Payment,Current,2024-08-03 09:37:06,2024-08-04 11:36:05,Gleesons,-5.20,0.00,EUR,COMPLETED,160.64
Card Payment,Current,2024-08-04 02:17:06,2024-08-04 11:47:15,Pawn Shop,-24.00,0.00,EUR,COMPLETED,136.64
Transfer,Current,2024-08-04 11:53:52,2024-08-04 11:53:52,Savings Vault topup,-2.50,0.00,EUR,COMPLETED,134.14
Transfer,Current,2024-08-04 12:16:18,2024-08-04 12:16:18,Savings Vault topup,-5.00,0.00,EUR,COMPLETED,129.14
Transfer,Current,2024-08-04 13:58:39,2024-08-04 13:58:39,From Flexible Cash Funds,100.00,0.00,EUR,COMPLETED,229.14
Transfer,Current,2024-08-04 13:58:43,2024-08-04 13:58:43,Savings Vault topup,-5.00,0.00,EUR,COMPLETED,224.14
Transfer,Current,2024-08-04 14:14:32,2024-08-04 14:14:32,Savings Vault topup,-0.25,0.00,EUR,COMPLETED,223.89
Transfer,Current,2024-08-04 14:27:48,2024-08-04 14:27:48,Savings Vault topup,-3.75,0.00,EUR,COMPLETED,220.14
Card Payment,Current,2024-08-04 09:36:34,2024-08-05 02:57:55,YouTube,-1.88,0.02,EUR,COMPLETED,218.24
Card Payment,Current,2024-08-04 02:51:53,2024-08-05 09:48:38,Apple,-2.99,0.00,EUR,COMPLETED,215.25
Card Payment,Current,2024-08-03 22:01:42,2024-08-05 10:11:39,Porterhouse,-3.50,0.00,EUR,COMPLETED,211.75
Card Payment,Current,2024-08-03 21:57:20,2024-08-05 10:11:44,Porterhouse,-21.50,0.00,EUR,COMPLETED,190.25
Card Payment,Current,2024-08-03 11:42:57,2024-08-05 10:40:50,Country Bake,-16.50,0.00,EUR,COMPLETED,173.75
Card Payment,Current,2024-08-04 14:27:48,2024-08-05 10:42:05,Easytrip,-10.25,0.00,EUR,COMPLETED,163.50
Card Payment,Current,2024-08-04 11:53:52,2024-08-05 10:44:58,Mint,-10.50,0.00,EUR,COMPLETED,153.00
Transfer,Current,2024-08-05 10:58:25,2024-08-05 10:58:26,Savings Vault topup,-3.75,0.00,EUR,COMPLETED,149.25
Card Payment,Current,2024-08-04 13:58:43,2024-08-05 11:49:03,Marks & Spencer,-88.00,0.00,EUR,COMPLETED,61.25
Card Payment,Current,2024-08-04 14:14:31,2024-08-05 12:05:17,Donnybrook Fair,-6.95,0.00,EUR,COMPLETED,54.30
Card Payment,Current,2024-08-04 12:16:16,2024-08-05 12:15:19,Applegreen,-10.00,0.00,EUR,COMPLETED,44.30
Transfer,Current,2024-08-05 14:21:28,2024-08-05 14:21:28,Savings Vault topup,-5.00,0.00,EUR,COMPLETED,39.30
Card Payment,Current,2024-08-05 14:21:27,2024-08-06 09:17:39,Payzone,-10.00,0.00,EUR,COMPLETED,29.30
Card Payment,Current,2024-08-05 10:57:57,2024-08-06 11:21:14,Gleesons,-4.25,0.00,EUR,COMPLETED,25.05
Transfer,Current,2024-08-07 15:15:26,2024-08-07 15:15:27,From Flexible Cash Funds,100.00,0.00,EUR,COMPLETED,125.05
Transfer,Current,2024-08-07 15:15:34,2024-08-07 15:15:34,To pocket EUR Subscriptions from EUR,-40.00,0.00,EUR,COMPLETED,85.05
Transfer,Current,2024-08-07 20:41:05,2024-08-07 20:41:05,Savings Vault topup,-0.55,0.00,EUR,COMPLETED,84.50
Card Payment,Current,2024-08-07 20:41:05,2024-08-08 09:52:47,Deliveroo,-21.89,0.00,EUR,COMPLETED,62.61
Transfer,Current,2024-08-08 13:55:49,2024-08-08 13:55:49,Savings Vault topup,-2.50,0.00,EUR,COMPLETED,60.11
Transfer,Current,2024-08-08 15:58:23,2024-08-08 15:58:24,Transfer from MARA DI RAIMONDO,10.94,0.00,EUR,COMPLETED,71.05
Transfer,Current,2024-08-08 17:08:41,2024-08-08 17:08:41,Savings Vault topup,-5.00,0.00,EUR,COMPLETED,66.05
Transfer,Current,2024-08-08 17:09:56,2024-08-08 17:09:56,Savings Vault topup,-3.80,0.00,EUR,COMPLETED,62.25
Transfer,Current,2024-08-08 19:24:08,2024-08-08 19:24:08,From Flexible Cash Funds,100.00,0.00,EUR,COMPLETED,162.25
Transfer,Current,2024-08-08 19:24:42,2024-08-08 19:24:42,Savings Vault topup,-5.00,0.00,EUR,COMPLETED,157.25
Transfer,Current,2024-08-08 19:25:16,2024-08-08 19:25:16,Transfer from CONNOR MATTHEW BYRNE,45.00,0.00,EUR,COMPLETED,202.25
Transfer,Current,2024-08-08 20:05:16,2024-08-08 20:05:16,Savings Vault topup,-2.00,0.00,EUR,COMPLETED,200.25
Transfer,Current,2024-08-09 08:47:12,2024-08-09 08:47:12,Savings Vault topup,-4.50,0.00,EUR,COMPLETED,195.75
Card Payment,Current,2024-08-08 17:09:56,2024-08-09 09:15:42,Strike Pay,-3.24,0.00,EUR,COMPLETED,192.51
Transfer,Current,2024-08-09 09:37:17,2024-08-09 09:37:17,Savings Vault topup,-2.50,0.00,EUR,COMPLETED,190.01
Transfer,Current,2024-08-09 09:48:39,2024-08-09 09:48:39,Savings Vault topup,-4.15,0.00,EUR,COMPLETED,185.86
Card Payment,Current,2024-08-08 19:24:42,2024-08-09 09:56:48,Eatokyo Sushi Noodles Bar,-90.00,0.00,EUR,COMPLETED,95.86
Card Payment,Current,2024-08-08 13:55:42,2024-08-09 10:43:15,Centra,-8.50,0.00,EUR,COMPLETED,87.36
Card Payment,Current,2024-08-08 20:05:15,2024-08-09 11:01:38,The Grand Social,-14.60,0.00,EUR,COMPLETED,72.76
Card Payment,Current,2024-08-08 17:08:40,2024-08-09 11:10:46,Cut and Sew,-32.00,0.00,EUR,COMPLETED,40.76
Transfer,Current,2024-08-09 23:19:48,2024-08-09 23:19:48,Savings Vault topup,-2.50,0.00,EUR,COMPLETED,38.26
Card Payment,Current,2024-08-09 09:37:17,2024-08-10 10:52:44,Mint,-8.50,0.00,EUR,COMPLETED,29.76
Card Payment,Current,2024-08-09 09:48:38,2024-08-10 10:55:24,SuperValu,-16.17,0.00,EUR,COMPLETED,13.59
Card Payment,Current,2024-08-09 08:47:11,2024-08-10 11:17:53,Deli,-3.10,0.00,EUR,COMPLETED,10.49
Transfer,Current,2024-08-10 17:11:27,2024-08-10 17:11:27,From Flexible Cash Funds,100.00,0.00,EUR,COMPLETED,110.49
Transfer,Current,2024-08-10 17:11:32,2024-08-10 17:11:32,Savings Vault topup,-2.10,0.00,EUR,COMPLETED,108.39
Transfer,Current,2024-08-11 08:43:41,2024-08-11 08:43:41,Savings Vault topup,-0.05,0.00,EUR,COMPLETED,108.34
Card Payment,Current,2024-08-09 23:19:48,2024-08-11 09:46:04,The White House,-3.50,0.00,EUR,COMPLETED,104.84
Card Payment,Current,2024-08-10 17:11:32,2024-08-11 10:01:22,La Cucina,-19.58,0.00,EUR,COMPLETED,85.26
Transfer,Current,2024-08-12 09:08:48,2024-08-12 09:08:49,Transfer to MARA DI RAIMONDO,-5.00,0.00,EUR,COMPLETED,80.26
Card Payment,Current,2024-08-11 08:43:41,2024-08-12 09:20:31,Apple,-19.99,0.00,EUR,COMPLETED,60.27
Topup,Current,2024-08-12 10:45:09,2024-08-12 10:45:10,Payment from PATRICIA        QUISH,300.00,0.00,EUR,COMPLETED,360.27
Transfer,Current,2024-08-12 12:39:02,2024-08-12 12:39:02,Savings Vault topup,-5.00,0.00,EUR,COMPLETED,355.27
Transfer,Current,2024-08-12 13:10:42,2024-08-12 13:10:42,Savings Vault topup,-5.00,0.00,EUR,COMPLETED,350.27
Exchange,Current,2024-08-12 18:06:53,2024-08-12 18:06:53,Exchanged to EUR,13.64,0.00,EUR,COMPLETED,363.91
Transfer,Current,2024-08-12 18:07:27,2024-08-12 18:07:27,Transfer from MARA DI RAIMONDO,35.00,0.00,EUR,COMPLETED,398.91
Transfer,Current,2024-08-12 18:17:08,2024-08-12 18:17:08,Savings Vault topup,-0.85,0.00,EUR,COMPLETED,398.06
Card Payment,Current,2024-08-12 13:10:42,2024-08-13 10:05:42,Ucd Bikes,-20.00,0.00,EUR,COMPLETED,378.06
Card Payment,Current,2024-08-12 12:39:02,2024-08-13 10:06:02,Gather and Gather,-4.00,0.00,EUR,COMPLETED,374.06
Card Payment,Current,2024-08-12 18:17:08,2024-08-13 10:36:03,Lufthansa,-251.83,0.00,EUR,COMPLETED,122.23
Transfer,Current,2024-08-13 12:45:05,2024-08-13 12:45:05,Savings Vault topup,-5.00,0.00,EUR,COMPLETED,117.23
Transfer,Current,2024-08-13 13:08:25,2024-08-13 13:08:25,Savings Vault topup,-2.75,0.00,EUR,COMPLETED,114.48
Transfer,Current,2024-08-13 17:16:43,2024-08-13 17:16:43,Savings Vault topup,-5.00,0.00,EUR,COMPLETED,109.48
Transfer,Current,2024-08-13 17:22:44,2024-08-13 17:22:44,Savings Vault topup,-5.00,0.00,EUR,COMPLETED,104.48
Transfer,Current,2024-08-13 20:16:40,2024-08-13 20:16:40,Savings Vault topup,-0.10,0.00,EUR,COMPLETED,104.38
Transfer,Current,2024-08-14 09:00:38,2024-08-14 09:00:38,Transfer from CAROLINE DEVEREUX,65.00,0.00,EUR,COMPLETED,169.38
Transfer,Current,2024-08-14 09:05:02,2024-08-14 09:05:02,Savings Vault topup,-1.50,0.00,EUR,COMPLETED,167.88
Card Payment,Current,2024-08-13 17:22:44,2024-08-14 09:54:40,Decathlon,-11.00,0.00,EUR,COMPLETED,156.88
Card Payment,Current,2024-08-13 12:45:05,2024-08-14 10:13:29,Centra,-15.00,0.00,EUR,COMPLETED,141.88
Card Payment,Current,2024-08-13 17:16:43,2024-08-14 10:51:34,Sports Direct,-12.00,0.00,EUR,COMPLETED,129.88
Card Payment,Current,2024-08-13 20:16:39,2024-08-14 10:57:59,Deliveroo,-21.98,0.00,EUR,COMPLETED,107.90
Card Payment,Current,2024-08-13 13:08:24,2024-08-14 11:15:58,OXMANTOWN,-4.45,0.00,EUR,COMPLETED,103.45
Transfer,Current,2024-08-14 13:14:50,2024-08-14 13:14:51,Savings Vault topup,-2.50,0.00,EUR,COMPLETED,100.95
Transfer,Current,2024-08-14 18:40:49,2024-08-14 18:40:49,To EUR,0.10,0.00,EUR,COMPLETED,101.05
Transfer,Current,2024-08-14 21:50:36,2024-08-14 21:50:36,Savings Vault topup,-3.75,0.00,EUR,COMPLETED,97.30
Transfer,Current,2024-08-14 23:01:00,2024-08-14 23:01:00,Savings Vault topup,-2.60,0.00,EUR,COMPLETED,94.70
Transfer,Current,2024-08-15 08:46:19,2024-08-15 08:46:19,Savings Vault topup,-2.50,0.00,EUR,COMPLETED,92.20
Transfer,Current,2024-08-15 09:16:05,2024-08-15 09:16:05,Savings Vault topup,-2.20,0.00,EUR,COMPLETED,90.00
Card Payment,Current,2024-08-14 13:14:50,2024-08-15 11:58:09,Centra,-5.50,0.00,EUR,COMPLETED,84.50
Card Payment,Current,2024-08-14 23:01:00,2024-08-15 14:57:30,Amazon,-5.48,0.00,EUR,COMPLETED,79.02
Transfer,Current,2024-08-15 15:10:40,2024-08-15 15:10:40,From Flexible Cash Funds,100.00,0.00,EUR,COMPLETED,179.02
Transfer,Current,2024-08-15 15:10:48,2024-08-15 15:10:48,Savings Vault topup,-5.00,0.00,EUR,COMPLETED,174.02
Transfer,Current,2024-08-15 15:14:58,2024-08-15 15:14:58,Savings Vault topup,-4.00,0.00,EUR,COMPLETED,170.02
Card Payment,Current,2024-08-14 21:50:36,2024-08-15 17:26:26,McDonald's,-20.25,0.00,EUR,COMPLETED,149.77
Card Payment,Current,2024-08-14 09:05:02,2024-08-15 17:44:46,Copper + Straw,-4.70,0.00,EUR,COMPLETED,145.07
Transfer,Current,2024-08-16 08:04:09,2024-08-16 08:04:09,Savings Vault topup,-0.05,0.00,EUR,COMPLETED,145.02
Card Payment,Current,2024-08-15 08:46:18,2024-08-16 11:34:44,Mint,-8.50,0.00,EUR,COMPLETED,136.52
Card Payment,Current,2024-08-15 15:14:58,2024-08-16 11:38:45,Starbucks,-4.20,0.00,EUR,COMPLETED,132.32
Card Payment,Current,2024-08-15 09:16:04,2024-08-16 11:41:10,SuperValu,-31.56,0.00,EUR,COMPLETED,100.76
Transfer,Current,2024-08-16 16:03:52,2024-08-16 16:03:52,Savings Vault topup,-5.00,0.00,EUR,COMPLETED,95.76
Transfer,Current,2024-08-16 18:32:20,2024-08-16 18:32:20,Transfer from MARA DI RAIMONDO,19.00,0.00,EUR,COMPLETED,114.76
Transfer,Current,2024-08-16 18:32:50,2024-08-16 18:32:50,Transfer from MARA DI RAIMONDO,13.50,0.00,EUR,COMPLETED,128.26
Transfer,Current,2024-08-16 18:32:53,2024-08-16 18:32:53,Transfer from MARA DI RAIMONDO,30.00,0.00,EUR,COMPLETED,158.26
Transfer,Current,2024-08-16 18:35:10,2024-08-16 18:35:10,Savings Vault topup,-0.55,0.00,EUR,COMPLETED,157.71
Card Payment,Current,2024-08-16 08:04:09,2024-08-17 09:39:49,Apple,-8.99,0.00,EUR,COMPLETED,148.72
Card Payment,Current,2024-08-16 16:03:52,2024-08-17 10:11:32,Xl,-9.00,0.00,EUR,COMPLETED,139.72
Card Payment,Current,2024-08-15 15:10:48,2024-08-17 10:39:31,An Post,-23.00,0.00,EUR,COMPLETED,116.72
Card Payment,Current,2024-08-16 18:35:10,2024-08-17 11:05:47,Deliveroo,-39.89,0.00,EUR,COMPLETED,76.83
Transfer,Current,2024-08-17 12:50:17,2024-08-17 12:50:17,Transfer to PATRICK JOHN BYRNE,-45.00,0.00,EUR,COMPLETED,31.83
Transfer,Current,2024-08-17 16:19:21,2024-08-17 16:19:21,Savings Vault topup,-2.00,0.00,EUR,COMPLETED,29.83
Card Payment,Current,2024-08-17 16:19:21,2024-08-18 10:10:11,SuperValu,-3.60,0.00,EUR,COMPLETED,26.23
Card Refund,Current,2024-08-16 10:43:38,2024-08-18 14:03:33,Amazon,59.71,0.00,EUR,COMPLETED,85.94
Transfer,Current,2024-08-18 15:52:19,2024-08-18 15:52:19,Savings Vault topup,-4.55,0.00,EUR,COMPLETED,81.39
Transfer,Current,2024-08-18 15:53:31,2024-08-18 15:53:32,Transfer from PATRICK JOHN BYRNE,18.00,0.00,EUR,COMPLETED,99.39
Card Payment,Current,2024-08-18 15:52:18,2024-08-19 09:14:46,Deliveroo,-46.09,0.00,EUR,COMPLETED,53.30
Transfer,Current,2024-08-20 08:53:57,2024-08-20 08:53:57,Savings Vault topup,-1.50,0.00,EUR,COMPLETED,51.80
Transfer,Current,2024-08-20 10:48:30,2024-08-20 10:48:30,Transfer from MARA DI RAIMONDO,20.00,0.00,EUR,COMPLETED,71.80
Transfer,Current,2024-08-21 09:11:20,2024-08-21 09:11:20,Savings Vault topup,-1.50,0.00,EUR,COMPLETED,70.30
Transfer,Current,2024-08-21 21:21:27,2024-08-21 21:21:27,From Flexible Cash Funds,1200.00,0.00,EUR,COMPLETED,1270.30
Transfer,Current,2024-08-21 21:21:50,2024-08-21 21:21:50,Savings Vault topup,-5.00,0.00,EUR,COMPLETED,1265.30
Transfer,Current,2024-08-22 08:26:13,2024-08-22 08:26:13,Savings Vault topup,-0.05,0.00,EUR,COMPLETED,1265.25
Transfer,Current,2024-08-22 08:32:13,2024-08-22 08:32:13,Savings Vault topup,-2.50,0.00,EUR,COMPLETED,1262.75
Card Payment,Current,2024-08-20 08:53:57,2024-08-22 09:27:34,Copper + Straw,-4.70,0.00,EUR,COMPLETED,1258.05
Card Payment,Current,2024-08-21 09:11:20,2024-08-22 09:39:33,Copper + Straw,-4.70,0.00,EUR,COMPLETED,1253.35
Topup,Current,2024-08-22 10:35:58,2024-08-22 10:35:58,Payment from PATRICIA        QUISH,100.00,0.00,EUR,COMPLETED,1353.35
Card Payment,Current,2024-08-21 21:21:50,2024-08-22 11:10:43,Vayama,-1164.00,0.00,EUR,COMPLETED,189.35
Transfer,Current,2024-08-22 01:00:00,2024-08-22 11:41:21,To eFlow,-5.83,0.00,EUR,COMPLETED,183.52
Transfer,Current,2024-08-22 11:05:47,2024-08-22 11:50:37,To Colm Quish,-150.00,0.00,EUR,COMPLETED,33.52
Transfer,Current,2024-08-22 17:10:01,2024-08-22 17:10:01,Savings Vault topup,-3.40,0.00,EUR,COMPLETED,30.12
Transfer,Current,2024-08-22 18:23:59,2024-08-22 18:23:59,From Flexible Cash Funds,50.00,0.00,EUR,COMPLETED,80.12
Transfer,Current,2024-08-22 18:24:18,2024-08-22 18:24:18,Savings Vault topup,-3.25,0.00,EUR,COMPLETED,76.87
Transfer,Current,2024-08-22 18:26:01,2024-08-22 18:26:01,Pocket Withdrawal,22.65,0.00,EUR,COMPLETED,99.52
Transfer,Current,2024-08-22 18:26:05,2024-08-22 18:26:05,Transfer from MARA DI RAIMONDO,20.00,0.00,EUR,COMPLETED,119.52
Transfer,Current,2024-08-22 18:26:53,2024-08-22 18:26:54,Savings Vault topup,-0.25,0.00,EUR,COMPLETED,119.27
Transfer,Current,2024-08-22 18:35:40,2024-08-22 18:35:40,From Flexible Cash Funds,120.00,0.00,EUR,COMPLETED,239.27
Transfer,Current,2024-08-22 18:39:03,2024-08-22 18:39:03,From Flexible Cash Funds,10.00,0.00,EUR,COMPLETED,249.27
Transfer,Current,2024-08-22 18:40:00,2024-08-22 18:40:00,Savings Vault topup,-5.00,0.00,EUR,COMPLETED,244.27
Transfer,Current,2024-08-22 18:46:39,2024-08-22 18:46:39,From Flexible Cash Funds,10.00,0.00,EUR,COMPLETED,254.27
Transfer,Current,2024-08-22 18:47:07,2024-08-22 18:47:07,Savings Vault topup,-1.50,0.00,EUR,COMPLETED,252.77
Topup,Current,2024-08-23 08:07:01,2024-08-23 08:07:02,Payment from WORKDAY LIMITED,2848.59,0.00,EUR,COMPLETED,3101.36
Transfer,Current,2024-08-23 08:32:30,2024-08-23 08:32:30,Savings Vault topup,-2.50,0.00,EUR,COMPLETED,3098.86
Transfer,Current,2024-08-23 08:09:17,2024-08-23 08:52:20,To Colm Quish,-243.26,0.00,EUR,COMPLETED,2855.60
Card Payment,Current,2024-08-22 18:26:53,2024-08-23 09:28:26,Zakura,-48.95,0.00,EUR,COMPLETED,2806.65
Card Payment,Current,2024-08-22 18:24:18,2024-08-23 09:46:17,Movies@,-43.35,0.00,EUR,COMPLETED,2763.30
Card Payment,Current,2024-08-22 17:10:01,2024-08-23 09:53:16,Parking Payments,-7.32,0.00,EUR,COMPLETED,2755.98
Card Payment,Current,2024-08-22 08:32:13,2024-08-23 09:54:19,Mint,-8.50,0.00,EUR,COMPLETED,2747.48
Card Payment,Current,2024-08-22 08:26:13,2024-08-23 09:56:02,SuperValu,-9.99,0.00,EUR,COMPLETED,2737.49
Card Payment,Current,2024-08-22 18:47:07,2024-08-23 10:36:16,Searsons Bar,-8.70,0.00,EUR,COMPLETED,2728.79
Card Payment,Current,2024-08-22 18:40:00,2024-08-23 11:28:18,Park Rite,-125.00,0.00,EUR,COMPLETED,2603.79
Transfer,Current,2024-08-23 15:50:30,2024-08-23 15:50:30,Savings Vault topup,-0.05,0.00,EUR,COMPLETED,2603.74
Transfer,Current,2024-08-23 20:19:11,2024-08-23 20:19:11,Transfer to ENDA CARROLL,-50.00,0.00,EUR,COMPLETED,2553.74
Card Payment,Current,2024-08-23 08:32:29,2024-08-24 09:18:43,Mint,-8.50,0.00,EUR,COMPLETED,2545.24
Card Payment,Current,2024-08-23 15:50:30,2024-08-24 10:15:00,PlayStation,-69.99,0.00,EUR,COMPLETED,2475.25
Transfer,Current,2024-08-24 13:19:59,2024-08-24 13:19:59,Savings Vault topup,-0.05,0.00,EUR,COMPLETED,2475.20
Transfer,Current,2024-08-24 13:23:00,2024-08-24 13:23:00,Savings Vault topup,-2.50,0.00,EUR,COMPLETED,2472.70
Transfer,Current,2024-08-24 17:59:26,2024-08-24 17:59:26,Savings Vault topup,-2.50,0.00,EUR,COMPLETED,2470.20
Transfer,Current,2024-08-24 19:32:49,2024-08-24 19:32:50,Savings Vault topup,-5.00,0.00,EUR,COMPLETED,2465.20
Card Payment,Current,2024-08-24 13:23:00,2024-08-25 11:00:51,The Old Punch Bowl,-7.50,0.00,EUR,COMPLETED,2457.70
Card Payment,Current,2024-08-24 19:32:49,2024-08-25 11:00:58,TriBeCa,-120.00,0.00,EUR,COMPLETED,2337.70
Transfer,Current,2024-08-25 11:07:16,2024-08-25 11:07:16,To pocket EUR Subscriptions from EUR,-700.00,0.00,EUR,COMPLETED,1637.70
Transfer,Current,2024-08-25 18:41:43,2024-08-25 18:41:43,Savings Vault topup,-1.20,0.00,EUR,COMPLETED,1636.50
Transfer,Current,2024-08-25 08:18:39,2024-08-26 02:07:23,To Finance Ireland,-1424.50,0.00,EUR,COMPLETED,212.00
Transfer,Current,2024-08-26 09:29:37,2024-08-26 09:29:37,Transfer from MARA DI RAIMONDO,10.00,0.00,EUR,COMPLETED,222.00
Card Payment,Current,2024-08-25 18:41:43,2024-08-26 11:11:09,Lidl,-60.76,0.00,EUR,COMPLETED,161.24
Card Payment,Current,2024-08-24 17:59:26,2024-08-26 11:19:54,Parking Payments,-10.50,0.00,EUR,COMPLETED,150.74
Card Payment,Current,2024-08-24 13:19:59,2024-08-26 11:32:15,Clark’s Newsagent,-8.99,0.00,EUR,COMPLETED,141.75
Transfer,Current,2024-08-26 11:34:19,2024-08-26 11:34:19,Transfer from MARA DI RAIMONDO,2.99,0.00,EUR,COMPLETED,144.74
Transfer,Current,2024-08-26 11:35:14,2024-08-26 11:35:15,Transfer to MARA DI RAIMONDO,-5.98,0.00,EUR,COMPLETED,138.76
Exchange,Current,2024-08-26 15:53:17,2024-08-26 15:53:17,Exchanged to EUR,14201.03,0.00,EUR,COMPLETED,14339.79
Transfer,Current,2024-08-26 15:53:35,2024-08-26 15:53:35,Savings Vault topup,-14201.00,0.00,EUR,COMPLETED,138.79
Transfer,Current,2024-08-26 16:32:49,2024-08-26 16:32:49,From Flexible Cash Funds,689.99,0.00,EUR,COMPLETED,828.78
Transfer,Current,2024-08-26 16:33:02,2024-08-26 16:33:02,Savings Vault topup,-0.05,0.00,EUR,COMPLETED,828.73
Transfer,Current,2024-08-27 09:01:20,2024-08-27 09:01:20,Savings Vault topup,-1.50,0.00,EUR,COMPLETED,827.23
Transfer,Current,2024-08-27 13:01:54,2024-08-27 13:01:54,From Flexible Cash Funds,460.00,0.00,EUR,COMPLETED,1287.23
Transfer,Current,2024-08-27 13:04:05,2024-08-27 13:04:05,Savings Vault topup,-0.35,0.00,EUR,COMPLETED,1286.88
Transfer,Current,2024-08-27 13:29:24,2024-08-27 13:29:24,Savings Vault topup,-5.00,0.00,EUR,COMPLETED,1281.88
Transfer,Current,2024-08-27 13:40:36,2024-08-27 13:40:36,From Flexible Cash Funds,100.00,0.00,EUR,COMPLETED,1381.88
Transfer,Current,2024-08-27 13:40:43,2024-08-27 13:40:43,Savings Vault topup,-5.00,0.00,EUR,COMPLETED,1376.88
Card Payment,Current,2024-08-26 16:33:02,2024-08-27 15:14:45,Zwift,-689.99,0.00,EUR,COMPLETED,686.89
Transfer,Current,2024-08-27 18:47:10,2024-08-27 18:47:10,Savings Vault topup,-1.25,0.00,EUR,COMPLETED,685.64
Transfer,Current,2024-08-27 18:56:28,2024-08-27 18:56:28,Savings Vault topup,-2.50,0.00,EUR,COMPLETED,683.14
Transfer,Current,2024-08-27 20:52:07,2024-08-27 20:52:07,Pocket Withdrawal,30.00,0.00,EUR,COMPLETED,713.14
Transfer,Current,2024-08-27 20:52:11,2024-08-27 20:52:12,Savings Vault topup,-2.00,0.00,EUR,COMPLETED,711.14
Transfer,Current,2024-08-27 20:57:19,2024-08-27 20:57:19,Pocket Withdrawal,50.00,0.00,EUR,COMPLETED,761.14
Transfer,Current,2024-08-27 20:59:41,2024-08-27 20:59:41,Savings Vault topup,-1.00,0.00,EUR,COMPLETED,760.14
Transfer,Current,2024-08-27 22:04:29,2024-08-27 22:04:29,Transfer to RORY BOYLE,-10.00,0.00,EUR,COMPLETED,750.14
Transfer,Current,2024-08-28 08:53:41,2024-08-28 08:53:41,Savings Vault topup,-2.55,0.00,EUR,COMPLETED,747.59
Card Payment,Current,2024-08-27 13:29:24,2024-08-28 09:14:30,Decathlon,-54.00,0.00,EUR,COMPLETED,693.59
Card Payment,Current,2024-08-27 13:40:43,2024-08-28 09:16:08,Life Style Sports,-150.00,0.00,EUR,COMPLETED,543.59
Card Payment,Current,2024-08-27 18:47:09,2024-08-28 09:37:58,Boojum,-8.75,0.00,EUR,COMPLETED,534.84
Card Payment,Current,2024-08-27 18:56:28,2024-08-28 10:16:17,Reynolds Logistics,-8.50,0.00,EUR,COMPLETED,526.34
Card Payment,Current,2024-08-27 20:52:11,2024-08-28 11:04:37,The Ginger Man,-27.60,0.00,EUR,COMPLETED,498.74
Card Payment,Current,2024-08-27 20:59:41,2024-08-28 11:04:38,The Ginger Man,-13.80,0.00,EUR,COMPLETED,484.94
Card Payment,Current,2024-08-27 13:04:05,2024-08-28 11:39:50,Zurich Insurance,-456.93,0.00,EUR,COMPLETED,28.01
Card Payment,Current,2024-08-27 09:01:20,2024-08-28 11:42:15,Copper + Straw,-4.70,0.00,EUR,COMPLETED,23.31
Transfer,Current,2024-08-28 21:12:55,2024-08-28 21:12:55,Pocket Withdrawal,150.00,0.00,EUR,COMPLETED,173.31
Transfer,Current,2024-08-28 21:14:01,2024-08-28 21:14:01,Savings Vault topup,-1.00,0.00,EUR,COMPLETED,172.31
Transfer,Current,2024-08-28 21:19:56,2024-08-28 21:19:56,Savings Vault topup,-0.05,0.00,EUR,COMPLETED,172.26
Transfer,Current,2024-08-29 08:05:32,2024-08-29 08:05:32,Savings Vault topup,-1.50,0.00,EUR,COMPLETED,170.76
Card Payment,Current,2024-08-28 08:53:40,2024-08-29 10:22:07,HP,-1.49,0.00,EUR,COMPLETED,169.27
Card Payment,Current,2024-08-28 21:19:56,2024-08-29 11:15:06,360 Cycles,-109.99,0.00,EUR,COMPLETED,59.28
Transfer,Current,2024-08-29 13:00:54,2024-08-29 13:00:54,Savings Vault topup,-2.50,0.00,EUR,COMPLETED,56.78
Card Payment,Current,2024-08-28 21:14:01,2024-08-29 14:46:48,Amazon,-26.80,0.00,EUR,COMPLETED,29.98
Transfer,Current,2024-08-29 18:55:16,2024-08-29 18:55:16,Pocket Withdrawal,50.00,0.00,EUR,COMPLETED,79.98
Transfer,Current,2024-08-29 18:55:33,2024-08-29 18:55:33,Savings Vault topup,-3.95,0.00,EUR,COMPLETED,76.03
Transfer,Current,2024-08-30 06:36:40,2024-08-30 06:36:40,Transfer from MARA DI RAIMONDO,550.00,0.00,EUR,COMPLETED,626.03
Transfer,Current,2024-08-30 08:02:23,2024-08-30 08:02:23,Savings Vault topup,-2.50,0.00,EUR,COMPLETED,623.53
Transfer,Current,2024-08-30 08:02:45,2024-08-30 08:02:45,Savings Vault topup,-420.00,0.00,EUR,COMPLETED,203.53
Transfer,Current,2024-08-30 08:25:20,2024-08-30 08:25:20,Savings Vault topup,-4.70,0.00,EUR,COMPLETED,198.83
Transfer,Current,2024-08-30 08:26:36,2024-08-30 08:26:36,Savings Vault topup,-5.00,0.00,EUR,COMPLETED,193.83
Card Refund,Current,2024-08-29 17:56:20,2024-08-30 09:53:31,Decathlon,48.00,0.00,EUR,COMPLETED,241.83
Card Payment,Current,2024-08-29 13:00:54,2024-08-30 10:52:43,Centra,-5.50,0.00,EUR,COMPLETED,236.33
Card Payment,Current,2024-08-29 08:05:32,2024-08-30 11:06:16,Copper + Straw,-4.70,0.00,EUR,COMPLETED,231.63
Transfer,Current,2024-08-30 20:06:51,2024-08-30 20:06:52,Savings Vault topup,-4.15,0.00,EUR,COMPLETED,227.48
Transfer,Current,2024-08-31 09:18:31,2024-08-31 09:18:31,Savings Vault topup,-2.00,0.00,EUR,COMPLETED,225.48
Card Refund,Current,2024-08-29 17:39:46,2024-08-31 09:36:00,360 Cycles,109.99,0.00,EUR,COMPLETED,335.47
Transfer,Current,2024-08-31 09:49:04,2024-08-31 09:49:04,Savings Vault topup,-2.50,0.00,EUR,COMPLETED,332.97
Card Payment,Current,2024-08-30 08:02:23,2024-08-31 10:38:07,Mint,-8.50,0.00,EUR,COMPLETED,324.47
Card Payment,Current,2024-08-30 08:25:20,2024-08-31 10:39:32,SuperValu,-18.06,0.00,EUR,COMPLETED,306.41
Card Payment,Current,2024-08-30 08:26:36,2024-08-31 11:46:03,Xl,-9.00,0.00,EUR,COMPLETED,297.41
Card Payment,Current,2024-08-30 20:06:51,2024-08-31 12:23:12,Amazon,-12.17,0.00,EUR,COMPLETED,285.24
Card Payment,Current,2024-08-29 18:55:33,2024-08-31 12:35:12,Amazon,-34.21,0.00,EUR,COMPLETED,251.03
Transfer,Current,2024-08-31 14:43:16,2024-08-31 14:43:17,Savings Vault topup,-3.35,0.00,EUR,COMPLETED,247.68
Transfer,Current,2024-08-31 15:26:11,2024-08-31 15:26:11,Savings Vault topup,-0.20,0.00,EUR,COMPLETED,247.48
Transfer,Current,2024-08-31 15:38:50,2024-08-31 15:38:50,Savings Vault topup,-1.10,0.00,EUR,COMPLETED,246.38
Transfer,Current,2024-08-31 15:57:23,2024-08-31 15:57:23,Savings Vault topup,-5.00,0.00,EUR,COMPLETED,241.38
Card Payment,Current,2024-08-31 09:49:03,2024-09-01 09:04:53,Parlour,-7.50,0.00,EUR,COMPLETED,233.88
Card Payment,Current,2024-08-31 15:38:50,2024-09-01 10:53:26,SuperValu,-28.78,0.00,EUR,COMPLETED,205.10
Card Payment,Current,2024-08-31 15:26:10,2024-09-01 10:57:28,Home Store + More,-44.96,0.00,EUR,COMPLETED,160.14
Card Payment,Current,2024-08-31 09:18:31,2024-09-01 11:41:43,Hatch Coffee,-17.60,0.00,EUR,COMPLETED,142.54
Transfer,Current,2024-09-01 12:53:52,2024-09-01 12:53:52,Savings Vault topup,-2.75,0.00,EUR,COMPLETED,139.79
Card Payment,Current,2024-08-31 14:43:16,2024-09-02 12:05:48,Camile Thai,-15.33,0.00,EUR,COMPLETED,124.46
Card Payment,Current,2024-08-31 15:57:22,2024-09-02 12:08:36,Easytrip,-10.00,0.00,EUR,COMPLETED,114.46
Card Payment,Current,2024-09-01 12:53:52,2024-09-02 12:09:39,Circle K Gas Station,-11.45,0.00,EUR,COMPLETED,103.01
Transfer,Current,2024-09-02 12:17:07,2024-09-02 12:17:07,Savings Vault topup,-1.45,0.00,EUR,COMPLETED,101.56
Transfer,Current,2024-09-02 12:50:04,2024-09-02 12:50:04,Savings Vault topup,-3.85,0.00,EUR,COMPLETED,97.71
Transfer,Current,2024-09-03 07:50:50,2024-09-03 07:50:50,Savings Vault topup,-2.00,0.00,EUR,COMPLETED,95.71
Card Payment,Current,2024-09-02 12:50:04,2024-09-03 09:45:10,Lidl,-33.23,0.00,EUR,COMPLETED,62.48
Transfer,Current,2024-09-03 11:39:20,2024-09-03 11:39:20,Savings Vault topup,-0.80,0.00,EUR,COMPLETED,61.68
Transfer,Current,2024-09-03 11:39:33,2024-09-03 11:39:33,Pocket Withdrawal,50.00,0.00,EUR,COMPLETED,111.68
Card Payment,Current,2024-09-02 12:17:06,2024-09-03 14:04:57,Amazon,-10.71,0.00,EUR,COMPLETED,100.97
Transfer,Current,2024-09-03 17:27:20,2024-09-03 17:27:20,Savings Vault topup,-5.00,0.00,EUR,COMPLETED,95.97
Transfer,Current,2024-09-04 02:51:48,2024-09-04 02:51:48,Savings Vault topup,-0.05,0.00,EUR,COMPLETED,95.92
Transfer,Current,2024-09-04 09:36:22,2024-09-04 09:36:22,Savings Vault topup,-0.90,0.00,EUR,COMPLETED,95.02
Card Payment,Current,2024-09-03 17:27:20,2024-09-04 10:29:21,Transport for Ireland - TFI,-15.00,0.00,EUR,COMPLETED,80.02
Transfer,Current,2024-09-04 11:11:13,2024-09-04 11:11:14,From Flexible Cash Funds,1000.00,0.00,EUR,COMPLETED,1080.02
Transfer,Current,2024-09-04 11:13:19,2024-09-04 11:13:19,Savings Vault topup,-1.55,0.00,EUR,COMPLETED,1078.47
Transfer,Current,2024-09-04 18:11:35,2024-09-04 18:11:35,Savings Vault topup,-2.00,0.00,EUR,COMPLETED,1076.47
Transfer,Current,2024-09-04 18:35:27,2024-09-04 18:35:27,Savings Vault topup,-5.00,0.00,EUR,COMPLETED,1071.47
Transfer,Current,2024-09-04 19:03:33,2024-09-04 19:03:33,Transfer from JOHN DANIEL KIELY,22.00,0.00,EUR,COMPLETED,1093.47
Transfer,Current,2024-09-04 19:05:10,2024-09-04 19:05:10,Savings Vault topup,-2.00,0.00,EUR,COMPLETED,1091.47
Card Payment,Current,2024-09-04 09:36:22,2024-09-05 03:01:57,YouTube,-1.81,0.00,EUR,COMPLETED,1089.66
Card Payment,Current,2024-09-04 02:51:47,2024-09-05 09:27:47,Apple,-2.99,0.00,EUR,COMPLETED,1086.67
Card Payment,Current,2024-09-04 18:11:34,2024-09-05 11:00:41,Kehoes Pub,-13.60,0.00,EUR,COMPLETED,1073.07
Card Payment,Current,2024-09-04 18:35:27,2024-09-05 11:00:45,EcigCo,-8.00,0.00,EUR,COMPLETED,1065.07
Card Payment,Current,2024-09-04 19:05:10,2024-09-05 11:26:23,Hitianland,-43.60,0.00,EUR,COMPLETED,1021.47
Card Payment,Current,2024-09-04 11:13:18,2024-09-05 11:27:03,Frank Keane Volkswagen,-900.69,0.00,EUR,COMPLETED,120.78
Card Payment,Current,2024-09-03 11:39:19,2024-09-05 13:21:00,Amazon,-43.84,0.00,EUR,COMPLETED,76.94
Transfer,Current,2024-09-05 18:17:44,2024-09-05 18:17:44,Savings Vault topup,-1.00,0.00,EUR,COMPLETED,75.94
Transfer,Current,2024-09-05 20:36:58,2024-09-05 20:36:59,Savings Vault topup,-4.65,0.00,EUR,COMPLETED,71.29
Card Payment,Current,2024-09-05 20:36:58,2024-09-06 10:54:53,FREE NOW,-28.40,0.00,EUR,COMPLETED,42.89
Card Payment,Current,2024-09-05 18:17:44,2024-09-06 11:23:58,Finnegans Wake,-7.80,0.00,EUR,COMPLETED,35.09
Transfer,Current,2024-09-06 17:16:31,2024-09-06 17:16:31,Savings Vault topup,-0.45,0.00,EUR,COMPLETED,34.64
Transfer,Current,2024-09-06 19:03:32,2024-09-06 19:03:32,From Flexible Cash Funds,100.00,0.00,EUR,COMPLETED,134.64
Transfer,Current,2024-09-06 19:03:57,2024-09-06 19:03:57,Savings Vault topup,-4.25,0.00,EUR,COMPLETED,130.39
Transfer,Current,2024-09-07 09:00:15,2024-09-07 09:00:15,Savings Vault topup,-5.00,0.00,EUR,COMPLETED,125.39
Card Payment,Current,2024-09-03 07:50:50,2024-09-07 09:48:26,Bear Market Coffee,-4.60,0.00,EUR,COMPLETED,120.79
Transfer,Current,2024-09-07 09:58:49,2024-09-07 09:58:49,Savings Vault topup,-0.30,0.00,EUR,COMPLETED,120.49
Card Payment,Current,2024-09-06 19:03:57,2024-09-07 11:23:42,Deliveroo,-24.15,0.00,EUR,COMPLETED,96.34
Transfer,Current,2024-09-07 11:32:40,2024-09-07 11:32:40,Savings Vault topup,-5.00,0.00,EUR,COMPLETED,91.34
Transfer,Current,2024-09-07 11:33:46,2024-09-07 11:33:46,Savings Vault topup,-0.50,0.00,EUR,COMPLETED,90.84
Transfer,Current,2024-09-07 12:00:02,2024-09-07 12:00:02,Savings Vault topup,-4.50,0.00,EUR,COMPLETED,86.34
Transfer,Current,2024-09-07 12:17:58,2024-09-07 12:17:59,Savings Vault topup,-0.55,0.00,EUR,COMPLETED,85.79
Card Payment,Current,2024-09-07 09:00:15,2024-09-07 14:50:22,Amazon,-6.00,0.06,EUR,COMPLETED,79.73
Card Payment,Current,2024-09-06 17:16:31,2024-09-07 14:59:41,Splice,-8.91,0.00,EUR,COMPLETED,70.82
Transfer,Current,2024-09-08 09:02:55,2024-09-08 09:02:55,Savings Vault topup,-2.45,0.00,EUR,COMPLETED,68.37
Card Payment,Current,2024-09-07 12:17:58,2024-09-08 09:51:34,WHSmith,-1.89,0.00,EUR,COMPLETED,66.48
Card Payment,Current,2024-09-07 11:32:39,2024-09-08 09:51:41,WHSmith,-4.00,0.00,EUR,COMPLETED,62.48
Transfer,Current,2024-09-08 10:29:18,2024-09-08 10:29:18,Pocket Withdrawal,50.00,0.00,EUR,COMPLETED,112.48
Transfer,Current,2024-09-08 10:30:12,2024-09-08 10:30:12,Savings Vault topup,-0.05,0.00,EUR,COMPLETED,112.43
Card Payment,Current,2024-09-08 10:30:12,2024-09-09 09:10:20,Amazon,-29.99,0.00,EUR,COMPLETED,82.44
Card Payment,Current,2024-09-07 12:00:02,2024-09-09 09:55:32,FREE NOW,-41.10,0.00,EUR,COMPLETED,41.34
Card Payment,Current,2024-09-07 11:33:45,2024-09-09 10:23:09,Butlers Chocolates,-4.90,0.00,EUR,COMPLETED,36.44
Card Payment,Current,2024-09-07 09:58:49,2024-09-09 10:23:27,SuperValu,-7.94,0.00,EUR,COMPLETED,28.50
Card Payment,Current,2024-09-08 09:02:55,2024-09-09 14:55:34,Retail inMotion,-4.51,0.05,EUR,COMPLETED,23.94
Transfer,Current,2024-09-09 14:59:15,2024-09-09 14:59:15,Transfer from MARA DI RAIMONDO,44.75,0.00,EUR,COMPLETED,68.69
Transfer,Current,2024-09-09 14:59:44,2024-09-09 14:59:44,Transfer from MARA DI RAIMONDO,41.91,0.00,EUR,COMPLETED,110.60
ATM,Current,2024-09-09 18:11:36,2024-09-10 11:17:47,Cash withdrawal at Vb In Der Region Eg,-100.00,0.00,EUR,COMPLETED,10.60
Transfer,Current,2024-09-10 11:29:53,2024-09-10 11:29:53,Savings Vault topup,-2.00,0.00,EUR,COMPLETED,8.60
Transfer,Current,2024-09-10 13:23:11,2024-09-10 13:23:12,From Flexible Cash Funds,100.00,0.00,EUR,COMPLETED,108.60
Transfer,Current,2024-09-10 13:25:29,2024-09-10 13:25:29,Savings Vault topup,-5.00,0.00,EUR,COMPLETED,103.60
Transfer,Current,2024-09-10 14:32:00,2024-09-10 14:32:00,Savings Vault topup,-3.00,0.00,EUR,COMPLETED,100.60
Transfer,Current,2024-09-10 14:37:25,2024-09-10 14:37:25,Savings Vault topup,-0.50,0.00,EUR,COMPLETED,100.10
Transfer,Current,2024-09-10 14:59:04,2024-09-10 14:59:04,Savings Vault topup,-4.00,0.00,EUR,COMPLETED,96.10
Transfer,Current,2024-09-10 17:03:43,2024-09-10 17:03:43,Savings Vault topup,-1.05,0.00,EUR,COMPLETED,95.05
Card Payment,Current,2024-09-10 14:31:59,2024-09-11 10:02:51,Hallepain,-12.40,0.00,EUR,COMPLETED,82.65
Card Payment,Current,2024-09-10 13:25:29,2024-09-11 10:40:41,Iberica,-60.00,0.00,EUR,COMPLETED,22.65
Card Payment,Current,2024-09-10 14:59:03,2024-09-11 10:46:36,CTS,-4.20,0.00,EUR,COMPLETED,18.45
Card Payment,Current,2024-09-10 11:29:53,2024-09-11 11:45:41,A2 Diffusion,-1.60,0.00,EUR,COMPLETED,16.85
Card Payment,Current,2024-09-11 09:07:14,2024-09-11 14:29:13,Amazon,-6.02,0.00,EUR,COMPLETED,10.83
Transfer,Current,2024-09-11 15:16:23,2024-09-11 15:16:24,From Flexible Cash Funds,250.00,0.00,EUR,COMPLETED,260.83
Transfer,Current,2024-09-11 15:16:47,2024-09-11 15:16:48,Savings Vault topup,-5.00,0.00,EUR,COMPLETED,255.83
Transfer,Current,2024-09-11 16:55:18,2024-09-11 16:55:18,From Flexible Cash Funds,120.00,0.00,EUR,COMPLETED,375.83
Transfer,Current,2024-09-11 16:57:30,2024-09-11 16:57:30,Savings Vault topup,-0.05,0.00,EUR,COMPLETED,375.78
Card Payment,Current,2024-09-10 17:03:43,2024-09-12 09:04:28,Aral,-3.79,0.00,EUR,COMPLETED,371.99
Card Payment,Current,2024-09-11 15:16:47,2024-09-12 09:55:21,Amazon,-199.00,0.00,EUR,COMPLETED,172.99
Card Payment,Current,2024-09-11 16:57:30,2024-09-12 10:05:03,Apple,-119.99,0.00,EUR,COMPLETED,53.00
Card Payment,Current,2024-09-10 14:37:24,2024-09-12 10:28:22,Waffle Factory,-5.90,0.00,EUR,COMPLETED,47.10
Card Payment,Current,2024-09-13 07:40:51,,Heroku,-0.91,0.00,EUR,REVERTED,
Transfer,Current,2024-09-13 07:40:51,2024-09-13 07:40:51,Savings Vault topup,-0.45,0.00,EUR,COMPLETED,46.65
Transfer,Current,2024-09-13 17:13:35,2024-09-13 17:13:35,Transfer to MARA DI RAIMONDO,-11.00,0.00,EUR,COMPLETED,35.65
Transfer,Current,2024-09-14 11:14:51,2024-09-14 11:14:51,Transfer from MARA DI RAIMONDO,35.00,0.00,EUR,COMPLETED,70.65
Transfer,Current,2024-09-14 19:34:09,2024-09-14 19:34:10,Savings Vault topup,-5.00,0.00,EUR,COMPLETED,65.65
Transfer,Current,2024-09-14 23:07:56,2024-09-14 23:07:56,Savings Vault topup,-1.50,0.00,EUR,COMPLETED,64.15
Card Payment,Current,2024-09-14 23:07:56,2024-09-15 10:09:03,Malik Rehan Tax,-47.70,0.00,EUR,COMPLETED,16.45
Card Payment,Current,2024-09-14 19:34:09,2024-09-15 10:14:27,Goethe Bar,-8.00,0.00,EUR,COMPLETED,8.45
Transfer,Current,2024-09-15 10:58:27,2024-09-15 10:58:27,From Flexible Cash Funds,100.00,0.00,EUR,COMPLETED,108.45
Transfer,Current,2024-09-15 10:59:22,2024-09-15 10:59:22,Savings Vault topup,-2.75,0.00,EUR,COMPLETED,105.70
Transfer,Current,2024-09-15 16:09:45,2024-09-15 16:09:45,Savings Vault topup,-3.00,0.00,EUR,COMPLETED,102.70
Card Payment,Current,2024-09-15 10:59:22,2024-09-16 08:37:05,ALDI,-24.45,0.00,EUR,COMPLETED,78.25
Card Payment,Current,2024-09-15 16:09:45,2024-09-16 08:42:40,Gleesons,-3.40,0.00,EUR,COMPLETED,74.85
Transfer,Current,2024-09-17 08:35:32,2024-09-17 08:35:32,Savings Vault topup,-2.75,0.00,EUR,COMPLETED,72.10
Transfer,Current,2024-09-17 13:59:30,2024-09-17 13:59:30,Savings Vault topup,-5.00,0.00,EUR,COMPLETED,67.10
Transfer,Current,2024-09-18 08:40:51,2024-09-18 08:40:51,Savings Vault topup,-2.75,0.00,EUR,COMPLETED,64.35
Card Payment,Current,2024-09-17 13:59:29,2024-09-18 09:05:56,Decathlon,-19.00,0.00,EUR,COMPLETED,45.35
Card Payment,Current,2024-09-17 08:35:31,2024-09-18 10:03:38,OXMANTOWN,-4.45,0.00,EUR,COMPLETED,40.90
Transfer,Current,2024-09-18 19:25:04,2024-09-18 19:25:04,Savings Vault topup,-0.15,0.00,EUR,COMPLETED,40.75
Transfer,Current,2024-09-19 08:33:40,2024-09-19 08:33:40,Savings Vault topup,-2.75,0.00,EUR,COMPLETED,38.00
Card Payment,Current,2024-09-18 08:40:51,2024-09-19 08:56:43,OXMANTOWN,-4.45,0.00,EUR,COMPLETED,33.55
Card Payment,Current,2024-09-18 19:25:04,2024-09-19 10:52:24,Deliveroo,-19.97,0.00,EUR,COMPLETED,13.58
Transfer,Current,2024-09-20 08:48:35,2024-09-20 08:48:35,Savings Vault topup,-2.75,0.00,EUR,COMPLETED,10.83
Card Payment,Current,2024-09-19 08:33:40,2024-09-20 09:27:37,OXMANTOWN,-4.45,0.00,EUR,COMPLETED,6.38
Transfer,Current,2024-09-20 14:18:01,2024-09-20 14:18:01,From Flexible Cash Funds,50.00,0.00,EUR,COMPLETED,56.38
Transfer,Current,2024-09-20 14:18:07,2024-09-20 14:18:07,Savings Vault topup,-2.50,0.00,EUR,COMPLETED,53.88
Transfer,Current,2024-09-20 14:44:54,2024-09-20 14:44:54,From Flexible Cash Funds,100.00,0.00,EUR,COMPLETED,153.88
Transfer,Current,2024-09-20 14:45:00,2024-09-20 14:45:00,Savings Vault topup,-2.70,0.00,EUR,COMPLETED,151.18
Transfer,Current,2024-09-20 14:49:10,2024-09-20 14:49:10,Savings Vault topup,-1.50,0.00,EUR,COMPLETED,149.68
Transfer,Current,2024-09-20 16:41:41,2024-09-20 16:41:41,Savings Vault topup,-5.00,0.00,EUR,COMPLETED,144.68
Transfer,Current,2024-09-21 09:22:05,2024-09-21 09:22:05,Savings Vault topup,-1.05,0.00,EUR,COMPLETED,143.63
Transfer,Current,2024-09-21 09:22:52,2024-09-21 09:22:52,Savings Vault topup,-5.00,0.00,EUR,COMPLETED,138.63
Card Payment,Current,2024-09-20 14:45:00,2024-09-21 09:42:58,Boots,-44.46,0.00,EUR,COMPLETED,94.17
Card Payment,Current,2024-09-20 16:41:41,2024-09-21 10:02:37,Iwant Mobile,-7.00,0.00,EUR,COMPLETED,87.17
Card Payment,Current,2024-09-20 14:49:10,2024-09-21 10:13:28,Butlers Chocolates,-4.70,0.00,EUR,COMPLETED,82.47
Card Payment,Current,2024-09-20 08:48:35,2024-09-21 10:20:06,OXMANTOWN,-4.45,0.00,EUR,COMPLETED,78.02
Card Payment,Current,2024-09-20 14:18:07,2024-09-21 10:21:13,Umi Falafel,-13.50,0.00,EUR,COMPLETED,64.52
Transfer,Current,2024-09-21 17:21:51,2024-09-21 17:21:51,Savings Vault topup,-4.50,0.00,EUR,COMPLETED,60.02
Transfer,Current,2024-09-22 07:27:58,2024-09-22 07:27:58,From Flexible Cash Funds,77.00,0.00,EUR,COMPLETED,137.02
Transfer,Current,2024-09-22 09:26:04,2024-09-22 09:26:04,Savings Vault topup,-3.50,0.00,EUR,COMPLETED,133.52
Transfer,Current,2024-09-22 13:41:10,2024-09-22 13:41:10,Savings Vault topup,-3.75,0.00,EUR,COMPLETED,129.77
Transfer,Current,2024-09-22 17:18:31,2024-09-22 17:18:31,Savings Vault topup,-2.25,0.00,EUR,COMPLETED,127.52
Card Payment,Current,2024-09-22 17:18:30,2024-09-23 10:12:24,Deliveroo,-22.55,0.00,EUR,COMPLETED,104.97
Card Payment,Current,2024-09-22 09:26:04,2024-09-23 10:43:15,FREE NOW,-34.30,0.00,EUR,COMPLETED,70.67
Card Payment,Current,2024-09-21 09:22:05,2024-09-23 11:24:50,SuperValu,-28.79,0.00,EUR,COMPLETED,41.88
Card Payment,Current,2024-09-21 17:21:51,2024-09-23 11:28:37,Butlers Chocolates,-4.10,0.00,EUR,COMPLETED,37.78
Card Payment,Current,2024-09-21 09:22:52,2024-09-23 11:34:32,Xl,-4.00,0.00,EUR,COMPLETED,33.78
Transfer,Current,2024-09-23 01:00:00,2024-09-23 11:48:45,To eFlow,-12.63,0.00,EUR,COMPLETED,21.15
Card Payment,Current,2024-09-22 13:41:09,2024-09-23 11:50:16,Spar,-13.25,0.00,EUR,COMPLETED,7.90
Transfer,Current,2024-09-23 12:15:25,2024-09-23 13:29:32,From Flexible Cash Funds,60.00,0.00,EUR,COMPLETED,67.90
Transfer,Current,2024-09-23 12:16:59,2024-09-23 13:29:53,From Flexible Cash Funds,60.00,0.00,EUR,COMPLETED,127.90
Transfer,Current,2024-09-23 16:32:08,2024-09-23 16:32:08,Savings Vault topup,-5.00,0.00,EUR,COMPLETED,122.90
Transfer,Current,2024-09-24 09:02:42,2024-09-24 09:02:42,Savings Vault topup,-2.75,0.00,EUR,COMPLETED,120.15
Card Payment,Current,2024-09-23 08:24:09,2024-09-24 09:24:54,Copper + Straw,-5.00,0.00,EUR,COMPLETED,115.15
Card Payment,Current,2024-09-23 16:32:07,2024-09-24 11:17:28,Transport for Ireland - TFI,-15.00,0.00,EUR,COMPLETED,100.15
Transfer,Current,2024-09-24 17:20:08,2024-09-24 17:20:08,Savings Vault topup,-5.00,0.00,EUR,COMPLETED,95.15
Transfer,Current,2024-09-24 17:20:29,2024-09-24 17:20:29,Savings Vault topup,-3.80,0.00,EUR,COMPLETED,91.35
Transfer,Current,2024-09-24 19:06:42,2024-09-24 19:06:42,Savings Vault topup,-4.20,0.00,EUR,COMPLETED,87.15
Topup,Current,2024-09-25 07:37:04,2024-09-25 07:37:04,Payment from WORKDAY LIMITED,2848.60,0.00,EUR,COMPLETED,2935.75
Transfer,Current,2024-09-25 07:38:02,2024-09-25 07:38:02,Savings Vault topup,-5.00,0.00,EUR,COMPLETED,2930.75
Transfer,Current,2024-09-25 07:38:19,2024-09-25 07:38:19,Savings Vault topup,-250.00,0.00,EUR,COMPLETED,2680.75
Card Payment,Current,2024-09-24 17:20:29,2024-09-25 08:44:10,Strike Pay,-3.24,0.00,EUR,COMPLETED,2677.51
Transfer,Current,2024-09-25 08:20:13,2024-09-25 08:54:01,To Finance Ireland,-1424.50,0.00,EUR,COMPLETED,1253.01
Card Payment,Current,2024-09-24 19:06:41,2024-09-25 09:38:36,SuperValu,-31.16,0.00,EUR,COMPLETED,1221.85
Card Payment,Current,2024-09-24 17:20:08,2024-09-25 09:47:32,Cut and Sew,-32.00,0.00,EUR,COMPLETED,1189.85
Card Payment,Current,2024-09-24 09:02:41,2024-09-25 09:57:38,OXMANTOWN,-4.45,0.00,EUR,COMPLETED,1185.40
Transfer,Current,2024-09-25 11:07:50,2024-09-25 11:07:50,To pocket EUR Subscriptions from EUR,-700.00,0.00,EUR,COMPLETED,485.40
Transfer,Current,2024-09-25 11:31:21,2024-09-25 11:31:21,Transfer from MARA DI RAIMONDO,550.00,0.00,EUR,COMPLETED,1035.40
Transfer,Current,2024-09-25 12:56:24,2024-09-25 12:56:24,Savings Vault topup,-2.50,0.00,EUR,COMPLETED,1032.90
Transfer,Current,2024-09-25 13:55:29,2024-09-25 13:55:29,Transfer to MARA DI RAIMONDO,-11.00,0.00,EUR,COMPLETED,1021.90
Transfer,Current,2024-09-25 21:34:47,2024-09-25 21:34:48,Savings Vault topup,-2.70,0.00,EUR,COMPLETED,1019.20
Transfer,Current,2024-09-25 22:02:38,2024-09-25 22:02:38,Savings Vault topup,-1.85,0.00,EUR,COMPLETED,1017.35
Transfer,Current,2024-09-26 08:25:46,2024-09-26 08:25:46,Savings Vault topup,-5.00,0.00,EUR,COMPLETED,1012.35
Card Payment,Current,2024-09-25 07:38:01,2024-09-26 10:12:00,SuperValu,-3.00,0.00,EUR,COMPLETED,1009.35
Card Payment,Current,2024-09-25 12:56:23,2024-09-26 10:29:37,Centra,-5.50,0.00,EUR,COMPLETED,1003.85
Card Payment,Current,2024-09-25 21:34:47,2024-09-26 12:14:17,bulk,-58.46,0.00,EUR,COMPLETED,945.39
Transfer,Current,2024-09-26 12:33:14,2024-09-26 12:33:14,Savings Vault topup,-1.25,0.00,EUR,COMPLETED,944.14
Transfer,Current,2024-09-26 19:17:22,2024-09-26 19:17:22,Savings Vault topup,-5.00,0.00,EUR,COMPLETED,939.14
Transfer,Current,2024-09-26 19:26:49,2024-09-26 19:26:49,Savings Vault topup,-4.25,0.00,EUR,COMPLETED,934.89
Transfer,Current,2024-09-27 08:29:18,2024-09-27 08:29:18,Savings Vault topup,-5.00,0.00,EUR,COMPLETED,929.89
Card Payment,Current,2024-09-26 19:26:49,2024-09-27 08:56:19,Umi Falafel,-16.15,0.00,EUR,COMPLETED,913.74
Card Payment,Current,2024-09-26 08:25:46,2024-09-27 10:03:59,SuperValu,-3.00,0.00,EUR,COMPLETED,910.74
Card Payment,Current,2024-09-26 12:33:14,2024-09-27 10:43:28,Chopped,-11.75,0.00,EUR,COMPLETED,898.99
Card Payment,Current,2024-09-26 19:17:21,2024-09-27 11:15:27,Daybreak,-9.00,0.00,EUR,COMPLETED,889.99
Transfer,Current,2024-09-27 12:26:33,2024-09-27 12:26:33,Savings Vault topup,-0.10,0.00,EUR,COMPLETED,889.89
Card Payment,Current,2024-09-25 22:02:38,2024-09-27 13:16:15,Amazon,-24.63,0.00,EUR,COMPLETED,865.26
Transfer,Current,2024-09-27 15:42:05,2024-09-27 15:42:05,Savings Vault topup,-5.00,0.00,EUR,COMPLETED,860.26
Transfer,Current,2024-09-27 15:57:54,2024-09-27 15:57:54,Savings Vault topup,-2.00,0.00,EUR,COMPLETED,858.26
Transfer,Current,2024-09-27 19:03:40,2024-09-27 19:03:40,Savings Vault topup,-3.00,0.00,EUR,COMPLETED,855.26
Transfer,Current,2024-09-27 20:16:14,2024-09-27 20:16:15,Savings Vault topup,-3.00,0.00,EUR,COMPLETED,852.26
Transfer,Current,2024-09-27 21:08:57,2024-09-27 21:08:57,Savings Vault topup,-3.25,0.00,EUR,COMPLETED,849.01
Transfer,Current,2024-09-27 21:12:37,2024-09-27 21:12:37,Transfer from JOHN DANIEL KIELY,20.00,0.00,EUR,COMPLETED,869.01
Transfer,Current,2024-09-27 21:26:14,2024-09-27 21:26:14,Savings Vault topup,-5.00,0.00,EUR,COMPLETED,864.01
Transfer,Current,2024-09-27 22:04:00,2024-09-27 22:04:00,Savings Vault topup,-1.00,0.00,EUR,COMPLETED,863.01
Transfer,Current,2024-09-27 22:28:15,2024-09-27 22:28:15,Savings Vault topup,-5.00,0.00,EUR,COMPLETED,858.01
Transfer,Current,2024-09-28 00:49:08,2024-09-28 00:49:08,Savings Vault topup,-0.50,0.00,EUR,COMPLETED,857.51
Card Payment,Current,2024-09-28 00:49:08,2024-09-28 09:54:32,FREE NOW,-18.90,0.00,EUR,COMPLETED,838.61
Card Payment,Current,2024-09-27 15:42:04,2024-09-28 11:09:22,Gamers World,-30.00,0.00,EUR,COMPLETED,808.61
Card Payment,Current,2024-09-27 21:08:56,2024-09-28 12:03:59,Circle K Gas Station,-28.35,0.00,EUR,COMPLETED,780.26
Card Payment,Current,2024-09-27 08:29:18,2024-09-28 12:14:01,SuperValu,-3.00,0.00,EUR,COMPLETED,777.26
Card Payment,Current,2024-09-27 12:26:33,2024-09-28 12:15:22,Centra,-8.98,0.00,EUR,COMPLETED,768.28
Card Payment,Current,2024-09-27 22:28:15,2024-09-28 12:26:26,Zozimus Bar,-14.00,0.00,EUR,COMPLETED,754.28
Card Payment,Current,2024-09-27 22:04:00,2024-09-28 12:26:27,Zozimus Bar,-58.80,0.00,EUR,COMPLETED,695.48
Card Payment,Current,2024-09-27 21:26:13,2024-09-28 12:30:10,Zozimus Bar,-14.00,0.00,EUR,COMPLETED,681.48
Transfer,Current,2024-09-28 13:15:28,2024-09-28 13:15:28,Savings Vault topup,-1.50,0.00,EUR,COMPLETED,679.98
Transfer,Current,2024-09-28 13:17:49,2024-09-28 13:17:49,Savings Vault topup,-4.50,0.00,EUR,COMPLETED,675.48
Transfer,Current,2024-09-28 14:19:25,2024-09-28 14:19:25,Savings Vault topup,-0.05,0.00,EUR,COMPLETED,675.43
Transfer,Current,2024-09-28 14:28:52,2024-09-28 14:28:52,Savings Vault topup,-5.00,0.00,EUR,COMPLETED,670.43
Transfer,Current,2024-09-28 15:50:12,2024-09-28 15:50:12,Savings Vault topup,-5.00,0.00,EUR,COMPLETED,665.43
Transfer,Current,2024-09-28 20:09:00,2024-09-28 20:09:00,Savings Vault topup,-1.25,0.00,EUR,COMPLETED,664.18
Card Payment,Current,2024-09-28 14:19:24,2024-09-29 09:20:32,Dublin Dundrum Centre,-119.99,0.00,EUR,COMPLETED,544.19
Card Payment,Current,2024-09-27 15:57:53,2024-09-29 10:46:22,Kehoes Pub,-13.60,0.00,EUR,COMPLETED,530.59
Card Payment,Current,2024-09-27 19:03:40,2024-09-29 10:47:09,Kehoes Pub,-20.40,0.00,EUR,COMPLETED,510.19
Card Payment,Current,2024-09-27 20:16:14,2024-09-29 10:47:35,Kehoes Pub,-20.40,0.00,EUR,COMPLETED,489.79
Card Payment,Current,2024-09-28 20:09:00,2024-09-29 10:56:04,"Conway, Co",-5.75,0.00,EUR,COMPLETED,484.04
Card Payment,Current,2024-09-28 14:28:51,2024-09-29 11:11:38,Dunnes Stores,-70.00,0.00,EUR,COMPLETED,414.04
Card Payment,Current,2024-09-28 15:50:12,2024-09-30 11:24:19,Gleesons,-50.00,0.00,EUR,COMPLETED,364.04
Card Payment,Current,2024-09-28 13:17:49,2024-09-30 11:30:36,Avoca,-2.10,0.00,EUR,COMPLETED,361.94
Card Payment,Current,2024-09-28 13:15:27,2024-09-30 11:30:46,Avoca,-20.70,0.00,EUR,COMPLETED,341.24
Transfer,Current,2024-09-30 17:28:56,2024-09-30 17:28:57,Savings Vault topup,-4.10,0.00,EUR,COMPLETED,337.14
Card Payment,Current,2024-09-30 17:28:56,2024-10-01 15:25:38,Gaagade Kaffe,-20.18,0.00,EUR,COMPLETED,316.96
Transfer,Current,2024-10-02 08:48:42,2024-10-02 08:48:42,Savings Vault topup,-2.55,0.00,EUR,COMPLETED,314.41
Transfer,Current,2024-10-02 12:27:55,2024-10-02 12:27:55,Savings Vault topup,-0.85,0.00,EUR,COMPLETED,313.56
Card Payment,Current,2024-10-02 08:48:42,2024-10-03 08:53:49,HP,-1.49,0.00,EUR,COMPLETED,312.07
Transfer,Current,2024-10-03 09:03:33,2024-10-03 09:03:33,Savings Vault topup,-5.00,0.00,EUR,COMPLETED,307.07
Transfer,Current,2024-10-03 13:04:50,2024-10-03 13:04:50,Savings Vault topup,-1.25,0.00,EUR,COMPLETED,305.82
Card Payment,Current,2024-10-02 12:27:55,2024-10-03 14:12:09,Amazon,-10.83,0.00,EUR,COMPLETED,294.99
Transfer,Current,2024-10-03 16:22:51,2024-10-03 16:22:51,Savings Vault topup,-2.75,0.00,EUR,COMPLETED,292.24
Transfer,Current,2024-10-03 23:09:25,2024-10-03 23:09:25,Savings Vault topup,-3.00,0.00,EUR,COMPLETED,289.24
Transfer,Current,2024-10-04 02:51:34,2024-10-04 02:51:34,Savings Vault topup,-0.05,0.00,EUR,COMPLETED,289.19
Transfer,Current,2024-10-04 09:36:36,2024-10-04 09:36:36,Savings Vault topup,-1.05,0.00,EUR,COMPLETED,288.14
Card Payment,Current,2024-10-03 13:04:47,2024-10-04 10:10:35,Fresh The Good Food Market,-6.75,0.00,EUR,COMPLETED,281.39
Card Payment,Current,2024-10-03 23:09:24,2024-10-04 11:22:00,Taxi,-22.40,0.00,EUR,COMPLETED,258.99
Card Payment,Current,2024-10-03 16:22:51,2024-10-04 11:31:16,The Barbers Bar,-21.45,0.00,EUR,COMPLETED,237.54
Card Payment,Current,2024-10-03 09:03:32,2024-10-04 12:10:16,SuperValu,-3.00,0.00,EUR,COMPLETED,234.54
Transfer,Current,2024-10-04 13:19:22,2024-10-04 13:19:22,Savings Vault topup,-4.85,0.00,EUR,COMPLETED,229.69
Transfer,Current,2024-10-04 13:20:09,2024-10-04 13:49:43,To Colm Quish,-14.60,0.00,EUR,COMPLETED,215.09
Transfer,Current,2024-10-04 18:07:52,2024-10-04 18:07:52,Savings Vault topup,-4.05,0.00,EUR,COMPLETED,211.04
Card Payment,Current,2024-10-04 09:36:35,2024-10-05 03:06:54,YouTube,-1.80,0.00,EUR,COMPLETED,209.24
Card Payment,Current,2024-10-04 13:19:22,2024-10-05 09:13:11,Deliveroo,-21.03,0.00,EUR,COMPLETED,188.21
Card Payment,Current,2024-10-04 02:51:33,2024-10-05 09:21:58,Apple,-2.99,0.00,EUR,COMPLETED,185.22
Card Payment,Current,2024-10-04 18:07:52,2024-10-05 10:33:37,Deliveroo,-41.19,0.00,EUR,COMPLETED,144.03
Transfer,Current,2024-10-05 11:18:57,2024-10-05 11:18:57,Savings Vault topup,-4.00,0.00,EUR,COMPLETED,140.03
Transfer,Current,2024-10-05 11:52:56,2024-10-05 11:52:56,Savings Vault topup,-2.60,0.00,EUR,COMPLETED,137.43
Transfer,Current,2024-10-05 12:06:04,2024-10-05 12:06:04,Savings Vault topup,-2.65,0.00,EUR,COMPLETED,134.78
Transfer,Current,2024-10-05 18:50:26,2024-10-05 18:50:27,Transfer from MARA DI RAIMONDO,44.76,0.00,EUR,COMPLETED,179.54
Transfer,Current,2024-10-05 18:50:43,2024-10-05 18:50:44,Transfer from MARA DI RAIMONDO,41.91,0.00,EUR,COMPLETED,221.45
Transfer,Current,2024-10-05 18:51:00,2024-10-05 18:51:00,Transfer from MARA DI RAIMONDO,4.60,0.00,EUR,COMPLETED,226.05
Transfer,Current,2024-10-05 20:19:51,2024-10-05 20:19:51,Savings Vault topup,-5.00,0.00,EUR,COMPLETED,221.05
Transfer,Current,2024-10-05 20:20:47,2024-10-05 20:20:47,Savings Vault topup,-0.50,0.00,EUR,COMPLETED,220.55
Card Payment,Current,2024-10-05 11:18:56,2024-10-06 09:08:53,Hatch Coffee,-22.20,0.00,EUR,COMPLETED,198.35
Card Payment,Current,2024-10-05 11:52:56,2024-10-06 09:23:59,Home Store + More,-33.48,0.00,EUR,COMPLETED,164.87
Card Payment,Current,2024-10-05 12:06:04,2024-10-06 11:35:30,ALDI,-38.47,0.00,EUR,COMPLETED,126.40
Transfer,Current,2024-10-06 13:14:15,2024-10-06 13:14:15,Savings Vault topup,-5.00,0.00,EUR,COMPLETED,121.40
Transfer,Current,2024-10-06 13:35:01,2024-10-06 13:35:01,Savings Vault topup,-1.75,0.00,EUR,COMPLETED,119.65
Transfer,Current,2024-10-06 13:46:32,2024-10-06 13:46:32,Savings Vault topup,-5.00,0.00,EUR,COMPLETED,114.65
Transfer,Current,2024-10-06 14:52:48,2024-10-06 14:52:48,Savings Vault topup,-0.10,0.00,EUR,COMPLETED,114.55
Transfer,Current,2024-10-06 17:16:25,2024-10-06 17:16:25,Savings Vault topup,-0.05,0.00,EUR,COMPLETED,114.50
Transfer,Current,2024-10-06 17:31:42,2024-10-06 17:31:42,From Flexible Cash Funds,12000.00,0.00,EUR,COMPLETED,12114.50
Transfer,Current,2024-10-06 17:32:08,2024-10-06 17:32:08,Savings Vault topup,-11900.00,0.00,EUR,COMPLETED,214.50
Transfer,Current,2024-10-07 08:52:43,2024-10-07 08:52:44,Savings Vault topup,-5.00,0.00,EUR,COMPLETED,209.50
Card Payment,Current,2024-10-05 20:19:51,2024-10-07 09:42:03,The Merry Cobbler,-60.00,0.00,EUR,COMPLETED,149.50
Card Payment,Current,2024-10-05 20:20:46,2024-10-07 09:42:10,The Merry Cobbler,-2.90,0.00,EUR,COMPLETED,146.60
Card Payment,Current,2024-10-06 13:46:31,2024-10-07 10:45:51,Butlers Chocolates,-12.00,0.00,EUR,COMPLETED,134.60
Card Payment,Current,2024-10-06 13:14:15,2024-10-07 11:11:36,Pacheco Venezuela,-8.00,0.00,EUR,COMPLETED,126.60
Card Payment,Current,2024-10-06 14:52:48,2024-10-07 11:15:51,Tesco,-4.98,0.00,EUR,COMPLETED,121.62
Card Payment,Current,2024-10-06 13:35:01,2024-10-07 11:43:06,Avoca,-5.65,0.00,EUR,COMPLETED,115.97
Transfer,Current,2024-10-07 13:37:17,2024-10-07 13:37:17,Savings Vault topup,-5.00,0.00,EUR,COMPLETED,110.97
Card Payment,Current,2024-10-06 17:16:24,2024-10-07 13:38:51,Splice,-8.99,0.09,EUR,COMPLETED,101.89
Transfer,Current,2024-10-07 15:33:56,2024-10-07 15:33:56,From Instant Access Savings,1107.00,0.00,EUR,COMPLETED,1208.89
Transfer,Current,2024-10-07 15:34:34,2024-10-07 15:34:34,Savings Vault topup,-5.00,0.00,EUR,COMPLETED,1203.89
Topup,Current,2024-10-08 05:37:37,2024-10-08 05:37:38,Payment from TRADING 212 UK LIMITED T/AS TRADING 212,27850.67,0.00,EUR,COMPLETED,29054.56
Transfer,Current,2024-10-08 07:55:32,2024-10-08 07:55:32,Savings Vault topup,-27850.00,0.00,EUR,COMPLETED,1204.56
Transfer,Current,2024-10-08 08:38:54,2024-10-08 08:38:54,Savings Vault topup,-5.00,0.00,EUR,COMPLETED,1199.56
Transfer,Current,2024-10-08 08:47:55,2024-10-08 08:47:55,Savings Vault topup,-0.05,0.00,EUR,COMPLETED,1199.51
Card Payment,Current,2024-10-07 15:34:34,2024-10-08 09:42:57,Eolas Money,-1107.00,0.00,EUR,COMPLETED,92.51
Card Payment,Current,2024-10-07 08:52:43,2024-10-08 10:20:03,SuperValu,-3.00,0.00,EUR,COMPLETED,89.51
Card Payment,Current,2024-10-07 13:37:16,2024-10-08 10:20:59,Centra,-5.00,0.00,EUR,COMPLETED,84.51
Transfer,Current,2024-10-08 19:53:40,2024-10-08 19:53:40,Savings Vault topup,-0.75,0.00,EUR,COMPLETED,83.76
Topup,Current,2024-10-09 06:23:32,2024-10-09 06:23:32,Payment from TRADING 212 UK LIMITED T/AS TRADING 212,179.13,0.00,EUR,COMPLETED,262.89
Card Payment,Current,2024-10-08 08:47:54,2024-10-09 09:21:51,Chemist Warehouse,-4.99,0.00,EUR,COMPLETED,257.90
Transfer,Current,2024-10-09 10:40:23,2024-10-09 10:40:23,Savings Vault topup,-5.00,0.00,EUR,COMPLETED,252.90
Card Payment,Current,2024-10-08 08:38:54,2024-10-09 11:20:45,SuperValu,-3.00,0.00,EUR,COMPLETED,249.90
Transfer,Current,2024-10-09 11:25:55,2024-10-09 11:25:55,Savings Vault topup,-0.25,0.00,EUR,COMPLETED,249.65
Card Payment,Current,2024-10-08 19:53:40,2024-10-09 14:13:23,Maxartspace,-65.85,0.00,EUR,COMPLETED,183.80
Transfer,Current,2024-10-09 14:40:56,2024-10-09 14:40:56,Transfer to MARA DI RAIMONDO,-18.19,0.00,EUR,COMPLETED,165.61
Transfer,Current,2024-10-09 17:50:06,2024-10-09 17:50:06,Pocket Withdrawal,350.00,0.00,EUR,COMPLETED,515.61
Transfer,Current,2024-10-09 17:53:54,2024-10-09 17:53:54,From Instant Access Savings,100.00,0.00,EUR,COMPLETED,615.61
Transfer,Current,2024-10-09 17:54:54,2024-10-09 17:54:54,Savings Vault topup,-2.85,0.00,EUR,COMPLETED,612.76
Transfer,Current,2024-10-09 18:09:38,2024-10-09 18:09:38,From Instant Access Savings,150.00,0.00,EUR,COMPLETED,762.76
Transfer,Current,2024-10-09 18:09:47,2024-10-09 18:09:47,Savings Vault topup,-5.00,0.00,EUR,COMPLETED,757.76
Transfer,Current,2024-10-09 18:58:47,2024-10-09 18:58:47,Savings Vault topup,-1.40,0.00,EUR,COMPLETED,756.36
Transfer,Current,2024-10-09 20:37:19,2024-10-09 20:37:20,From Instant Access Savings,120.00,0.00,EUR,COMPLETED,876.36
Transfer,Current,2024-10-09 20:37:51,2024-10-09 20:37:51,Savings Vault topup,-5.00,0.00,EUR,COMPLETED,871.36
Transfer,Current,2024-10-09 20:43:55,2024-10-09 20:43:55,Savings Vault topup,-5.00,0.00,EUR,COMPLETED,866.36
Transfer,Current,2024-10-10 08:29:11,2024-10-10 08:29:11,Savings Vault topup,-5.00,0.00,EUR,COMPLETED,861.36
Card Payment,Current,2024-10-09 10:40:23,2024-10-10 09:14:35,Dr Maurice Treacy,-125.00,0.00,EUR,COMPLETED,736.36
Card Payment,Current,2024-10-09 20:43:55,2024-10-10 09:40:03,Yamamori,-85.00,0.00,EUR,COMPLETED,651.36
Card Payment,Current,2024-10-09 17:54:54,2024-10-10 09:47:18,Vision Express,-480.43,0.00,EUR,COMPLETED,170.93
Card Payment,Current,2024-10-09 11:25:54,2024-10-10 09:56:04,OXMANTOWN,-4.95,0.00,EUR,COMPLETED,165.98
Card Payment,Current,2024-10-09 18:58:47,2024-10-10 10:42:48,Boots,-13.72,0.00,EUR,COMPLETED,152.26
Card Payment,Current,2024-10-09 18:09:46,2024-10-10 10:42:52,Arnotts,-125.00,0.00,EUR,COMPLETED,27.26
Card Payment,Current,2024-10-09 20:37:51,2024-10-10 11:05:39,Transport for Ireland - TFI,-15.00,0.00,EUR,COMPLETED,12.26
Transfer,Current,2024-10-11 08:59:34,2024-10-11 08:59:34,From Instant Access Savings,120.00,0.00,EUR,COMPLETED,132.26
Transfer,Current,2024-10-11 08:59:41,2024-10-11 08:59:41,Savings Vault topup,-5.00,0.00,EUR,COMPLETED,127.26
Card Payment,Current,2024-10-10 08:29:10,2024-10-11 11:37:06,SuperValu,-3.00,0.00,EUR,COMPLETED,124.26
Transfer,Current,2024-10-11 19:50:52,2024-10-11 19:50:52,From Instant Access Savings,100.00,0.00,EUR,COMPLETED,224.26
Transfer,Current,2024-10-11 19:51:39,2024-10-11 19:51:39,Savings Vault topup,-5.00,0.00,EUR,COMPLETED,219.26
Transfer,Current,2024-10-11 23:02:11,2024-10-11 23:02:12,Transfer to JOHN DANIEL KIELY,-22.01,0.00,EUR,COMPLETED,197.25
Transfer,Current,2024-10-12 11:38:07,2024-10-12 11:38:07,From Instant Access Savings,100.00,0.00,EUR,COMPLETED,297.25
Transfer,Current,2024-10-12 11:39:00,2024-10-12 11:39:01,Savings Vault topup,-5.00,0.00,EUR,COMPLETED,292.25
Card Payment,Current,2024-10-11 08:59:41,2024-10-12 11:42:41,Ann Griffin,-80.00,0.00,EUR,COMPLETED,212.25
Transfer,Current,2024-10-12 11:54:52,2024-10-12 11:54:52,From Instant Access Savings,100.00,0.00,EUR,COMPLETED,312.25
Transfer,Current,2024-10-12 11:55:24,2024-10-12 11:55:24,Savings Vault topup,-0.50,0.00,EUR,COMPLETED,311.75
Transfer,Current,2024-10-12 12:01:55,2024-10-12 12:01:55,Savings Vault topup,-2.50,0.00,EUR,COMPLETED,309.25
Transfer,Current,2024-10-12 12:22:35,2024-10-12 12:22:35,From Instant Access Savings,250.00,0.00,EUR,COMPLETED,559.25
Transfer,Current,2024-10-12 12:22:41,2024-10-12 12:22:41,Savings Vault topup,-5.00,0.00,EUR,COMPLETED,554.25
Transfer,Current,2024-10-12 13:04:58,2024-10-12 13:04:59,Savings Vault topup,-1.50,0.00,EUR,COMPLETED,552.75
Transfer,Current,2024-10-12 13:49:48,2024-10-12 13:49:48,Savings Vault topup,-4.25,0.00,EUR,COMPLETED,548.50
Transfer,Current,2024-10-12 14:12:03,2024-10-12 14:12:04,Savings Vault topup,-0.75,0.00,EUR,COMPLETED,547.75
Transfer,Current,2024-10-12 23:02:10,2024-10-12 23:02:10,Savings Vault topup,-1.00,0.00,EUR,COMPLETED,546.75
Transfer,Current,2024-10-12 23:32:19,2024-10-12 23:32:19,Savings Vault topup,-1.00,0.00,EUR,COMPLETED,545.75
Transfer,Current,2024-10-12 23:50:37,2024-10-12 23:50:37,Savings Vault topup,-4.00,0.00,EUR,COMPLETED,541.75
Transfer,Current,2024-10-13 00:56:29,2024-10-13 00:56:29,Savings Vault topup,-2.55,0.00,EUR,COMPLETED,539.20
Card Payment,Current,2024-10-11 19:51:39,2024-10-13 09:20:33,Run in the Dark,-43.00,0.00,EUR,COMPLETED,496.20
Card Payment,Current,2024-10-12 12:22:39,2024-10-13 09:44:44,Brown Thomas,-177.00,0.00,EUR,COMPLETED,319.20
Transfer,Current,2024-10-13 10:22:59,2024-10-13 10:22:59,From Instant Access Savings,100.00,0.00,EUR,COMPLETED,419.20
Transfer,Current,2024-10-13 10:23:07,2024-10-13 10:23:07,Savings Vault topup,-5.00,0.00,EUR,COMPLETED,414.20
Transfer,Current,2024-10-13 10:26:35,2024-10-13 10:26:36,Savings Vault topup,-0.25,0.00,EUR,COMPLETED,413.95
Card Payment,Current,2024-10-12 11:39:00,2024-10-13 10:53:07,LSS Ireland Limited,-100.00,0.00,EUR,COMPLETED,313.95
Card Payment,Current,2024-10-12 12:01:55,2024-10-13 10:54:31,Smooch R,-12.50,0.00,EUR,COMPLETED,301.45
Card Payment,Current,2024-10-12 14:12:00,2024-10-13 11:33:41,SuperValu,-15.85,0.00,EUR,COMPLETED,285.60
Card Payment,Current,2024-10-12 11:55:23,2024-10-13 11:47:31,Massimo Dutti,-119.90,0.00,EUR,COMPLETED,165.70
Card Payment,Current,2024-10-12 23:32:19,2024-10-13 11:49:31,Dockers Pub,-10.80,0.00,EUR,COMPLETED,154.90
Card Payment,Current,2024-10-12 23:50:37,2024-10-13 11:49:37,Dockers Pub,-17.20,0.00,EUR,COMPLETED,137.70
Card Payment,Current,2024-10-12 23:02:09,2024-10-13 11:49:41,Dockers Pub,-10.80,0.00,EUR,COMPLETED,126.90
Card Payment,Current,2024-10-12 13:04:50,2024-10-13 11:57:44,Pizzatruck,-7.70,0.00,EUR,COMPLETED,119.20
Card Payment,Current,2024-10-12 13:49:41,2024-10-13 11:57:54,Pizzatruck,-2.15,0.00,EUR,COMPLETED,117.05
Transfer,Current,2024-10-13 15:27:24,2024-10-13 15:27:24,Savings Vault topup,-2.50,0.00,EUR,COMPLETED,114.55
Transfer,Current,2024-10-13 15:46:17,2024-10-13 15:46:17,Savings Vault topup,-5.00,0.00,EUR,COMPLETED,109.55
Transfer,Current,2024-10-13 16:05:23,2024-10-13 16:05:23,Savings Vault topup,-4.50,0.00,EUR,COMPLETED,105.05
Transfer,Current,2024-10-13 16:30:58,2024-10-13 16:30:58,From Instant Access Savings,100.00,0.00,EUR,COMPLETED,205.05
Transfer,Current,2024-10-13 16:32:00,2024-10-13 16:32:01,Savings Vault topup,-3.75,0.00,EUR,COMPLETED,201.30
Transfer,Current,2024-10-13 16:37:55,2024-10-13 16:37:55,Savings Vault topup,-5.00,0.00,EUR,COMPLETED,196.30
Card Payment,Current,2024-10-13 15:46:17,2024-10-14 09:28:41,Centra,-20.00,0.00,EUR,COMPLETED,176.30
Card Payment,Current,2024-10-13 16:05:23,2024-10-14 09:28:42,Centra,-2.10,0.00,EUR,COMPLETED,174.20
Card Payment,Current,2024-10-13 16:32:00,2024-10-14 09:29:51,ALDI,-33.25,0.00,EUR,COMPLETED,140.95
Card Payment,Current,2024-10-13 15:27:22,2024-10-14 09:49:31,OAKBERRY Açaí Bowls,-11.50,0.00,EUR,COMPLETED,129.45
Card Payment,Current,2024-10-13 00:56:29,2024-10-14 10:19:15,Harbour Kebab,-14.49,0.00,EUR,COMPLETED,114.96
Transfer,Current,2024-10-14 10:23:23,2024-10-14 10:23:23,Transfer from MARA DI RAIMONDO,10.00,0.00,EUR,COMPLETED,124.96
Transfer,Current,2024-10-14 10:23:47,2024-10-14 10:23:47,Transfer from MARA DI RAIMONDO,4.00,0.00,EUR,COMPLETED,128.96
Card Payment,Current,2024-10-13 10:26:35,2024-10-14 11:29:12,Applegreen,-11.95,0.00,EUR,COMPLETED,117.01
Card Payment,Current,2024-10-13 10:23:07,2024-10-14 11:29:15,Applegreen,-45.00,0.00,EUR,COMPLETED,72.01
Card Payment,Current,2024-10-13 16:37:54,2024-10-14 12:24:58,Easytrip,-10.00,0.00,EUR,COMPLETED,62.01
Transfer,Current,2024-10-14 13:52:03,2024-10-14 13:52:03,From Instant Access Savings,250.00,0.00,EUR,COMPLETED,312.01
Transfer,Current,2024-10-14 13:52:26,2024-10-14 13:52:26,Savings Vault topup,-0.75,0.00,EUR,COMPLETED,311.26
Topup,Current,2024-10-14 14:25:32,2024-10-14 14:25:32,Payment from VHI CLAIMS,25.00,0.00,EUR,COMPLETED,336.26
Transfer,Current,2024-10-15 16:59:55,2024-10-15 16:59:55,Transfer from MARA DI RAIMONDO,35.00,0.00,EUR,COMPLETED,371.26
Transfer,Current,2024-10-16 08:02:17,2024-10-16 08:02:17,Savings Vault topup,-5.00,0.00,EUR,COMPLETED,366.26
Transfer,Current,2024-10-16 09:31:49,2024-10-16 09:31:49,Savings Vault topup,-0.05,0.00,EUR,COMPLETED,366.21
Card Payment,Current,2024-10-16 09:31:48,2024-10-16 14:11:45,Monzo,-29.99,0.00,EUR,COMPLETED,336.22
Topup,Current,2024-10-16 14:24:16,2024-10-16 14:24:17,Payment from VHI CLAIMS,25.00,0.00,EUR,COMPLETED,361.22
Transfer,Current,2024-10-16 17:02:55,2024-10-16 17:02:55,Savings Vault topup,-1.25,0.00,EUR,COMPLETED,359.97
Transfer,Current,2024-10-16 17:23:55,2024-10-16 17:23:55,From Instant Access Savings,125.00,0.00,EUR,COMPLETED,484.97
Transfer,Current,2024-10-16 17:24:49,2024-10-16 17:24:49,Savings Vault topup,-5.00,0.00,EUR,COMPLETED,479.97
Transfer,Current,2024-10-16 17:30:17,2024-10-16 17:30:17,Savings Vault topup,-5.00,0.00,EUR,COMPLETED,474.97
Topup,Current,2024-10-16 18:56:02,2024-10-16 18:56:02,Payment from REVENUE COMMISSION,1441.00,0.00,EUR,COMPLETED,1915.97
Transfer,Current,2024-10-16 18:57:03,2024-10-16 18:57:03,Savings Vault topup,-1400.00,0.00,EUR,COMPLETED,515.97
Card Payment,Current,2024-10-16 17:02:54,2024-10-17 10:29:15,Dunnes Stores,-12.75,0.00,EUR,COMPLETED,503.22
Card Payment,Current,2024-10-16 17:30:17,2024-10-17 10:39:11,Decathlon,-11.00,0.00,EUR,COMPLETED,492.22
Card Payment,Current,2024-10-16 17:24:49,2024-10-17 10:43:54,Levi's,-176.00,0.00,EUR,COMPLETED,316.22
Card Payment,Current,2024-10-16 08:02:16,2024-10-17 11:13:25,SuperValu,-3.00,0.00,EUR,COMPLETED,313.22
Topup,Current,2024-10-17 12:20:48,2024-10-17 12:20:49,Payment from VHI CLAIMS,160.00,0.00,EUR,COMPLETED,473.22
Transfer,Current,2024-10-17 19:05:00,2024-10-17 19:05:00,Savings Vault topup,-2.00,0.00,EUR,COMPLETED,471.22
Card Payment,Current,2024-10-17 19:05:00,2024-10-18 08:52:09,Texaco,-9.60,0.00,EUR,COMPLETED,461.62
Transfer,Current,2024-10-18 09:05:46,2024-10-18 09:05:46,Savings Vault topup,-2.50,0.00,EUR,COMPLETED,459.12
Card Payment,Current,2024-10-14 13:52:26,2024-10-18 10:54:11,Marc O'Polo,-228.85,0.00,EUR,COMPLETED,230.27
Transfer,Current,2024-10-19 05:04:06,2024-10-19 05:04:06,Savings Vault topup,-2.55,0.00,EUR,COMPLETED,227.72
Card Payment,Current,2024-10-18 09:05:45,2024-10-19 10:21:23,La Cucina,-39.50,0.00,EUR,COMPLETED,188.22
Transfer,Current,2024-10-19 13:35:39,2024-10-19 13:35:39,Savings Vault topup,-3.60,0.00,EUR,COMPLETED,184.62
Transfer,Current,2024-10-19 13:56:17,2024-10-19 13:56:18,Savings Vault topup,-4.80,0.00,EUR,COMPLETED,179.82
Transfer,Current,2024-10-19 14:11:17,2024-10-19 14:11:17,Savings Vault topup,-4.75,0.00,EUR,COMPLETED,175.07
Transfer,Current,2024-10-19 19:07:47,2024-10-19 19:07:47,From Instant Access Savings,750.00,0.00,EUR,COMPLETED,925.07
Transfer,Current,2024-10-19 19:09:13,2024-10-19 19:09:13,Savings Vault topup,-1.60,0.00,EUR,COMPLETED,923.47
Card Payment,Current,2024-10-19 13:56:17,2024-10-20 09:12:10,La Cucina,-89.04,0.00,EUR,COMPLETED,834.43
Card Payment,Current,2024-10-19 14:11:17,2024-10-20 09:17:00,Applegreen,-2.05,0.00,EUR,COMPLETED,832.38
Card Payment,Current,2024-10-19 05:04:06,2024-10-20 09:42:04,Apple,-16.49,0.00,EUR,COMPLETED,815.89
Card Payment,Current,2024-10-19 13:35:38,2024-10-20 10:31:07,Castletroy Park Pharmacy,-7.28,0.00,EUR,COMPLETED,808.61
Transfer,Current,2024-10-20 13:04:12,2024-10-20 13:04:12,Savings Vault topup,-5.00,0.00,EUR,COMPLETED,803.61
Transfer,Current,2024-10-20 15:22:48,2024-10-20 15:22:48,From Instant Access Savings,100.00,0.00,EUR,COMPLETED,903.61
Transfer,Current,2024-10-20 15:22:53,2024-10-20 15:22:54,Savings Vault topup,-4.95,0.00,EUR,COMPLETED,898.66
Transfer,Current,2024-10-20 17:31:50,2024-10-20 17:31:51,Savings Vault topup,-0.25,0.00,EUR,COMPLETED,898.41
Transfer,Current,2024-10-20 18:24:49,2024-10-20 18:24:50,From Instant Access Savings,100.00,0.00,EUR,COMPLETED,998.41
Transfer,Current,2024-10-20 18:24:53,2024-10-20 18:24:54,Savings Vault topup,-5.00,0.00,EUR,COMPLETED,993.41
Transfer,Current,2024-10-21 08:31:38,2024-10-21 08:31:38,Savings Vault topup,-5.00,0.00,EUR,COMPLETED,988.41
Card Payment,Current,2024-10-20 18:24:53,2024-10-21 09:58:50,Lidl,-44.00,0.00,EUR,COMPLETED,944.41
Topup,Current,2024-10-21 10:36:56,2024-10-21 10:36:58,Payment from PATRICIA        QUISH,100.00,0.00,EUR,COMPLETED,1044.41
Card Payment,Current,2024-10-20 17:31:50,2024-10-21 11:11:35,Massimo Dutti,-59.95,0.00,EUR,COMPLETED,984.46
Card Refund,Current,2024-10-21 01:00:00,2024-10-21 11:11:37,Massimo Dutti,119.90,0.00,EUR,COMPLETED,1104.36
Card Payment,Current,2024-10-20 15:22:53,2024-10-21 11:13:44,O'Dwyer Oil,-50.01,0.00,EUR,COMPLETED,1054.35
Transfer,Current,2024-10-21 19:40:55,2024-10-21 19:40:55,From Instant Access Savings,700.00,0.00,EUR,COMPLETED,1754.35
Transfer,Current,2024-10-21 19:41:38,2024-10-21 19:41:38,Savings Vault topup,-3.80,0.00,EUR,COMPLETED,1750.55
Transfer,Current,2024-10-21 19:42:24,2024-10-21 19:42:24,Savings Vault topup,-0.40,0.00,EUR,COMPLETED,1750.15
Transfer,Current,2024-10-22 08:04:14,2024-10-22 08:04:14,Savings Vault topup,-5.00,0.00,EUR,COMPLETED,1745.15
Card Payment,Current,2024-10-20 13:04:11,2024-10-22 09:18:03,House Limerick,-15.00,0.00,EUR,COMPLETED,1730.15
Card Payment,Current,2024-10-21 19:42:24,2024-10-22 10:39:57,Booking.com,-488.92,0.00,EUR,COMPLETED,1241.23
Card Payment,Current,2024-10-21 08:31:38,2024-10-22 11:12:52,SuperValu,-3.00,0.00,EUR,COMPLETED,1238.23
Transfer,Current,2024-10-22 22:26:19,2024-10-22 22:26:19,Savings Vault topup,-5.00,0.00,EUR,COMPLETED,1233.23
Topup,Current,2024-10-23 07:40:35,2024-10-23 07:40:36,Payment from WORKDAY LIMITED,398.81,0.00,EUR,COMPLETED,1632.04
Transfer,Current,2024-10-23 07:40:55,2024-10-23 07:40:55,Savings Vault topup,-473.00,0.00,EUR,COMPLETED,1159.04
Transfer,Current,2024-10-23 08:05:47,2024-10-23 08:05:48,Savings Vault topup,-5.00,0.00,EUR,COMPLETED,1154.04
Card Payment,Current,2024-10-22 08:04:13,2024-10-23 09:49:06,SuperValu,-3.00,0.00,EUR,COMPLETED,1151.04
Card Payment,Current,2024-10-21 19:41:38,2024-10-23 10:32:39,Aer Lingus,-282.24,0.00,EUR,COMPLETED,868.80
Card Payment,Current,2024-10-22 22:26:19,2024-10-23 10:48:00,Www.footfocus.ie,-70.00,0.00,EUR,COMPLETED,798.80
Card Payment,Current,2024-10-19 19:09:13,2024-10-23 11:17:46,Dell,-741.68,0.00,EUR,COMPLETED,57.12
Transfer,Current,2024-10-23 01:00:00,2024-10-23 11:45:07,To eFlow,-1.23,0.00,EUR,COMPLETED,55.89
Transfer,Current,2024-10-23 13:58:06,2024-10-23 13:58:06,From Instant Access Savings,250.00,0.00,EUR,COMPLETED,305.89
Transfer,Current,2024-10-23 13:58:36,2024-10-23 13:58:36,Transfer to Andrew James Fullen,-250.00,0.00,EUR,COMPLETED,55.89
Transfer,Current,2024-10-23 19:20:33,2024-10-23 19:20:33,From Instant Access Savings,100.00,0.00,EUR,COMPLETED,155.89
Transfer,Current,2024-10-23 19:20:48,2024-10-23 19:20:48,Savings Vault topup,-0.05,0.00,EUR,COMPLETED,155.84
Transfer,Current,2024-10-24 08:29:23,2024-10-24 08:29:24,Savings Vault topup,-1.25,0.00,EUR,COMPLETED,154.59
Card Payment,Current,2024-10-23 19:20:48,2024-10-24 10:08:33,Deliveroo,-57.99,0.00,EUR,COMPLETED,96.60
Card Payment,Current,2024-10-23 08:05:47,2024-10-24 11:17:25,SuperValu,-3.00,0.00,EUR,COMPLETED,93.60
Transfer,Current,2024-10-24 16:41:23,2024-10-24 16:41:24,Savings Vault topup,-2.50,0.00,EUR,COMPLETED,91.10
Transfer,Current,2024-10-24 16:47:21,2024-10-24 16:47:22,Savings Vault topup,-2.60,0.00,EUR,COMPLETED,88.50
Transfer,Current,2024-10-24 16:50:27,2024-10-24 16:50:28,Savings Vault topup,-5.00,0.00,EUR,COMPLETED,83.50
Transfer,Current,2024-10-24 16:54:09,2024-10-24 16:54:09,Savings Vault topup,-1.75,0.00,EUR,COMPLETED,81.75
Transfer,Current,2024-10-24 20:32:58,2024-10-24 20:32:58,Savings Vault topup,-2.85,0.00,EUR,COMPLETED,78.90
Topup,Current,2024-10-25 08:10:19,2024-10-25 08:10:19,Payment from WORKDAY LIMITED,5189.82,0.00,EUR,COMPLETED,5268.72
Card Payment,Current,2024-10-24 16:50:27,2024-10-25 09:38:28,Tesco,-4.00,0.00,EUR,COMPLETED,5264.72
Card Payment,Current,2024-10-24 16:54:09,2024-10-25 09:50:55,Stillorgan Decor,-20.65,0.00,EUR,COMPLETED,5244.07
Card Payment,Current,2024-10-24 08:29:23,2024-10-25 09:57:06,SuperValu,-12.75,0.00,EUR,COMPLETED,5231.32
Transfer,Current,2024-10-25 11:30:00,2024-10-25 11:30:00,To pocket EUR Subscriptions from EUR,-400.00,0.00,EUR,COMPLETED,4831.32
Card Payment,Current,2024-10-24 16:47:21,2024-10-25 11:32:29,Bookstation,-15.48,0.00,EUR,COMPLETED,4815.84
Card Payment,Current,2024-10-24 16:41:23,2024-10-25 11:32:30,Bookstation,-3.50,0.00,EUR,COMPLETED,4812.34
Card Payment,Current,2024-10-24 20:32:58,2024-10-25 13:29:24,Amazon,-11.43,0.00,EUR,COMPLETED,4800.91
Transfer,Current,2024-10-25 14:19:13,2024-10-25 14:51:01,To Finance Ireland,-1424.50,0.00,EUR,COMPLETED,3376.41
Transfer,Current,2024-10-25 14:19:13,2024-10-25 14:51:01,To Trading 212 UK Limited,-500.00,0.00,EUR,COMPLETED,2876.41
Transfer,Current,2024-10-25 15:20:41,2024-10-25 15:20:41,Savings Vault topup,-2000.00,0.00,EUR,COMPLETED,876.41
Transfer,Current,2024-10-25 15:36:13,2024-10-25 15:36:13,Savings Vault topup,-2.50,0.00,EUR,COMPLETED,873.91
Transfer,Current,2024-10-25 21:31:03,2024-10-25 21:31:03,Savings Vault topup,-5.00,0.00,EUR,COMPLETED,868.91
Card Payment,Current,2024-10-25 15:36:13,2024-10-26 10:37:20,SuperValu,-13.50,0.00,EUR,COMPLETED,855.41
Transfer,Current,2024-10-26 11:32:57,2024-10-26 11:32:57,Transfer to Andrew James Fullen,-124.00,0.00,EUR,COMPLETED,731.41
Transfer,Current,2024-10-26 15:41:13,2024-10-26 15:41:13,Savings Vault topup,-1.75,0.00,EUR,COMPLETED,729.66
Transfer,Current,2024-10-26 15:46:38,2024-10-26 15:46:38,Savings Vault topup,-4.50,0.00,EUR,COMPLETED,725.16
Transfer,Current,2024-10-26 15:55:55,2024-10-26 15:55:55,Savings Vault topup,-2.50,0.00,EUR,COMPLETED,722.66
Transfer,Current,2024-10-26 18:41:10,2024-10-26 18:41:10,Savings Vault topup,-1.90,0.00,EUR,COMPLETED,720.76
Card Payment,Current,2024-10-26 15:55:55,2024-10-27 09:52:49,Insomnia Coffee Company,-4.50,0.00,EUR,COMPLETED,716.26
Card Payment,Current,2024-10-26 18:41:10,2024-10-27 10:37:28,SuperValu,-23.62,0.00,EUR,COMPLETED,692.64
Card Payment,Current,2024-10-25 21:31:03,2024-10-27 10:38:29,The Merry Cobbler,-80.00,0.00,EUR,COMPLETED,612.64
Transfer,Current,2024-10-27 11:04:52,2024-10-27 11:04:52,Savings Vault topup,-1.65,0.00,EUR,COMPLETED,610.99
Transfer,Current,2024-10-27 13:33:59,2024-10-27 13:33:59,Savings Vault topup,-4.75,0.00,EUR,COMPLETED,606.24
Transfer,Current,2024-10-27 18:41:07,2024-10-27 18:41:07,Savings Vault topup,-2.30,0.00,EUR,COMPLETED,603.94
Transfer,Current,2024-10-27 18:46:47,2024-10-27 18:46:47,Transfer from MARA DI RAIMONDO,13.35,0.00,EUR,COMPLETED,617.29
Transfer,Current,2024-10-27 18:47:18,2024-10-27 18:47:18,Transfer from MARA DI RAIMONDO,550.00,0.00,EUR,COMPLETED,1167.29
Transfer,Current,2024-10-27 18:52:04,2024-10-27 18:52:04,Transfer from MARA DI RAIMONDO,11.64,0.00,EUR,COMPLETED,1178.93
Transfer,Current,2024-10-27 18:53:03,2024-10-27 18:53:03,Transfer to MARA DI RAIMONDO,-13.50,0.00,EUR,COMPLETED,1165.43
Transfer,Current,2024-10-27 18:54:00,2024-10-27 18:54:00,Transfer from MARA DI RAIMONDO,10.00,0.00,EUR,COMPLETED,1175.43
Transfer,Current,2024-10-27 19:38:48,2024-10-27 19:38:48,Transfer from MARA DI RAIMONDO,18.00,0.00,EUR,COMPLETED,1193.43
Card Payment,Current,2024-10-26 15:41:13,2024-10-28 09:13:21,Spar,-5.65,0.00,EUR,COMPLETED,1187.78
Card Payment,Current,2024-10-26 15:46:38,2024-10-28 09:16:39,Subway,-9.10,0.00,EUR,COMPLETED,1178.68
Card Payment,Current,2024-10-27 18:41:07,2024-10-28 09:29:26,Deliveroo,-38.54,0.00,EUR,COMPLETED,1140.14
Card Payment,Current,2024-10-27 11:04:52,2024-10-28 09:40:02,SuperValu,-32.67,0.00,EUR,COMPLETED,1107.47
Card Payment,Current,2024-10-27 13:33:59,2024-10-28 11:13:33,Clark’s Newsagent,-9.05,0.00,EUR,COMPLETED,1098.42
Transfer,Current,2024-10-28 14:30:17,2024-10-28 14:30:18,Savings Vault topup,-1.40,0.00,EUR,COMPLETED,1097.02
Transfer,Current,2024-10-28 14:51:17,2024-10-28 14:51:17,Savings Vault topup,-0.20,0.00,EUR,COMPLETED,1096.82
Card Payment,Current,2024-10-28 14:30:17,2024-10-29 09:14:34,Woodie's,-124.72,0.00,EUR,COMPLETED,972.10
Card Payment,Current,2024-10-28 14:51:16,2024-10-29 11:17:03,SuperValu,-23.96,0.00,EUR,COMPLETED,948.14
Transfer,Current,2024-10-29 20:28:54,2024-10-29 20:28:55,To Payward Ireland Ltd.,-1.00,0.00,EUR,COMPLETED,947.14
Transfer,Current,2024-10-29 21:11:57,2024-10-29 21:11:57,Savings Vault topup,-5.00,0.00,EUR,COMPLETED,942.14
Transfer,Current,2024-10-29 21:12:36,2024-10-29 21:12:37,Transfer from CONOR NAYLOR,30.00,0.00,EUR,COMPLETED,972.14
Transfer,Current,2024-10-29 22:02:15,2024-10-29 22:02:15,Savings Vault topup,-4.50,0.00,EUR,COMPLETED,967.64
Transfer,Current,2024-10-30 08:24:11,2024-10-30 08:24:11,Savings Vault topup,-5.00,0.00,EUR,COMPLETED,962.64
Transfer,Current,2024-10-30 08:28:28,2024-10-30 08:28:28,Savings Vault topup,-5.00,0.00,EUR,COMPLETED,957.64
Card Payment,Current,2024-10-29 21:11:57,2024-10-30 09:42:38,Light House Cinema,-60.00,0.00,EUR,COMPLETED,897.64
Card Payment,Current,2024-10-29 22:02:15,2024-10-30 11:13:17,McDonald's,-10.10,0.00,EUR,COMPLETED,887.54
Transfer,Current,2024-10-30 11:38:53,2024-10-30 11:38:54,To Payward Ireland Ltd.,-98.00,0.00,EUR,COMPLETED,789.54
Transfer,Current,2024-10-30 13:12:34,2024-10-30 13:12:34,Savings Vault topup,-2.75,0.00,EUR,COMPLETED,786.79
Transfer,Current,2024-10-30 16:49:57,2024-10-30 16:49:57,Savings Vault topup,-2.05,0.00,EUR,COMPLETED,784.74
Transfer,Current,2024-10-31 07:35:03,2024-10-31 07:35:03,Savings Vault topup,-2.55,0.00,EUR,COMPLETED,782.19
Transfer,Current,2024-10-31 07:41:14,2024-10-31 07:41:14,Savings Vault topup,-4.65,0.00,EUR,COMPLETED,777.54
Transfer,Current,2024-10-31 08:13:00,2024-10-31 08:13:00,Savings Vault topup,-5.00,0.00,EUR,COMPLETED,772.54
Card Payment,Current,2024-10-30 08:24:11,2024-10-31 10:19:07,Payzone,-10.00,0.00,EUR,COMPLETED,762.54
Card Payment,Current,2024-10-30 16:49:57,2024-10-31 11:00:34,Deliveroo,-40.59,0.00,EUR,COMPLETED,721.95
Card Payment,Current,2024-10-30 08:28:27,2024-10-31 11:14:45,Hatch Coffee,-37.00,0.00,EUR,COMPLETED,684.95
Transfer,Current,2024-10-31 11:28:23,2024-10-31 11:28:23,Transfer from MARA DI RAIMONDO,20.30,0.00,EUR,COMPLETED,705.25
Transfer,Current,2024-10-31 11:57:04,2024-10-31 11:57:04,Savings Vault topup,-5.00,0.00,EUR,COMPLETED,700.25
Transfer,Current,2024-10-31 17:00:44,2024-10-31 17:00:44,Savings Vault topup,-5.00,0.00,EUR,COMPLETED,695.25
Transfer,Current,2024-10-31 19:21:36,2024-10-31 19:21:36,Savings Vault topup,-5.00,0.00,EUR,COMPLETED,690.25
Transfer,Current,2024-10-31 19:34:59,2024-10-31 19:34:59,Savings Vault topup,-2.50,0.00,EUR,COMPLETED,687.75
Transfer,Current,2024-10-31 20:21:42,2024-10-31 20:21:42,Savings Vault topup,-2.00,0.00,EUR,COMPLETED,685.75
Transfer,Current,2024-11-01 08:29:23,2024-11-01 08:29:24,Savings Vault topup,-3.50,0.00,EUR,COMPLETED,682.25
Card Payment,Current,2024-10-31 20:21:42,2024-11-01 09:55:32,Light House Cinema,-10.60,0.00,EUR,COMPLETED,671.65
Card Payment,Current,2024-10-31 07:41:14,2024-11-01 10:17:43,Startfabrik,-365.07,0.00,EUR,COMPLETED,306.58
Card Payment,Current,2024-10-31 17:00:44,2024-11-01 10:24:41,Cut and Sew,-32.00,0.00,EUR,COMPLETED,274.58
Card Payment,Current,2024-10-31 07:35:03,2024-11-01 11:11:41,HP,-1.49,0.00,EUR,COMPLETED,273.09
Card Payment,Current,2024-10-31 19:21:36,2024-11-01 11:13:04,Eatokyo Sushi Noodles Bar,-65.00,0.00,EUR,COMPLETED,208.09
Card Payment,Current,2024-10-30 13:12:34,2024-11-01 12:09:23,Amazon,-39.45,0.00,EUR,COMPLETED,168.64
Card Payment,Current,2024-10-31 11:57:04,2024-11-01 13:08:26,Wikimedia,-26.00,0.00,EUR,COMPLETED,142.64
Transfer,Current,2024-11-01 13:28:53,2024-11-01 13:28:53,Savings Vault topup,-2.25,0.00,EUR,COMPLETED,140.39
Transfer,Current,2024-11-01 14:15:18,2024-11-01 14:15:18,Transfer from MARA DI RAIMONDO,41.91,0.00,EUR,COMPLETED,182.30
Transfer,Current,2024-11-01 14:15:20,2024-11-01 14:15:21,Transfer from MARA DI RAIMONDO,44.76,0.00,EUR,COMPLETED,227.06
Transfer,Current,2024-11-01 14:17:03,2024-11-01 14:17:04,Transfer from MARA DI RAIMONDO,28.50,0.00,EUR,COMPLETED,255.56
Transfer,Current,2024-11-01 15:07:53,2024-11-01 15:07:53,Savings Vault topup,-5.00,0.00,EUR,COMPLETED,250.56
Card Payment,Current,2024-10-31 08:12:59,2024-11-01 15:51:08,SuperValu,-3.00,0.00,EUR,COMPLETED,247.56
Transfer,Current,2024-11-01 17:09:11,2024-11-01 17:09:11,Savings Vault topup,-2.50,0.00,EUR,COMPLETED,245.06
Transfer,Current,2024-11-01 17:14:51,2024-11-01 17:14:51,Savings Vault topup,-1.50,0.00,EUR,COMPLETED,243.56
Transfer,Current,2024-11-01 17:47:05,2024-11-01 17:47:05,Savings Vault topup,-4.50,0.00,EUR,COMPLETED,239.06
Transfer,Current,2024-11-01 20:41:40,2024-11-01 20:41:40,Savings Vault topup,-1.00,0.00,EUR,COMPLETED,238.06
Transfer,Current,2024-11-01 21:10:59,2024-11-01 21:10:59,Savings Vault topup,-5.00,0.00,EUR,COMPLETED,233.06
Transfer,Current,2024-11-01 21:43:21,2024-11-01 21:43:21,Savings Vault topup,-4.00,0.00,EUR,COMPLETED,229.06
Transfer,Current,2024-11-01 23:18:11,2024-11-01 23:18:11,Savings Vault topup,-5.00,0.00,EUR,COMPLETED,224.06
Transfer,Current,2024-11-02 09:52:35,2024-11-02 09:52:35,Transfer to MARA DI RAIMONDO,-8.40,0.00,EUR,COMPLETED,215.66
Transfer,Current,2024-11-02 10:33:04,2024-11-02 10:33:04,From Instant Access Savings,100.00,0.00,EUR,COMPLETED,315.66
Transfer,Current,2024-11-02 10:33:11,2024-11-02 10:33:11,Savings Vault topup,-0.25,0.00,EUR,COMPLETED,315.41
Transfer,Current,2024-11-02 11:00:25,2024-11-02 11:00:25,Savings Vault topup,-0.70,0.00,EUR,COMPLETED,314.71
Card Payment,Current,2024-11-01 17:14:51,2024-11-02 11:07:21,Grogans Castle Lounge,-6.70,0.00,EUR,COMPLETED,308.01
Card Payment,Current,2024-11-01 17:47:05,2024-11-02 11:07:21,Grogans Castle Lounge,-20.10,0.00,EUR,COMPLETED,287.91
Card Payment,Current,2024-11-01 20:41:39,2024-11-02 11:07:34,Grogans Castle Lounge,-35.80,0.00,EUR,COMPLETED,252.11
Card Payment,Current,2024-11-01 21:43:21,2024-11-02 11:07:34,Grogans Castle Lounge,-27.20,0.00,EUR,COMPLETED,224.91
Transfer,Current,2024-11-02 11:10:35,2024-11-02 11:10:35,Savings Vault topup,-1.25,0.00,EUR,COMPLETED,223.66
Card Payment,Current,2024-11-01 08:29:23,2024-11-02 11:26:01,Mint,-12.30,0.00,EUR,COMPLETED,211.36
Card Payment,Current,2024-11-01 17:09:11,2024-11-02 11:29:57,Circle K Gas Station,-10.50,0.00,EUR,COMPLETED,200.86
Card Payment,Current,2024-10-31 19:34:59,2024-11-02 11:35:27,The Grand Social Ireland,-8.50,0.00,EUR,COMPLETED,192.36
Card Payment,Current,2024-11-01 21:10:59,2024-11-02 11:43:24,Centra,-18.00,0.00,EUR,COMPLETED,174.36
Card Payment,Current,2024-11-01 23:18:10,2024-11-02 12:17:19,O Regans Bar,-28.00,0.00,EUR,COMPLETED,146.36
Card Payment,Current,2024-11-01 13:28:52,2024-11-02 12:21:25,SuperValu,-10.55,0.00,EUR,COMPLETED,135.81
Card Payment,Current,2024-11-01 15:07:53,2024-11-02 13:16:52,Movember Foundation,-30.00,0.00,EUR,COMPLETED,105.81
Transfer,Current,2024-11-02 15:05:16,2024-11-02 15:05:16,Savings Vault topup,-4.85,0.00,EUR,COMPLETED,100.96
Transfer,Current,2024-11-02 19:13:12,2024-11-02 19:13:12,Savings Vault topup,-0.10,0.00,EUR,COMPLETED,100.86
Card Payment,Current,2024-11-02 10:33:10,2024-11-03 08:54:49,Applegreen,-10.95,0.00,EUR,COMPLETED,89.91
Card Payment,Current,2024-11-02 19:13:12,2024-11-03 10:13:17,Domino's pizza,-30.98,0.00,EUR,COMPLETED,58.93
Card Payment,Current,2024-11-02 11:00:25,2024-11-03 10:26:09,SuperValu,-20.86,0.00,EUR,COMPLETED,38.07
Card Payment,Current,2024-11-02 15:05:15,2024-11-03 11:02:26,Deliveroo,-21.03,0.00,EUR,COMPLETED,17.04
Card Payment,Current,2024-11-02 11:10:35,2024-11-03 12:06:58,Amazon,-10.75,0.11,EUR,COMPLETED,6.18
Transfer,Current,2024-11-03 12:31:59,2024-11-03 12:31:59,From Instant Access Savings,100.00,0.00,EUR,COMPLETED,106.18
Transfer,Current,2024-11-03 12:34:45,2024-11-03 12:34:46,Savings Vault topup,-4.60,0.00,EUR,COMPLETED,101.58
Transfer,Current,2024-11-03 19:54:08,2024-11-03 19:54:09,Savings Vault topup,-2.15,0.00,EUR,COMPLETED,99.43
Transfer,Current,2024-11-04 02:51:48,2024-11-04 02:51:48,Savings Vault topup,-0.05,0.00,EUR,COMPLETED,99.38
Transfer,Current,2024-11-04 08:11:45,2024-11-04 08:11:45,Savings Vault topup,-5.00,0.00,EUR,COMPLETED,94.38
Transfer,Current,2024-11-04 09:36:20,2024-11-04 09:36:21,Savings Vault topup,-1.15,0.00,EUR,COMPLETED,93.23
Card Payment,Current,2024-11-03 12:34:45,2024-11-04 11:28:33,Lidl,-37.08,0.00,EUR,COMPLETED,56.15
Transfer,Current,2024-11-04 13:54:34,2024-11-04 13:54:35,From Instant Access Savings,1200.00,0.00,EUR,COMPLETED,1256.15
Transfer,Current,2024-11-04 13:57:07,2024-11-04 14:35:52,To Murphy Larkin,-978.00,0.00,EUR,COMPLETED,278.15
Card Payment,Current,2024-11-04 09:36:20,2024-11-04 17:13:03,YouTube,-1.78,0.00,EUR,COMPLETED,276.37
Transfer,Current,2024-11-04 17:48:23,2024-11-04 17:48:23,Transfer to MARA DI RAIMONDO,-22.50,0.00,EUR,COMPLETED,253.87
Transfer,Current,2024-11-04 17:48:26,2024-11-04 17:48:26,Transfer to MARA DI RAIMONDO,-5.41,0.00,EUR,COMPLETED,248.46
Transfer,Current,2024-11-04 18:03:03,2024-11-04 18:03:03,Savings Vault topup,-2.50,0.00,EUR,COMPLETED,245.96
Transfer,Current,2024-11-04 18:04:24,2024-11-04 18:04:24,Savings Vault topup,-4.55,0.00,EUR,COMPLETED,241.41
Transfer,Current,2024-11-05 08:39:56,2024-11-05 08:39:56,Savings Vault topup,-5.00,0.00,EUR,COMPLETED,236.41
Card Payment,Current,2024-11-04 02:51:48,2024-11-05 08:54:07,Apple,-2.99,0.00,EUR,COMPLETED,233.42
Card Payment,Current,2024-11-04 08:11:45,2024-11-05 10:10:26,Insomnia Coffee Company,-4.00,0.00,EUR,COMPLETED,229.42
Card Payment,Current,2024-11-04 18:03:03,2024-11-05 10:25:52,SuperValu,-3.50,0.00,EUR,COMPLETED,225.92
Card Payment,Current,2024-11-04 18:04:23,2024-11-05 10:25:55,SuperValu,-1.09,0.00,EUR,COMPLETED,224.83
Card Payment,Current,2024-11-03 19:54:08,2024-11-05 13:44:16,Amazon,-14.57,0.15,EUR,COMPLETED,210.11
Transfer,Current,2024-11-06 09:20:02,2024-11-06 09:20:02,Savings Vault topup,-0.25,0.00,EUR,COMPLETED,209.86
Card Payment,Current,2024-11-05 08:39:56,2024-11-06 11:45:21,SuperValu,-3.00,0.00,EUR,COMPLETED,206.86
Transfer,Current,2024-11-06 16:16:31,2024-11-06 16:16:31,Savings Vault topup,-3.95,0.00,EUR,COMPLETED,202.91
Transfer,Current,2024-11-06 16:59:11,2024-11-06 16:59:11,Savings Vault topup,-2.50,0.00,EUR,COMPLETED,200.41
Transfer,Current,2024-11-06 18:31:07,2024-11-06 18:31:07,Savings Vault topup,-0.80,0.00,EUR,COMPLETED,199.61
Transfer,Current,2024-11-07 08:41:26,2024-11-07 08:41:26,Savings Vault topup,-2.95,0.00,EUR,COMPLETED,196.66
Card Payment,Current,2024-11-06 09:20:02,2024-11-07 08:55:44,OXMANTOWN,-3.95,0.00,EUR,COMPLETED,192.71
Card Payment,Current,2024-11-06 16:59:10,2024-11-07 10:28:10,Centra,-8.50,0.00,EUR,COMPLETED,184.21
Card Payment,Current,2024-11-06 18:31:07,2024-11-07 10:56:40,Deliveroo,-52.84,0.00,EUR,COMPLETED,131.37
Card Payment,Current,2024-11-06 16:16:31,2024-11-07 13:42:29,Splice,-9.21,0.00,EUR,COMPLETED,122.16
Transfer,Current,2024-11-07 23:33:07,2024-11-07 23:33:07,Savings Vault topup,-1.65,0.00,EUR,COMPLETED,120.51
Transfer,Current,2024-11-08 08:12:56,2024-11-08 08:12:56,From Instant Access Savings,100.00,0.00,EUR,COMPLETED,220.51
Transfer,Current,2024-11-08 08:39:39,2024-11-08 08:39:39,Savings Vault topup,-4.00,0.00,EUR,COMPLETED,216.51
Card Payment,Current,2024-11-07 08:41:26,2024-11-08 09:38:21,SuperValu,-12.41,0.00,EUR,COMPLETED,204.10
Transfer,Current,2024-11-08 10:20:15,2024-11-08 10:20:15,Savings Vault topup,-4.55,0.00,EUR,COMPLETED,199.55
Transfer,Current,2024-11-08 10:27:01,2024-11-08 10:27:01,Savings Vault topup,-1.75,0.00,EUR,COMPLETED,197.80
Transfer,Current,2024-11-08 19:36:16,2024-11-08 19:36:16,Savings Vault topup,-5.00,0.00,EUR,COMPLETED,192.80
Transfer,Current,2024-11-08 20:01:05,2024-11-08 20:01:05,From Instant Access Savings,100.00,0.00,EUR,COMPLETED,292.80
Transfer,Current,2024-11-08 20:01:37,2024-11-08 20:01:38,Transfer to JOHN DANIEL KIELY,-16.00,0.00,EUR,COMPLETED,276.80
Transfer,Current,2024-11-08 20:17:04,2024-11-08 20:17:04,Savings Vault topup,-3.50,0.00,EUR,COMPLETED,273.30
Transfer,Current,2024-11-09 09:52:56,2024-11-09 09:52:56,Savings Vault topup,-4.50,0.00,EUR,COMPLETED,268.80
Card Payment,Current,2024-11-08 20:17:04,2024-11-09 11:10:45,The Circular,-21.30,0.00,EUR,COMPLETED,247.50
Card Payment,Current,2024-11-08 08:39:39,2024-11-09 11:45:07,Hatch Coffee,-22.20,0.00,EUR,COMPLETED,225.30
Card Payment,Current,2024-11-08 19:36:16,2024-11-09 11:53:40,Centra,-9.00,0.00,EUR,COMPLETED,216.30
Card Payment,Current,2024-11-07 23:33:07,2024-11-09 12:58:15,Amazon,-50.67,0.00,EUR,COMPLETED,165.63
Transfer,Current,2024-11-09 15:01:44,2024-11-09 15:01:44,Savings Vault topup,-5.00,0.00,EUR,COMPLETED,160.63
Transfer,Current,2024-11-10 08:42:23,2024-11-10 08:42:23,Savings Vault topup,-3.50,0.00,EUR,COMPLETED,157.13
Card Payment,Current,2024-11-09 15:01:44,2024-11-10 11:44:44,SuperValu,-17.00,0.00,EUR,COMPLETED,140.13
Card Payment,Current,2024-11-09 09:52:56,2024-11-10 11:49:03,Butlers Chocolates,-4.10,0.00,EUR,COMPLETED,136.03
Transfer,Current,2024-11-10 12:47:46,2024-11-10 12:47:46,From Instant Access Savings,100.00,0.00,EUR,COMPLETED,236.03
Transfer,Current,2024-11-10 12:47:57,2024-11-10 12:47:57,Savings Vault topup,-0.25,0.00,EUR,COMPLETED,235.78
Card Payment,Current,2024-11-08 10:27:00,2024-11-10 14:03:07,Amazon,-8.65,0.00,EUR,COMPLETED,227.13
Transfer,Current,2024-11-10 14:25:42,2024-11-10 14:25:42,Savings Vault topup,-4.85,0.00,EUR,COMPLETED,222.28
Card Payment,Current,2024-11-10 12:47:56,2024-11-11 09:16:22,Hatch Coffee,-26.95,0.00,EUR,COMPLETED,195.33
Card Payment,Current,2024-11-10 08:42:23,2024-11-11 11:05:23,Applegreen,-13.30,0.00,EUR,COMPLETED,182.03
Transfer,Current,2024-11-11 11:33:27,2024-11-11 11:33:27,Savings Vault topup,-0.30,0.00,EUR,COMPLETED,181.73
Card Payment,Current,2024-11-10 14:25:42,2024-11-11 13:39:21,Amazon,-73.03,0.73,EUR,COMPLETED,107.97
Card Payment,Current,2024-11-08 10:20:14,2024-11-11 13:59:45,Amazon,-88.09,0.00,EUR,COMPLETED,19.88
Transfer,Current,2024-11-11 14:17:57,2024-11-11 14:17:57,From Instant Access Savings,250.00,0.00,EUR,COMPLETED,269.88
Transfer,Current,2024-11-11 14:18:51,2024-11-11 14:18:51,Savings Vault topup,-5.00,0.00,EUR,COMPLETED,264.88
Transfer,Current,2024-11-12 09:04:52,2024-11-12 09:04:52,Savings Vault topup,-0.25,0.00,EUR,COMPLETED,264.63
Card Payment,Current,2024-11-11 14:18:50,2024-11-12 09:34:06,Www.my power.ie,-240.00,0.00,EUR,COMPLETED,24.63
Card Payment,Current,2024-11-11 11:33:26,2024-11-12 12:13:04,Amazon,-9.94,0.00,EUR,COMPLETED,14.69
Transfer,Current,2024-11-12 13:38:38,2024-11-12 13:38:38,From Instant Access Savings,1000.00,0.00,EUR,COMPLETED,1014.69
Transfer,Current,2024-11-12 13:38:51,2024-11-12 14:38:01,To Murphy Larkin,-978.00,0.00,EUR,COMPLETED,36.69
Transfer,Current,2024-11-12 16:08:06,2024-11-12 16:08:06,Savings Vault topup,-2.50,0.00,EUR,COMPLETED,34.19
Transfer,Current,2024-11-12 16:55:38,2024-11-12 16:55:38,Savings Vault topup,-5.00,0.00,EUR,COMPLETED,29.19
Card Payment,Current,2024-11-12 09:04:51,2024-11-13 09:16:49,OXMANTOWN,-3.95,0.00,EUR,COMPLETED,25.24
Card Payment,Current,2024-11-12 16:08:05,2024-11-13 10:19:30,Centra,-8.50,0.00,EUR,COMPLETED,16.74
Card Payment,Current,2024-11-12 16:55:38,2024-11-13 11:55:48,Spar,-8.00,0.00,EUR,COMPLETED,8.74
Transfer,Current,2024-11-13 12:27:15,2024-11-13 12:27:15,From Instant Access Savings,150.00,0.00,EUR,COMPLETED,158.74
Transfer,Current,2024-11-13 12:27:55,2024-11-13 12:27:55,Transfer to DONAL TOMAS LYNCH,-98.00,0.00,EUR,COMPLETED,60.74
Transfer,Current,2024-11-13 13:04:55,2024-11-13 13:04:55,Savings Vault topup,-3.30,0.00,EUR,COMPLETED,57.44
Transfer,Current,2024-11-13 16:42:36,2024-11-13 16:42:36,From Instant Access Savings,100.00,0.00,EUR,COMPLETED,157.44
Transfer,Current,2024-11-13 16:42:46,2024-11-13 16:42:46,Savings Vault topup,-1.75,0.00,EUR,COMPLETED,155.69
Transfer,Current,2024-11-13 16:44:31,2024-11-13 16:44:31,Savings Vault topup,-3.45,0.00,EUR,COMPLETED,152.24
Transfer,Current,2024-11-13 17:05:00,2024-11-13 17:05:00,Transfer from MARA DI RAIMONDO,49.00,0.00,EUR,COMPLETED,201.24
Transfer,Current,2024-11-13 17:05:22,2024-11-13 17:05:22,Transfer from MARA DI RAIMONDO,20.74,0.00,EUR,COMPLETED,221.98
Card Payment,Current,2024-11-13 17:07:49,,Deliveroo,-21.09,0.00,EUR,REVERTED,
Transfer,Current,2024-11-13 17:07:49,2024-11-13 17:07:49,Savings Vault topup,-4.55,0.00,EUR,COMPLETED,217.43
Transfer,Current,2024-11-13 17:08:18,2024-11-13 17:08:18,Transfer from MARA DI RAIMONDO,21.09,0.00,EUR,COMPLETED,238.52
Card Payment,Current,2024-11-13 17:09:12,,Deliveroo,-21.09,0.00,EUR,REVERTED,
Transfer,Current,2024-11-13 17:09:12,2024-11-13 17:09:12,Savings Vault topup,-4.55,0.00,EUR,COMPLETED,233.97
Transfer,Current,2024-11-13 17:11:40,2024-11-13 17:11:40,Savings Vault topup,-4.55,0.00,EUR,COMPLETED,229.42
Transfer,Current,2024-11-13 21:50:54,2024-11-13 21:50:55,Transfer to CONOR NAYLOR,-34.50,0.00,EUR,COMPLETED,194.92
Transfer,Current,2024-11-13 22:10:21,2024-11-13 22:10:21,Savings Vault topup,-5.00,0.00,EUR,COMPLETED,189.92
Transfer,Current,2024-11-14 08:42:50,2024-11-14 08:42:50,Savings Vault topup,-4.50,0.00,EUR,COMPLETED,185.42
Card Payment,Current,2024-11-13 17:11:40,2024-11-14 10:46:34,Deliveroo,-21.09,0.00,EUR,COMPLETED,164.33
Card Payment,Current,2024-11-13 16:42:45,2024-11-14 11:22:53,The Rise Pharmacy,-27.65,0.00,EUR,COMPLETED,136.68
Card Payment,Current,2024-11-13 16:44:30,2024-11-14 12:21:07,SuperValu,-6.31,0.00,EUR,COMPLETED,130.37
Card Payment,Current,2024-11-13 13:04:54,2024-11-14 15:21:55,Amazon,-49.34,0.00,EUR,COMPLETED,81.03
Transfer,Current,2024-11-14 17:33:08,2024-11-14 17:33:08,Savings Vault topup,-5.00,0.00,EUR,COMPLETED,76.03
Card Payment,Current,2024-11-14 08:42:50,2024-11-15 09:22:14,Kaldi's Coffee,-6.10,0.00,EUR,COMPLETED,69.93
Card Payment,Current,2024-11-14 17:33:08,2024-11-15 11:31:18,Daybreak,-9.00,0.00,EUR,COMPLETED,60.93
Transfer,Current,2024-11-15 14:32:38,2024-11-15 14:32:38,Savings Vault topup,-2.10,0.00,EUR,COMPLETED,58.83
Transfer,Current,2024-11-15 18:26:56,2024-11-15 18:26:57,From Instant Access Savings,100.00,0.00,EUR,COMPLETED,158.83
Transfer,Current,2024-11-15 18:28:16,2024-11-15 18:28:16,Savings Vault topup,-1.50,0.00,EUR,COMPLETED,157.33
Transfer,Current,2024-11-15 19:36:36,2024-11-15 19:36:37,Savings Vault topup,-1.50,0.00,EUR,COMPLETED,155.83
Transfer,Current,2024-11-15 20:58:59,2024-11-15 20:58:59,Savings Vault topup,-2.50,0.00,EUR,COMPLETED,153.33
Transfer,Current,2024-11-15 21:00:19,2024-11-15 21:00:19,Transfer from JOHN DANIEL KIELY,4.00,0.00,EUR,COMPLETED,157.33
Transfer,Current,2024-11-15 21:17:05,2024-11-15 21:17:05,Savings Vault topup,-5.00,0.00,EUR,COMPLETED,152.33
Transfer,Current,2024-11-15 23:13:15,2024-11-15 23:13:16,Savings Vault topup,-2.50,0.00,EUR,COMPLETED,149.83
Transfer,Current,2024-11-16 00:14:28,2024-11-16 00:14:29,From Instant Access Savings,100.00,0.00,EUR,COMPLETED,249.83
Transfer,Current,2024-11-16 00:14:38,2024-11-16 00:14:38,Savings Vault topup,-5.00,0.00,EUR,COMPLETED,244.83
Transfer,Current,2024-11-16 00:45:07,2024-11-16 00:45:07,From Instant Access Savings,100.00,0.00,EUR,COMPLETED,344.83
Transfer,Current,2024-11-16 00:46:42,2024-11-16 00:46:42,From Instant Access Savings,100.00,0.00,EUR,COMPLETED,444.83
Transfer,Current,2024-11-16 00:46:54,2024-11-16 00:46:54,Savings Vault topup,-5.00,0.00,EUR,COMPLETED,439.83
Transfer,Current,2024-11-16 01:19:21,2024-11-16 01:19:22,Savings Vault topup,-5.00,0.00,EUR,COMPLETED,434.83
Transfer,Current,2024-11-16 02:13:53,2024-11-16 02:13:53,Savings Vault topup,-3.00,0.00,EUR,COMPLETED,431.83
Card Payment,Current,2024-11-13 22:10:20,2024-11-16 09:43:32,The Ferryman,-14.00,0.00,EUR,COMPLETED,417.83
Card Payment,Current,2024-11-15 20:58:59,2024-11-16 11:07:57,Centra,-14.50,0.00,EUR,COMPLETED,403.33
Transfer,Current,2024-11-16 11:34:10,2024-11-16 11:34:10,Savings Vault topup,-4.25,0.00,EUR,COMPLETED,399.08
Card Payment,Current,2024-11-15 23:13:15,2024-11-16 11:39:37,Kodiak,-20.50,0.00,EUR,COMPLETED,378.58
Card Payment,Current,2024-11-15 21:17:04,2024-11-16 11:39:40,Kodiak,-21.00,0.00,EUR,COMPLETED,357.58
Transfer,Current,2024-11-16 12:08:32,2024-11-16 12:08:32,Transfer from RORY BOYLE,20.00,0.00,EUR,COMPLETED,377.58
Card Payment,Current,2024-11-15 14:32:38,2024-11-16 12:45:35,SuperValu,-26.58,0.00,EUR,COMPLETED,351.00
Transfer,Current,2024-11-16 14:42:45,2024-11-16 14:42:45,Transfer to RORY BOYLE,-10.00,0.00,EUR,COMPLETED,341.00
Transfer,Current,2024-11-16 15:43:21,2024-11-16 15:43:21,Pocket Withdrawal,100.00,0.00,EUR,COMPLETED,441.00
Transfer,Current,2024-11-16 15:44:10,2024-11-16 15:44:10,Savings Vault topup,-3.90,0.00,EUR,COMPLETED,437.10
Transfer,Current,2024-11-16 20:49:16,2024-11-16 20:49:16,Savings Vault topup,-5.00,0.00,EUR,COMPLETED,432.10
Transfer,Current,2024-11-17 10:00:38,2024-11-17 10:00:38,Savings Vault topup,-4.50,0.00,EUR,COMPLETED,427.60
Card Payment,Current,2024-11-16 11:34:10,2024-11-17 10:41:42,Applegreen,-11.15,0.00,EUR,COMPLETED,416.45
Transfer,Current,2024-11-17 10:49:45,2024-11-17 10:49:45,Savings Vault topup,-4.50,0.00,EUR,COMPLETED,411.95
Transfer,Current,2024-11-17 11:04:08,2024-11-17 11:04:08,Savings Vault topup,-5.00,0.00,EUR,COMPLETED,406.95
Card Payment,Current,2024-11-16 15:44:10,2024-11-17 11:14:36,SuperValu,-16.22,0.00,EUR,COMPLETED,390.73
Card Payment,Current,2024-11-15 18:28:16,2024-11-17 11:17:49,Blackbird,-14.70,0.00,EUR,COMPLETED,376.03
Card Payment,Current,2024-11-15 19:36:36,2024-11-17 11:18:37,Blackbird,-6.70,0.00,EUR,COMPLETED,369.33
Card Payment,Current,2024-11-16 01:19:21,2024-11-17 11:21:10,Zaytoon,-18.00,0.00,EUR,COMPLETED,351.33
Card Payment,Current,2024-11-16 02:13:52,2024-11-17 11:57:04,Taxi Ugo,-28.40,0.00,EUR,COMPLETED,322.93
Card Payment,Current,2024-11-16 00:14:38,2024-11-17 11:57:33,Marrakesh,-100.00,0.00,EUR,COMPLETED,222.93
Card Payment,Current,2024-11-16 00:46:54,2024-11-17 11:57:38,Marrakesh,-146.00,0.00,EUR,COMPLETED,76.93
Transfer,Current,2024-11-17 14:24:33,2024-11-17 14:24:33,Savings Vault topup,-3.25,0.00,EUR,COMPLETED,73.68
Card Payment,Current,2024-11-16 20:49:16,2024-11-18 09:03:34,Independent.ie,-6.00,0.00,EUR,COMPLETED,67.68
Card Payment,Current,2024-11-17 11:04:07,2024-11-18 10:37:32,The Irish Times,-1.00,0.00,EUR,COMPLETED,66.68
Card Payment,Current,2024-11-17 10:00:38,2024-11-18 11:03:10,Hatch Coffee,-17.10,0.00,EUR,COMPLETED,49.58
Card Payment,Current,2024-11-17 10:49:44,2024-11-18 11:04:10,Hatch Coffee,-4.10,0.00,EUR,COMPLETED,45.48
Card Payment,Current,2024-11-17 14:24:33,2024-11-18 11:22:00,Lidl,-40.35,0.00,EUR,COMPLETED,5.13
Transfer,Current,2024-11-18 14:27:09,2024-11-18 14:27:09,From Instant Access Savings,100.00,0.00,EUR,COMPLETED,105.13
Transfer,Current,2024-11-18 14:27:25,2024-11-18 14:27:25,Savings Vault topup,-4.05,0.00,EUR,COMPLETED,101.08
Transfer,Current,2024-11-18 18:45:54,2024-11-18 18:45:54,Savings Vault topup,-5.00,0.00,EUR,COMPLETED,96.08
Card Payment,Current,2024-11-18 18:45:54,2024-11-19 10:38:14,Circle K,-1.00,0.00,EUR,COMPLETED,95.08
Card Payment,Current,2024-11-18 14:27:25,2024-11-19 13:42:03,Amazon,-17.19,0.00,EUR,COMPLETED,77.89
Transfer,Current,2024-11-20 10:21:12,2024-11-20 10:21:12,From Instant Access Savings,100.00,0.00,EUR,COMPLETED,177.89
Transfer,Current,2024-11-20 10:21:28,2024-11-20 10:21:28,Savings Vault topup,-0.25,0.00,EUR,COMPLETED,177.64
Transfer,Current,2024-11-20 12:47:13,2024-11-20 12:47:13,Savings Vault topup,-1.25,0.00,EUR,COMPLETED,176.39
Transfer,Current,2024-11-20 16:38:09,2024-11-20 16:38:09,Savings Vault topup,-2.50,0.00,EUR,COMPLETED,173.89
Transfer,Current,2024-11-20 17:35:42,2024-11-20 17:35:43,Savings Vault topup,-4.00,0.00,EUR,COMPLETED,169.89
Transfer,Current,2024-11-21 08:31:05,2024-11-21 08:31:05,Savings Vault topup,-2.50,0.00,EUR,COMPLETED,167.39
Card Payment,Current,2024-11-20 10:21:28,2024-11-21 08:54:10,Cycling Ireland,-94.95,0.00,EUR,COMPLETED,72.44
Card Payment,Current,2024-11-20 17:35:42,2024-11-21 10:08:42,Deliveroo,-23.20,0.00,EUR,COMPLETED,49.24
Card Payment,Current,2024-11-20 16:38:09,2024-11-21 10:09:40,Centra,-8.50,0.00,EUR,COMPLETED,40.74
Card Payment,Current,2024-11-20 12:47:12,2024-11-21 10:51:33,Fresh The Good Food Market,-6.75,0.00,EUR,COMPLETED,33.99
Transfer,Current,2024-11-21 18:06:31,2024-11-21 18:06:31,Transfer from MARA DI RAIMONDO,23.20,0.00,EUR,COMPLETED,57.19
Transfer,Current,2024-11-21 18:07:09,2024-11-21 18:07:09,Savings Vault topup,-3.05,0.00,EUR,COMPLETED,54.14
Card Payment,Current,2024-11-21 08:31:05,2024-11-22 10:14:28,Taste & See Café,-3.50,0.00,EUR,COMPLETED,50.64
Card Payment,Current,2024-11-21 18:07:09,2024-11-22 10:14:45,Deliveroo,-40.39,0.00,EUR,COMPLETED,10.25
Transfer,Current,2024-11-22 11:04:05,2024-11-22 11:04:05,Transfer from MARA DI RAIMONDO,20.20,0.00,EUR,COMPLETED,30.45
Transfer,Current,2024-11-22 00:00:00,2024-11-22 11:42:53,To eFlow,-5.83,0.00,EUR,COMPLETED,24.62
Transfer,Current,2024-11-22 14:59:31,2024-11-22 14:59:31,From Instant Access Savings,1000.00,0.00,EUR,COMPLETED,1024.62
Transfer,Current,2024-11-22 19:07:46,2024-11-22 19:07:47,Transfer to MARA DI RAIMONDO,-1000.00,0.00,EUR,COMPLETED,24.62
Transfer,Current,2024-11-23 16:48:31,2024-11-23 16:48:31,From Instant Access Savings,125.00,0.00,EUR,COMPLETED,149.62
Transfer,Current,2024-11-23 17:00:35,2024-11-23 17:00:35,From Instant Access Savings,175.00,0.00,EUR,COMPLETED,324.62
Transfer,Current,2024-11-23 17:01:16,2024-11-23 17:01:17,Savings Vault topup,-4.20,0.00,EUR,COMPLETED,320.42
Transfer,Current,2024-11-23 17:14:34,2024-11-23 17:14:35,Savings Vault topup,-0.05,0.00,EUR,COMPLETED,320.37
Transfer,Current,2024-11-23 17:19:17,2024-11-23 17:19:17,Savings Vault topup,-5.00,0.00,EUR,COMPLETED,315.37
Transfer,Current,2024-11-23 17:21:53,2024-11-23 17:21:53,Savings Vault topup,-1.00,0.00,EUR,COMPLETED,314.37
Transfer,Current,2024-11-23 17:27:38,2024-11-23 17:27:38,Transfer from EMMA SADBH MURPHY,82.00,0.00,EUR,COMPLETED,396.37
Transfer,Current,2024-11-23 19:47:27,2024-11-23 19:47:27,Savings Vault topup,-2.50,0.00,EUR,COMPLETED,393.87
Transfer,Current,2024-11-23 21:42:13,2024-11-23 21:42:13,Savings Vault topup,-3.60,0.00,EUR,COMPLETED,390.27
Transfer,Current,2024-11-23 22:02:04,2024-11-23 22:02:04,Transfer to EMMA SADBH MURPHY,-10.00,0.00,EUR,COMPLETED,380.27
Transfer,Current,2024-11-24 01:12:02,2024-11-24 01:12:02,Savings Vault topup,-3.50,0.00,EUR,COMPLETED,376.77
Transfer,Current,2024-11-24 10:50:35,2024-11-24 10:50:35,Savings Vault topup,-0.05,0.00,EUR,COMPLETED,376.72
Card Payment,Current,2024-11-23 17:01:16,2024-11-24 11:00:56,Zakura,-259.16,0.00,EUR,COMPLETED,117.56
Card Payment,Current,2024-11-23 17:14:34,2024-11-24 11:40:45,Boots,-4.99,0.00,EUR,COMPLETED,112.57
Transfer,Current,2024-11-24 12:24:27,2024-11-24 12:24:28,Transfer from LAURA LOUISE KAVANAGH,67.70,0.00,EUR,COMPLETED,180.27
Transfer,Current,2024-11-24 12:31:29,2024-11-24 12:31:29,Savings Vault topup,-3.25,0.00,EUR,COMPLETED,177.02
Transfer,Current,2024-11-24 16:19:35,2024-11-24 16:19:35,Savings Vault topup,-1.60,0.00,EUR,COMPLETED,175.42
Transfer,Current,2024-11-24 19:00:44,2024-11-24 19:00:45,Savings Vault topup,-2.75,0.00,EUR,COMPLETED,172.67
Transfer,Current,2024-11-24 20:30:02,2024-11-24 20:30:02,From Instant Access Savings,1900.00,0.00,EUR,COMPLETED,2072.67
Topup,Current,2024-11-25 08:07:58,2024-11-25 08:07:59,Payment from WORKDAY LIMITED,2671.85,0.00,EUR,COMPLETED,4744.52
Transfer,Current,2024-11-25 08:07:59,2024-11-25 08:07:59,Savings Vault topup,-275.00,0.00,EUR,COMPLETED,4469.52
Transfer,Current,2024-11-25 08:00:44,2024-11-25 08:38:57,To Finance Ireland,-1424.50,0.00,EUR,COMPLETED,3045.02
Transfer,Current,2024-11-25 08:46:55,2024-11-25 08:46:55,Savings Vault topup,-1250.00,0.00,EUR,COMPLETED,1795.02
Transfer,Current,2024-11-25 08:44:45,2024-11-25 09:25:21,To Trading 212 UK Limited,-500.00,0.00,EUR,COMPLETED,1295.02
Transfer,Current,2024-11-25 08:46:08,2024-11-25 09:25:28,To Colm Quish,-722.39,0.00,EUR,COMPLETED,572.63
Card Payment,Current,2024-11-24 16:19:35,2024-11-25 10:16:52,Lidl,-32.68,0.00,EUR,COMPLETED,539.95
Transfer,Current,2024-11-25 10:20:34,2024-11-25 10:20:34,To pocket EUR Subscriptions from EUR,-400.00,0.00,EUR,COMPLETED,139.95
Topup,Current,2024-11-25 10:37:35,2024-11-25 10:37:37,Payment from PATRICIA        QUISH,1000.00,0.00,EUR,COMPLETED,1139.95
Transfer,Current,2024-11-25 10:40:30,2024-11-25 10:40:30,Savings Vault topup,-750.00,0.00,EUR,COMPLETED,389.95
Transfer,Current,2024-11-25 10:55:19,2024-11-25 10:55:21,To Payward Ireland Ltd.,-100.00,0.00,EUR,COMPLETED,289.95
Card Payment,Current,2024-11-24 01:12:02,2024-11-25 11:04:13,FREE NOW,-15.30,0.00,EUR,COMPLETED,274.65
Card Payment,Current,2024-11-23 17:19:16,2024-11-25 12:31:56,Spar,-9.00,0.00,EUR,COMPLETED,265.65
Card Payment,Current,2024-11-23 21:42:13,2024-11-25 12:31:59,Spar,-23.28,0.00,EUR,COMPLETED,242.37
Card Payment,Current,2024-11-24 12:31:29,2024-11-25 12:35:10,Gleesons,-10.35,0.00,EUR,COMPLETED,232.02
Card Payment,Current,2024-11-23 17:21:53,2024-11-25 12:50:32,Toners,-6.80,0.00,EUR,COMPLETED,225.22
Card Payment,Current,2024-11-23 19:47:27,2024-11-25 12:50:50,Toners,-41.50,0.00,EUR,COMPLETED,183.72
Transfer,Current,2024-11-25 13:14:37,2024-11-25 13:14:37,Transfer from MARA DI RAIMONDO,7.65,0.00,EUR,COMPLETED,191.37
Transfer,Current,2024-11-25 13:14:41,2024-11-25 13:14:41,Transfer from MARA DI RAIMONDO,38.50,0.00,EUR,COMPLETED,229.87
Transfer,Current,2024-11-25 13:15:10,2024-11-25 13:15:10,Transfer from MARA DI RAIMONDO,550.00,0.00,EUR,COMPLETED,779.87
Transfer,Current,2024-11-25 13:15:53,2024-11-25 13:15:53,Savings Vault topup,-500.00,0.00,EUR,COMPLETED,279.87
Card Payment,Current,2024-11-24 19:00:44,2024-11-25 14:01:54,Amazon,-11.45,0.11,EUR,COMPLETED,268.31
Transfer,Current,2024-11-25 15:06:46,2024-11-25 15:06:46,Savings Vault topup,-5.00,0.00,EUR,COMPLETED,263.31
Card Payment,Current,2024-11-24 10:50:35,2024-11-25 15:23:25,The Washington Post,-0.99,0.00,EUR,COMPLETED,262.32
Exchange,Current,2024-11-25 16:56:07,2024-11-25 16:56:07,Exchanged to EUR,20099.12,0.00,EUR,COMPLETED,20361.44
Transfer,Current,2024-11-25 16:56:49,2024-11-25 16:56:49,Savings Vault topup,-20000.00,0.00,EUR,COMPLETED,361.44
Transfer,Current,2024-11-25 19:08:29,2024-11-25 19:08:29,Transfer to ENDA CARROLL,-50.00,0.00,EUR,COMPLETED,311.44
Card Payment,Current,2024-11-25 15:06:45,2024-11-26 10:10:42,Dublin Marathon,-6.00,0.00,EUR,COMPLETED,305.44
Transfer,Current,2024-11-27 09:15:58,2024-11-27 09:15:59,Savings Vault topup,-5.00,0.00,EUR,COMPLETED,300.44
Transfer,Current,2024-11-27 22:08:36,2024-11-27 22:08:36,Savings Vault topup,-1.60,0.00,EUR,COMPLETED,298.84
Card Payment,Current,2024-11-27 09:15:58,2024-11-28 11:00:46,Donation,-10.00,0.00,EUR,COMPLETED,288.84
Transfer,Current,2024-11-29 08:09:39,2024-11-29 08:09:39,Savings Vault topup,-0.25,0.00,EUR,COMPLETED,288.59
Transfer,Current,2024-11-29 12:13:54,2024-11-29 12:13:54,Savings Vault topup,-0.25,0.00,EUR,COMPLETED,288.34
Transfer,Current,2024-11-29 12:21:03,2024-11-29 12:21:03,Savings Vault topup,-4.50,0.00,EUR,COMPLETED,283.84
Card Payment,Current,2024-11-27 22:08:36,2024-11-29 12:45:23,Amazon,-100.68,0.00,EUR,COMPLETED,183.16
Transfer,Current,2024-11-29 16:24:16,2024-11-29 16:24:16,Savings Vault topup,-5.00,0.00,EUR,COMPLETED,178.16
Transfer,Current,2024-11-29 19:27:14,2024-11-29 19:27:14,Savings Vault topup,-4.50,0.00,EUR,COMPLETED,173.66
Transfer,Current,2024-11-29 19:41:23,2024-11-29 19:41:23,Savings Vault topup,-2.15,0.00,EUR,COMPLETED,171.51
Transfer,Current,2024-11-29 20:25:13,2024-11-29 20:25:13,Savings Vault topup,-2.50,0.00,EUR,COMPLETED,169.01
Transfer,Current,2024-11-29 20:29:04,2024-11-29 20:29:04,Savings Vault topup,-1.50,0.00,EUR,COMPLETED,167.51
Transfer,Current,2024-11-29 21:38:56,2024-11-29 21:38:56,Savings Vault topup,-1.00,0.00,EUR,COMPLETED,166.51
Transfer,Current,2024-11-29 23:59:28,2024-11-29 23:59:28,Savings Vault topup,-3.00,0.00,EUR,COMPLETED,163.51
Transfer,Current,2024-11-30 00:09:09,2024-11-30 00:09:09,Savings Vault topup,-3.75,0.00,EUR,COMPLETED,159.76
Transfer,Current,2024-11-30 00:12:26,2024-11-30 00:12:26,Savings Vault topup,-0.25,0.00,EUR,COMPLETED,159.51
Card Payment,Current,2024-11-29 19:27:13,2024-11-30 09:52:09,Kennedy's Pub & Restaurant,-20.10,0.00,EUR,COMPLETED,139.41
Card Payment,Current,2024-11-29 16:24:16,2024-11-30 11:23:48,SuperValu,-11.00,0.00,EUR,COMPLETED,128.41
Card Payment,Current,2024-11-29 20:25:13,2024-11-30 11:32:52,Centra,-11.50,0.00,EUR,COMPLETED,116.91
Card Payment,Current,2024-11-29 12:13:54,2024-11-30 11:55:34,Texaco,-6.95,0.00,EUR,COMPLETED,109.96
Card Payment,Current,2024-11-29 12:21:03,2024-11-30 11:55:40,Texaco,-9.10,0.00,EUR,COMPLETED,100.86
Card Payment,Current,2024-11-29 08:09:39,2024-11-30 11:59:38,Gleesons,-3.95,0.00,EUR,COMPLETED,96.91
Card Payment,Current,2024-11-29 23:59:27,2024-11-30 12:00:21,McCarthy's Bar,-6.40,0.00,EUR,COMPLETED,90.51
Transfer,Current,2024-11-30 15:06:46,2024-11-30 15:06:46,Savings Vault topup,-3.50,0.00,EUR,COMPLETED,87.01
Transfer,Current,2024-11-30 16:28:54,2024-11-30 16:28:54,Savings Vault topup,-5.00,0.00,EUR,COMPLETED,82.01
Transfer,Current,2024-11-30 17:11:22,2024-11-30 17:11:22,From Instant Access Savings,100.00,0.00,EUR,COMPLETED,182.01
Transfer,Current,2024-11-30 17:11:35,2024-11-30 17:11:35,Savings Vault topup,-2.50,0.00,EUR,COMPLETED,179.51
Transfer,Current,2024-11-30 19:34:56,2024-11-30 19:34:56,Savings Vault topup,-3.50,0.00,EUR,COMPLETED,176.01
Transfer,Current,2024-11-30 20:07:07,2024-11-30 20:07:07,Savings Vault topup,-0.25,0.00,EUR,COMPLETED,175.76
Transfer,Current,2024-11-30 20:25:52,2024-11-30 20:25:52,Savings Vault topup,-5.00,0.00,EUR,COMPLETED,170.76
Transfer,Current,2024-11-30 20:55:09,2024-11-30 20:55:09,Savings Vault topup,-3.50,0.00,EUR,COMPLETED,167.26
Transfer,Current,2024-11-30 21:59:58,2024-11-30 21:59:58,Savings Vault topup,-2.50,0.00,EUR,COMPLETED,164.76
Card Payment,Current,2024-11-29 20:29:04,2024-12-01 08:56:56,Eat.dingle,-6.70,0.00,EUR,COMPLETED,158.06
Card Payment,Current,2024-11-29 21:38:56,2024-12-01 08:57:19,Barr na Sráide,-16.80,0.00,EUR,COMPLETED,141.26
Card Payment,Current,2024-11-30 00:09:09,2024-12-01 08:58:20,Eat.dingle,-13.25,0.00,EUR,COMPLETED,128.01
Card Payment,Current,2024-11-30 00:12:25,2024-12-01 08:58:26,Eat.dingle,-2.95,0.00,EUR,COMPLETED,125.06
Card Payment,Current,2024-11-30 21:59:58,2024-12-01 10:36:57,Glenduff Manor House,-35.50,0.00,EUR,COMPLETED,89.56
Card Payment,Current,2024-11-30 19:34:55,2024-12-01 11:06:53,City Point Ireland Limited,-18.30,0.00,EUR,COMPLETED,71.26
Card Payment,Current,2024-11-30 20:55:09,2024-12-01 11:07:26,City Point Ireland Limited,-9.30,0.00,EUR,COMPLETED,61.96
Transfer,Current,2024-12-01 13:01:10,2024-12-01 13:01:10,From Instant Access Savings,100.00,0.00,EUR,COMPLETED,161.96
Transfer,Current,2024-12-01 13:04:03,2024-12-01 13:04:03,Savings Vault topup,-3.85,0.00,EUR,COMPLETED,158.11
Card Payment,Current,2024-11-30 20:25:52,2024-12-01 13:07:00,Centra,-8.00,0.00,EUR,COMPLETED,150.11
Card Payment,Current,2024-11-30 16:28:54,2024-12-01 13:33:55,McCarthy's Bar,-9.00,0.00,EUR,COMPLETED,141.11
Card Payment,Current,2024-11-29 19:41:22,2024-12-01 15:17:51,Amazon,-5.57,0.00,EUR,COMPLETED,135.54
Transfer,Current,2024-12-02 07:41:33,2024-12-02 07:41:33,Savings Vault topup,-2.55,0.00,EUR,COMPLETED,132.99
Card Payment,Current,2024-11-30 15:06:46,2024-12-02 11:25:40,Adams Barbershop,-19.30,0.00,EUR,COMPLETED,113.69
Card Payment,Current,2024-11-30 17:11:35,2024-12-02 11:26:08,Adams Barbershop,-9.50,0.00,EUR,COMPLETED,104.19
Card Payment,Current,2024-11-30 20:07:07,2024-12-02 11:27:30,Eat.dingle,-2.95,0.00,EUR,COMPLETED,101.24
Transfer,Current,2024-12-02 11:47:06,2024-12-02 11:47:06,Savings Vault topup,-0.45,0.00,EUR,COMPLETED,100.79
Card Payment,Current,2024-12-01 13:04:02,2024-12-02 12:03:26,Spar,-79.23,0.00,EUR,COMPLETED,21.56
Transfer,Current,2024-12-02 16:09:09,2024-12-02 16:09:09,Transfer from MARA DI RAIMONDO,44.76,0.00,EUR,COMPLETED,66.32
Transfer,Current,2024-12-02 16:09:12,2024-12-02 16:09:12,Transfer from MARA DI RAIMONDO,41.91,0.00,EUR,COMPLETED,108.23
Transfer,Current,2024-12-02 18:14:21,2024-12-02 18:14:21,Savings Vault topup,-3.50,0.00,EUR,COMPLETED,104.73
Transfer,Current,2024-12-02 22:21:57,2024-12-02 22:21:58,From Instant Access Savings,100.00,0.00,EUR,COMPLETED,204.73
Transfer,Current,2024-12-02 22:22:19,2024-12-02 22:22:19,Transfer to RORY BOYLE,-100.00,0.00,EUR,COMPLETED,104.73
Card Payment,Current,2024-12-02 18:14:21,2024-12-03 10:29:22,Applegreen,-6.30,0.00,EUR,COMPLETED,98.43
Card Payment,Current,2024-12-02 07:41:33,2024-12-03 13:48:44,HP,-1.49,0.00,EUR,COMPLETED,96.94
Card Payment,Current,2024-12-02 11:47:05,2024-12-03 15:02:35,Amazon,-10.91,0.00,EUR,COMPLETED,86.03
Transfer,Current,2024-12-03 18:08:33,2024-12-03 18:08:34,Savings Vault topup,-4.50,0.00,EUR,COMPLETED,81.53
Exchange,Current,2024-12-03 22:31:30,2024-12-03 22:31:30,Exchanged to EUR,10688.59,0.00,EUR,COMPLETED,10770.12
Transfer,Current,2024-12-03 22:32:05,2024-12-03 22:32:05,Savings Vault topup,-10688.00,0.00,EUR,COMPLETED,82.12
Transfer,Current,2024-12-04 02:52:05,2024-12-04 02:52:05,Savings Vault topup,-0.05,0.00,EUR,COMPLETED,82.07
Transfer,Current,2024-12-04 08:16:02,2024-12-04 08:16:02,From Instant Access Savings,1000.00,0.00,EUR,COMPLETED,1082.07
Transfer,Current,2024-12-04 09:36:27,2024-12-04 09:36:27,Savings Vault topup,-1.00,0.00,EUR,COMPLETED,1081.07
Transfer,Current,2024-12-04 09:37:31,2024-12-04 09:37:31,Transfer to MARA DI RAIMONDO,-1000.00,0.00,EUR,COMPLETED,81.07
Transfer,Current,2024-12-04 11:53:57,2024-12-04 11:53:57,From Instant Access Savings,4500.00,0.00,EUR,COMPLETED,4581.07
Transfer,Current,2024-12-04 11:55:12,2024-12-04 12:37:48,To Colm Quish,-838.49,0.00,EUR,COMPLETED,3742.58
Transfer,Current,2024-12-04 11:58:48,2024-12-04 12:38:06,To Burlington Management Company CLG,-3580.35,0.00,EUR,COMPLETED,162.23
Card Payment,Current,2024-12-03 18:08:33,2024-12-04 15:47:08,SuperValu,-20.10,0.00,EUR,COMPLETED,142.13
Transfer,Current,2024-12-04 17:46:06,2024-12-04 17:46:06,Savings Vault topup,-5.00,0.00,EUR,COMPLETED,137.13
Transfer,Current,2024-12-04 19:02:18,2024-12-04 19:02:18,Savings Vault topup,-2.95,0.00,EUR,COMPLETED,134.18
Card Payment,Current,2024-12-04 09:36:27,2024-12-05 04:11:31,YouTube,-1.80,0.00,EUR,COMPLETED,132.38
Card Payment,Current,2024-12-04 02:52:05,2024-12-05 10:58:55,Apple,-2.99,0.00,EUR,COMPLETED,129.39
Card Payment,Current,2024-12-04 17:46:05,2024-12-05 11:31:11,Daybreak,-9.00,0.00,EUR,COMPLETED,120.39
Transfer,Current,2024-12-05 12:37:49,2024-12-05 12:37:49,Savings Vault topup,-0.25,0.00,EUR,COMPLETED,120.14
Card Payment,Current,2024-12-04 19:02:18,2024-12-05 13:27:09,Bunsen,-36.41,0.00,EUR,COMPLETED,83.73
Transfer,Current,2024-12-05 18:02:53,2024-12-05 18:02:53,Savings Vault topup,-2.50,0.00,EUR,COMPLETED,81.23
Transfer,Current,2024-12-06 09:40:36,2024-12-06 09:40:36,Savings Vault topup,-4.80,0.00,EUR,COMPLETED,76.43
Card Payment,Current,2024-12-05 12:37:49,2024-12-06 10:34:34,Market Pharmacy Smithfield,-12.95,0.00,EUR,COMPLETED,63.48
Card Payment,Current,2024-12-05 18:02:53,2024-12-06 12:46:46,Centra,-8.50,0.00,EUR,COMPLETED,54.98
Transfer,Current,2024-12-06 14:42:10,2024-12-06 14:42:10,Savings Vault topup,-4.60,0.00,EUR,COMPLETED,50.38
Card Payment,Current,2024-12-06 09:40:36,2024-12-06 16:08:22,Amazon,-17.04,0.00,EUR,COMPLETED,33.34
Transfer,Current,2024-12-06 17:39:56,2024-12-06 17:39:56,From Instant Access Savings,100.00,0.00,EUR,COMPLETED,133.34
Card Payment,Current,2024-12-06 14:42:09,2024-12-07 10:47:48,SuperValu,-26.08,0.00,EUR,COMPLETED,107.26
Transfer,Current,2024-12-07 16:32:23,2024-12-07 16:32:23,Savings Vault topup,-0.80,0.00,EUR,COMPLETED,106.46
Transfer,Current,2024-12-07 18:16:43,2024-12-07 18:16:43,From Instant Access Savings,100.00,0.00,EUR,COMPLETED,206.46
Transfer,Current,2024-12-07 18:17:28,2024-12-07 18:17:28,Transfer to KIERAN HORAN,-120.00,0.00,EUR,COMPLETED,86.46
Card Payment,Current,2024-12-07 16:32:20,2024-12-08 10:04:33,Deliveroo,-38.84,0.00,EUR,COMPLETED,47.62
Transfer,Current,2024-12-08 12:39:28,2024-12-08 12:39:29,Transfer from MARA DI RAIMONDO,19.42,0.00,EUR,COMPLETED,67.04
Transfer,Current,2024-12-08 16:06:25,2024-12-08 16:06:25,Savings Vault topup,-3.25,0.00,EUR,COMPLETED,63.79
Card Payment,Current,2024-12-08 16:06:25,2024-12-09 11:13:48,Hatch Coffee,-9.35,0.00,EUR,COMPLETED,54.44
Transfer,Current,2024-12-09 12:30:18,2024-12-09 12:30:18,Savings Vault topup,-2.50,0.00,EUR,COMPLETED,51.94
Topup,Current,2024-12-09 18:57:34,2024-12-09 18:57:35,Payment from MURPHY LARKIN TIMBER PRODUCTS,253.00,0.00,EUR,COMPLETED,304.94
Transfer,Current,2024-12-09 19:34:51,2024-12-09 19:34:51,Savings Vault topup,-5.00,0.00,EUR,COMPLETED,299.94
Card Payment,Current,2024-12-09 12:30:18,2024-12-10 10:26:31,Centra,-5.50,0.00,EUR,COMPLETED,294.44
Card Payment,Current,2024-12-09 19:34:51,2024-12-10 10:57:23,The Old Punch Bowl,-135.00,0.00,EUR,COMPLETED,159.44
Transfer,Current,2024-12-10 12:45:53,2024-12-10 12:45:53,Savings Vault topup,-1.25,0.00,EUR,COMPLETED,158.19
Transfer,Current,2024-12-10 18:21:38,2024-12-10 18:21:38,Savings Vault topup,-2.90,0.00,EUR,COMPLETED,155.29
Topup,Current,2024-12-11 07:10:33,2024-12-11 07:10:33,Payment from WORKDAY LIMITED,89.00,0.00,EUR,COMPLETED,244.29
Card Payment,Current,2024-12-10 12:45:52,2024-12-11 11:00:44,Fresh The Good Food Market,-6.75,0.00,EUR,COMPLETED,237.54
Card Payment,Current,2024-12-10 18:21:38,2024-12-11 11:13:17,SuperValu,-27.42,0.00,EUR,COMPLETED,210.12
Transfer,Current,2024-12-11 13:37:21,2024-12-11 13:37:21,Savings Vault topup,-1.00,0.00,EUR,COMPLETED,209.12
Transfer,Current,2024-12-11 17:10:01,2024-12-11 17:10:01,Savings Vault topup,-2.50,0.00,EUR,COMPLETED,206.62
Transfer,Current,2024-12-11 17:17:04,2024-12-11 17:17:04,Savings Vault topup,-5.00,0.00,EUR,COMPLETED,201.62
Transfer,Current,2024-12-11 17:32:11,2024-12-11 17:32:11,Savings Vault topup,-5.00,0.00,EUR,COMPLETED,196.62
Transfer,Current,2024-12-11 18:01:45,2024-12-11 18:01:45,Savings Vault topup,-2.50,0.00,EUR,COMPLETED,194.12
Transfer,Current,2024-12-11 18:22:16,2024-12-11 18:22:16,Savings Vault topup,-5.00,0.00,EUR,COMPLETED,189.12
Card Payment,Current,2024-12-11 13:37:21,2024-12-12 11:54:31,Chopped,-12.80,0.00,EUR,COMPLETED,176.32
Card Payment,Current,2024-12-11 18:01:45,2024-12-12 11:58:01,The Grand Social Ireland,-8.50,0.00,EUR,COMPLETED,167.82
Transfer,Current,2024-12-12 12:34:21,2024-12-12 12:34:21,Savings Vault topup,-5.00,0.00,EUR,COMPLETED,162.82
Card Payment,Current,2024-12-11 17:32:11,2024-12-12 13:07:15,Decathlon,-6.00,0.00,EUR,COMPLETED,156.82
Card Payment,Current,2024-12-11 17:17:04,2024-12-12 13:10:35,Life Style Sports,-12.00,0.00,EUR,COMPLETED,144.82
Card Payment,Current,2024-12-11 17:10:01,2024-12-12 13:30:00,Centra,-8.50,0.00,EUR,COMPLETED,136.32
Transfer,Current,2024-12-12 14:21:35,2024-12-12 14:21:36,Savings Vault topup,-3.00,0.00,EUR,COMPLETED,133.32
Transfer,Current,2024-12-12 18:28:46,2024-12-12 18:28:46,From Instant Access Savings,100.00,0.00,EUR,COMPLETED,233.32
Transfer,Current,2024-12-12 18:29:05,2024-12-12 18:29:05,Savings Vault topup,-5.00,0.00,EUR,COMPLETED,228.32
Transfer,Current,2024-12-12 21:55:06,2024-12-12 21:55:07,Savings Vault topup,-5.00,0.00,EUR,COMPLETED,223.32
Card Payment,Current,2024-12-12 21:55:06,2024-12-13 09:54:41,SPAR Food & Fuel,-10.00,0.00,EUR,COMPLETED,213.32
Card Payment,Current,2024-12-11 18:22:16,2024-12-13 11:08:51,ASICS,-90.00,0.00,EUR,COMPLETED,123.32
Transfer,Current,2024-12-13 11:26:55,2024-12-13 11:26:55,Savings Vault topup,-2.50,0.00,EUR,COMPLETED,120.82
Transfer,Current,2024-12-13 12:54:22,2024-12-13 12:54:22,Savings Vault topup,-1.85,0.00,EUR,COMPLETED,118.97
Transfer,Current,2024-12-13 15:28:19,2024-12-13 15:28:19,From Instant Access Savings,200.00,0.00,EUR,COMPLETED,318.97
Transfer,Current,2024-12-13 16:42:58,2024-12-13 16:42:58,Savings Vault topup,-4.50,0.00,EUR,COMPLETED,314.47
Transfer,Current,2024-12-13 16:43:41,2024-12-13 16:43:41,Savings Vault topup,-4.00,0.00,EUR,COMPLETED,310.47
Card Payment,Current,2024-12-12 14:21:35,2024-12-13 17:27:53,Boojum,-10.40,0.00,EUR,COMPLETED,300.07
Card Payment,Current,2024-12-12 12:34:21,2024-12-13 17:28:25,Transport for Ireland - TFI,-20.00,0.00,EUR,COMPLETED,280.07
Card Payment,Current,2024-12-12 18:29:04,2024-12-13 17:32:46,Dines,-14.00,0.00,EUR,COMPLETED,266.07
Transfer,Current,2024-12-13 20:19:39,2024-12-13 20:19:39,Savings Vault topup,-2.00,0.00,EUR,COMPLETED,264.07
Transfer,Current,2024-12-13 22:30:24,2024-12-13 22:30:24,Savings Vault topup,-5.00,0.00,EUR,COMPLETED,259.07
Card Payment,Current,2024-12-13 16:43:40,2024-12-14 08:34:30,FREE NOW,-57.20,0.00,EUR,COMPLETED,201.87
Transfer,Current,2024-12-14 09:50:26,2024-12-14 09:50:26,From Instant Access Savings,260.00,0.00,EUR,COMPLETED,461.87
Transfer,Current,2024-12-14 09:52:22,2024-12-14 09:52:22,Savings Vault topup,-5.00,0.00,EUR,COMPLETED,456.87
Card Payment,Current,2024-12-13 22:30:24,2024-12-14 10:21:26,Resilience,-60.00,0.00,EUR,COMPLETED,396.87
Transfer,Current,2024-12-14 10:54:21,2024-12-14 10:54:21,Savings Vault topup,-4.25,0.00,EUR,COMPLETED,392.62
Card Payment,Current,2024-12-13 20:19:39,2024-12-14 11:09:37,SNCF,-23.60,0.00,EUR,COMPLETED,369.02
Transfer,Current,2024-12-14 11:18:08,2024-12-14 11:18:08,Savings Vault topup,-4.50,0.00,EUR,COMPLETED,364.52
Card Payment,Current,2024-12-13 12:54:22,2024-12-14 11:51:19,SuperValu,-19.63,0.00,EUR,COMPLETED,344.89
Card Payment,Current,2024-12-13 16:42:57,2024-12-14 12:15:38,Burger King,-12.10,0.00,EUR,COMPLETED,332.79
Transfer,Current,2024-12-14 12:57:23,2024-12-14 12:57:23,Savings Vault topup,-4.50,0.00,EUR,COMPLETED,328.29
Transfer,Current,2024-12-14 13:04:19,2024-12-14 13:04:19,Savings Vault topup,-2.50,0.00,EUR,COMPLETED,325.79
Card Payment,Current,2024-12-13 11:26:54,2024-12-14 13:33:39,123paris.city,-37.50,0.00,EUR,COMPLETED,288.29
Transfer,Current,2024-12-14 14:26:41,2024-12-14 14:26:41,Savings Vault topup,-5.00,0.00,EUR,COMPLETED,283.29
Transfer,Current,2024-12-14 16:17:47,2024-12-14 16:17:48,Savings Vault topup,-3.00,0.00,EUR,COMPLETED,280.29
Transfer,Current,2024-12-14 16:32:24,2024-12-14 16:32:24,Savings Vault topup,-3.50,0.00,EUR,COMPLETED,276.79
Transfer,Current,2024-12-14 17:06:13,2024-12-14 17:06:13,From Instant Access Savings,200.00,0.00,EUR,COMPLETED,476.79
Transfer,Current,2024-12-14 17:07:26,2024-12-14 17:07:26,Savings Vault topup,-5.00,0.00,EUR,COMPLETED,471.79
Transfer,Current,2024-12-14 17:19:01,2024-12-14 17:19:02,Savings Vault topup,-1.10,0.00,EUR,COMPLETED,470.69
Transfer,Current,2024-12-14 20:33:19,2024-12-14 20:33:19,Savings Vault topup,-5.00,0.00,EUR,COMPLETED,465.69
Transfer,Current,2024-12-15 10:32:19,2024-12-15 10:32:19,Savings Vault topup,-4.25,0.00,EUR,COMPLETED,461.44
Card Payment,Current,2024-12-14 09:52:22,2024-12-15 10:40:08,Le Sancerre,-35.00,0.00,EUR,COMPLETED,426.44
Card Payment,Current,2024-12-14 14:26:40,2024-12-15 10:56:21,MERCI,-6.00,0.00,EUR,COMPLETED,420.44
Transfer,Current,2024-12-15 11:28:08,2024-12-15 11:28:08,Savings Vault topup,-1.75,0.00,EUR,COMPLETED,418.69
Card Payment,Current,2024-12-14 10:54:20,2024-12-15 11:32:58,Altermundi,-75.15,0.00,EUR,COMPLETED,343.54
Card Payment,Current,2024-12-14 16:32:24,2024-12-15 11:33:19,RATP,-4.30,0.00,EUR,COMPLETED,339.24
Transfer,Current,2024-12-15 11:41:27,2024-12-15 11:41:27,Savings Vault topup,-0.50,0.00,EUR,COMPLETED,338.74
Transfer,Current,2024-12-15 11:46:33,2024-12-15 11:46:33,From Instant Access Savings,100.00,0.00,EUR,COMPLETED,438.74
Transfer,Current,2024-12-15 11:49:40,2024-12-15 11:49:40,Savings Vault topup,-2.50,0.00,EUR,COMPLETED,436.24
Card Payment,Current,2024-12-14 17:19:01,2024-12-15 12:31:24,Monoprix,-0.78,0.00,EUR,COMPLETED,435.46
Card Payment,Current,2024-12-14 12:57:23,2024-12-15 12:31:40,Carrefour,-6.10,0.00,EUR,COMPLETED,429.36
Transfer,Current,2024-12-15 13:14:49,2024-12-15 13:14:49,Savings Vault topup,-5.00,0.00,EUR,COMPLETED,424.36
Card Payment,Current,2024-12-14 13:04:19,2024-12-15 13:31:08,Bo&Mie,-14.50,0.00,EUR,COMPLETED,409.86
Transfer,Current,2024-12-15 14:11:17,2024-12-15 14:11:17,Savings Vault topup,-5.00,0.00,EUR,COMPLETED,404.86
Transfer,Current,2024-12-15 14:21:04,2024-12-15 14:21:04,From Instant Access Savings,100.00,0.00,EUR,COMPLETED,504.86
Transfer,Current,2024-12-15 14:21:30,2024-12-15 14:21:30,Savings Vault topup,-5.00,0.00,EUR,COMPLETED,499.86
Transfer,Current,2024-12-15 14:37:43,2024-12-15 14:37:43,Savings Vault topup,-0.05,0.00,EUR,COMPLETED,499.81
Transfer,Current,2024-12-15 14:57:07,2024-12-15 14:57:07,Savings Vault topup,-2.50,0.00,EUR,COMPLETED,497.31
Transfer,Current,2024-12-15 16:10:34,2024-12-15 16:10:34,From Instant Access Savings,150.00,0.00,EUR,COMPLETED,647.31
Transfer,Current,2024-12-15 16:11:06,2024-12-15 16:11:06,Savings Vault topup,-5.00,0.00,EUR,COMPLETED,642.31
Transfer,Current,2024-12-15 16:33:18,2024-12-15 16:33:18,Savings Vault topup,-5.00,0.00,EUR,COMPLETED,637.31
Transfer,Current,2024-12-15 20:12:57,2024-12-15 20:12:57,From Instant Access Savings,100.00,0.00,EUR,COMPLETED,737.31
Transfer,Current,2024-12-15 20:33:28,2024-12-15 20:33:28,Savings Vault topup,-5.00,0.00,EUR,COMPLETED,732.31
Transfer,Current,2024-12-16 09:05:32,2024-12-16 09:05:32,Savings Vault topup,-4.50,0.00,EUR,COMPLETED,727.81
Transfer,Current,2024-12-16 09:28:33,2024-12-16 09:28:33,Savings Vault topup,-1.00,0.00,EUR,COMPLETED,726.81
Card Payment,Current,2024-12-14 20:33:19,2024-12-16 10:01:18,Le Paris Halles,-40.00,0.00,EUR,COMPLETED,686.81
Card Payment,Current,2024-12-14 16:17:47,2024-12-16 10:02:01,Le Florentin,-65.40,0.00,EUR,COMPLETED,621.41
Card Payment,Current,2024-12-14 11:18:08,2024-12-16 10:14:54,Cos550,-53.10,0.00,EUR,COMPLETED,568.31
Card Payment,Current,2024-12-15 10:32:18,2024-12-16 10:35:02,RATP,-2.15,0.00,EUR,COMPLETED,566.16
Card Payment,Current,2024-12-15 11:28:08,2024-12-16 10:35:17,RATP,-8.65,0.00,EUR,COMPLETED,557.51
Card Payment,Current,2024-12-15 20:33:28,2024-12-16 10:58:38,Le Reveil,-170.00,0.00,EUR,COMPLETED,387.51
Transfer,Current,2024-12-16 11:12:56,2024-12-16 11:12:56,Savings Vault topup,-1.50,0.00,EUR,COMPLETED,386.01
Card Payment,Current,2024-12-14 17:07:25,2024-12-16 11:31:43,Bobby Second Han,-110.00,0.00,EUR,COMPLETED,276.01
Transfer,Current,2024-12-16 11:32:32,2024-12-16 11:32:32,Transfer from MARA DI RAIMONDO,8.00,0.00,EUR,COMPLETED,284.01
Transfer,Current,2024-12-16 11:32:46,2024-12-16 11:32:47,Transfer from MARA DI RAIMONDO,10.00,0.00,EUR,COMPLETED,294.01
Transfer,Current,2024-12-16 11:32:50,2024-12-16 11:32:50,Transfer from MARA DI RAIMONDO,12.75,0.00,EUR,COMPLETED,306.76
Transfer,Current,2024-12-16 11:32:53,2024-12-16 11:32:53,Transfer from MARA DI RAIMONDO,10.00,0.00,EUR,COMPLETED,316.76
Transfer,Current,2024-12-16 11:32:56,2024-12-16 11:32:56,Transfer from MARA DI RAIMONDO,27.40,0.00,EUR,COMPLETED,344.16
Transfer,Current,2024-12-16 11:32:59,2024-12-16 11:32:59,Transfer from MARA DI RAIMONDO,14.00,0.00,EUR,COMPLETED,358.16
Transfer,Current,2024-12-16 11:33:02,2024-12-16 11:33:02,Transfer from MARA DI RAIMONDO,28.60,0.00,EUR,COMPLETED,386.76
Transfer,Current,2024-12-16 11:33:05,2024-12-16 11:33:05,Transfer from MARA DI RAIMONDO,11.80,0.00,EUR,COMPLETED,398.56
Transfer,Current,2024-12-16 11:33:08,2024-12-16 11:33:08,Transfer from MARA DI RAIMONDO,25.00,0.00,EUR,COMPLETED,423.56
Card Payment,Current,2024-12-15 14:37:43,2024-12-16 11:59:13,Nike,-24.99,0.00,EUR,COMPLETED,398.57
Card Payment,Current,2024-12-15 11:41:27,2024-12-16 12:09:19,Pharmacie Cœur de Paris,-10.90,0.00,EUR,COMPLETED,387.67
Card Payment,Current,2024-12-15 14:21:30,2024-12-16 12:15:11,Citadium,-49.00,0.00,EUR,COMPLETED,338.67
Card Payment,Current,2024-12-15 14:11:17,2024-12-16 12:15:16,Citadium,-39.00,0.00,EUR,COMPLETED,299.67
Card Payment,Current,2024-12-15 11:49:40,2024-12-16 12:30:41,illy,-25.50,0.00,EUR,COMPLETED,274.17
Card Payment,Current,2024-12-15 16:33:18,2024-12-16 12:59:15,Stollys,-5.00,0.00,EUR,COMPLETED,269.17
Card Payment,Current,2024-12-15 14:57:07,2024-12-16 12:59:17,Book Nook,-18.50,0.00,EUR,COMPLETED,250.67
Card Payment,Current,2024-12-15 16:11:06,2024-12-16 12:59:31,Stollys,-9.00,0.00,EUR,COMPLETED,241.67
Transfer,Current,2024-12-16 15:05:30,2024-12-16 15:05:30,Savings Vault topup,-2.50,0.00,EUR,COMPLETED,239.17
Transfer,Current,2024-12-16 15:37:39,2024-12-16 15:37:39,Savings Vault topup,-0.75,0.00,EUR,COMPLETED,238.42
Transfer,Current,2024-12-16 20:50:32,2024-12-16 20:50:32,Savings Vault topup,-5.00,0.00,EUR,COMPLETED,233.42
Card Payment,Current,2024-12-16 09:05:32,2024-12-17 10:33:28,Le Sancerre,-33.10,0.00,EUR,COMPLETED,200.32
Card Payment,Current,2024-12-16 09:28:33,2024-12-17 11:11:11,RATP,-11.80,0.00,EUR,COMPLETED,188.52
Card Payment,Current,2024-12-16 20:50:31,2024-12-17 11:39:39,Independent.ie,-6.00,0.00,EUR,COMPLETED,182.52
Card Payment,Current,2024-12-15 13:14:49,2024-12-17 12:07:42,Galeries Lafayette,-35.00,0.00,EUR,COMPLETED,147.52
Card Payment,Current,2024-12-16 11:12:54,2024-12-17 12:25:40,Air De Paris,-10.70,0.00,EUR,COMPLETED,136.82
Card Payment,Current,2024-12-16 15:37:39,2024-12-17 12:44:07,Lidl,-33.85,0.00,EUR,COMPLETED,102.97
Card Payment,Current,2024-12-16 15:05:30,2024-12-17 13:24:06,Munkhzorig Bayanb,-40.50,0.00,EUR,COMPLETED,62.47
Transfer,Current,2024-12-18 14:38:37,2024-12-18 14:38:38,Savings Vault topup,-5.00,0.00,EUR,COMPLETED,57.47
Transfer,Current,2024-12-18 16:51:53,2024-12-18 16:51:53,Savings Vault topup,-5.00,0.00,EUR,COMPLETED,52.47
Transfer,Current,2024-12-18 17:20:07,2024-12-18 17:20:07,From Instant Access Savings,100.00,0.00,EUR,COMPLETED,152.47
Transfer,Current,2024-12-18 17:21:04,2024-12-18 17:21:04,Savings Vault topup,-5.00,0.00,EUR,COMPLETED,147.47
Transfer,Current,2024-12-18 18:30:42,2024-12-18 18:30:42,Savings Vault topup,-4.85,0.00,EUR,COMPLETED,142.62
Transfer,Current,2024-12-19 08:24:36,2024-12-19 08:24:36,Savings Vault topup,-2.50,0.00,EUR,COMPLETED,140.12
Card Payment,Current,2024-12-18 14:38:37,2024-12-19 08:52:58,Circle K Gas Station,-9.00,0.00,EUR,COMPLETED,131.12
Card Payment,Current,2024-12-18 16:51:53,2024-12-19 10:19:58,Cut and Sew,-32.00,0.00,EUR,COMPLETED,99.12
Card Payment,Current,2024-12-18 17:21:04,2024-12-19 10:47:06,Marks & Spencer,-42.00,0.00,EUR,COMPLETED,57.12
Card Payment,Current,2024-12-18 18:30:42,2024-12-19 11:30:28,Deliveroo,-21.03,0.00,EUR,COMPLETED,36.09
Transfer,Current,2024-12-19 13:14:32,2024-12-19 13:14:32,From Instant Access Savings,100.00,0.00,EUR,COMPLETED,136.09
Transfer,Current,2024-12-19 13:15:09,2024-12-19 13:15:09,Transfer to MARA DI RAIMONDO,-42.25,0.00,EUR,COMPLETED,93.84
Transfer,Current,2024-12-19 13:35:47,2024-12-19 13:35:47,Savings Vault topup,-0.05,0.00,EUR,COMPLETED,93.79
Transfer,Current,2024-12-19 16:31:33,2024-12-19 16:31:33,Savings Vault topup,-5.00,0.00,EUR,COMPLETED,88.79
Transfer,Current,2024-12-19 18:46:03,2024-12-19 18:46:03,Savings Vault topup,-3.65,0.00,EUR,COMPLETED,85.14
Transfer,Current,2024-12-19 21:34:30,2024-12-19 21:34:30,Savings Vault topup,-0.80,0.00,EUR,COMPLETED,84.34
Card Payment,Current,2024-12-19 18:46:02,2024-12-20 09:16:21,Deliveroo,-22.27,0.00,EUR,COMPLETED,62.07
Card Payment,Current,2024-12-19 16:31:33,2024-12-20 09:29:20,Sparadise,-8.00,0.00,EUR,COMPLETED,54.07
Transfer,Current,2024-12-20 10:16:18,2024-12-20 10:16:18,Pocket Withdrawal,100.00,0.00,EUR,COMPLETED,154.07
Transfer,Current,2024-12-20 10:16:26,2024-12-20 10:16:26,From Instant Access Savings,1000.00,0.00,EUR,COMPLETED,1154.07
Exchange,Current,2024-12-20 10:16:44,2024-12-20 10:16:44,Exchanged to AED,-1000.00,0.00,EUR,COMPLETED,154.07
Card Payment,Current,2024-12-19 08:24:36,2024-12-20 10:34:53,Copper + Straw,-9.50,0.00,EUR,COMPLETED,144.57
Transfer,Current,2024-12-20 11:27:54,2024-12-20 11:27:54,Savings Vault topup,-5.00,0.00,EUR,COMPLETED,139.57
Transfer,Current,2024-12-20 12:03:06,2024-12-20 12:03:07,Savings Vault topup,-2.50,0.00,EUR,COMPLETED,137.07
Topup,Current,2024-12-20 12:21:55,2024-12-20 12:21:56,Payment from VHI CLAIMS,75.00,0.00,EUR,COMPLETED,212.07
Transfer,Current,2024-12-20 12:32:19,2024-12-20 12:32:19,Savings Vault topup,-0.50,0.00,EUR,COMPLETED,211.57
Card Payment,Current,2024-12-19 21:34:30,2024-12-20 15:07:12,Airalo,-14.84,0.00,EUR,COMPLETED,196.73
Transfer,Current,2024-12-20 15:08:58,2024-12-20 15:08:58,Savings Vault topup,-2.10,0.00,EUR,COMPLETED,194.63
Transfer,Current,2024-12-20 15:16:48,2024-12-20 15:16:48,Savings Vault topup,-3.00,0.00,EUR,COMPLETED,191.63
Card Payment,Current,2024-12-19 13:35:46,2024-12-20 16:37:09,Centra,-8.99,0.00,EUR,COMPLETED,182.64
Transfer,Current,2024-12-20 17:39:47,2024-12-20 17:39:47,Savings Vault topup,-0.10,0.00,EUR,COMPLETED,182.54
Transfer,Current,2024-12-20 19:02:44,2024-12-20 19:02:44,Savings Vault topup,-2.55,0.00,EUR,COMPLETED,179.99
Transfer,Current,2024-12-20 19:45:53,2024-12-20 19:45:53,Savings Vault topup,-3.30,0.00,EUR,COMPLETED,176.69
Transfer,Current,2024-12-20 19:52:21,2024-12-20 19:52:22,Savings Vault topup,-0.45,0.00,EUR,COMPLETED,176.24
Card Payment,Current,2024-12-20 12:03:06,2024-12-21 08:35:24,FREE NOW,-44.50,0.00,EUR,COMPLETED,131.74
Card Payment,Current,2024-12-20 11:27:53,2024-12-21 11:11:29,Marqette,-13.00,0.00,EUR,COMPLETED,118.74
Card Payment,Current,2024-12-20 12:32:19,2024-12-21 11:20:02,Butlers Chocolates,-4.90,0.00,EUR,COMPLETED,113.84
Card Payment,Current,2024-12-20 19:45:53,2024-12-21 12:54:34,Boots,-9.34,0.00,EUR,COMPLETED,104.50
Card Payment,Current,2024-12-20 19:02:43,2024-12-21 15:24:37,J D Wetherspoon,-20.49,0.00,EUR,COMPLETED,84.01
Card Payment,Current,2024-12-20 17:39:46,2024-12-21 15:31:17,J D Wetherspoon,-8.98,0.00,EUR,COMPLETED,75.03
Card Payment,Current,2024-12-20 19:52:21,2024-12-21 15:32:49,Pret A Manger,-4.91,0.00,EUR,COMPLETED,70.12
Card Payment,Current,2024-12-20 15:08:57,2024-12-21 15:32:51,Pret A Manger,-5.58,0.00,EUR,COMPLETED,64.54
Transfer,Current,2024-12-22 08:21:17,2024-12-22 08:21:17,Transfer from PATRICK JOHN BYRNE,16.00,0.00,EUR,COMPLETED,80.54
Transfer,Current,2024-12-22 09:49:38,2024-12-22 09:49:38,Transfer to DAVID KEVIN SMYTH,-16.00,0.00,EUR,COMPLETED,64.54
Transfer,Current,2024-12-22 09:51:34,2024-12-22 09:51:34,Transfer to DAVID KEVIN SMYTH,-20.00,0.00,EUR,COMPLETED,44.54
Transfer,Current,2024-12-22 10:55:26,2024-12-22 10:55:26,Savings Vault topup,-0.05,0.00,EUR,COMPLETED,44.49
Card Payment,Current,2024-12-20 15:16:48,2024-12-22 12:56:10,Caffè Nero,-11.40,0.00,EUR,COMPLETED,33.09
Topup,Current,2024-12-23 08:06:58,2024-12-23 08:06:58,Payment from WORKDAY LIMITED,1452.61,0.00,EUR,COMPLETED,1485.70
Transfer,Current,2024-12-23 08:08:17,2024-12-23 08:08:17,To pocket EUR Subscriptions from EUR,-400.00,0.00,EUR,COMPLETED,1085.70
Transfer,Current,2024-12-23 00:00:00,2024-12-23 11:46:48,To eFlow,-3.53,0.00,EUR,COMPLETED,1082.17
Card Payment,Current,2024-12-22 10:55:26,2024-12-23 16:17:35,The Washington Post,-0.99,0.00,EUR,COMPLETED,1081.18
Topup,Current,2024-12-23 20:20:19,2024-12-23 20:20:20,Payment from PATRICIA        QUISH,50.00,0.00,EUR,COMPLETED,1131.18
Transfer,Current,2024-12-24 18:55:39,2024-12-24 18:55:39,Savings Vault topup,-2.50,0.00,EUR,COMPLETED,1128.68
Transfer,Current,2024-12-25 07:26:43,2024-12-25 07:26:43,From Instant Access Savings,1000.00,0.00,EUR,COMPLETED,2128.68
Exchange,Current,2024-12-25 09:34:21,2024-12-25 09:34:21,Exchanged to AED,-131.55,0.00,EUR,COMPLETED,1997.13
Card Payment,Current,2024-12-24 18:55:39,2024-12-25 13:15:55,Amazon,-11.50,0.00,EUR,COMPLETED,1985.63
Transfer,Current,2024-12-26 08:55:57,2024-12-26 08:55:58,From Instant Access Savings,250.00,0.00,EUR,COMPLETED,2235.63
Exchange,Current,2024-12-26 08:56:15,2024-12-26 08:56:15,Exchanged to AED,-263.54,0.00,EUR,COMPLETED,1972.09
Transfer,Current,2024-12-26 13:20:51,2024-12-26 13:20:51,Savings Vault topup,-5.00,0.00,EUR,COMPLETED,1967.09
Transfer,Current,2024-12-26 13:36:19,2024-12-26 13:36:19,From Instant Access Savings,200.00,0.00,EUR,COMPLETED,2167.09
Transfer,Current,2024-12-26 13:37:54,2024-12-26 13:37:54,Transfer to PATRICIA QUISH,-200.00,0.00,EUR,COMPLETED,1967.09
Transfer,Current,2024-12-25 07:26:57,2024-12-27 01:57:15,To Finance Ireland,-1424.50,0.00,EUR,COMPLETED,542.59
Transfer,Current,2024-12-25 07:22:15,2024-12-27 01:57:37,To Trading 212 UK Limited,-500.00,0.00,EUR,COMPLETED,42.59
Card Payment,Current,2024-12-26 13:20:51,2024-12-27 10:41:34,The Irish Times,-1.00,0.00,EUR,COMPLETED,41.59
Topup,Current,2024-12-27 10:45:18,2024-12-27 10:45:19,Payment from PATRICIA        QUISH,200.00,0.00,EUR,COMPLETED,241.59
Exchange,Current,2024-12-27 16:09:08,2024-12-27 16:09:08,Exchanged to AED,-100.00,0.00,EUR,COMPLETED,141.59
Transfer,Current,2024-12-27 17:36:22,2024-12-27 17:36:22,Transfer to Martin Clancy,-30.00,0.00,EUR,COMPLETED,111.59
Transfer,Current,2024-12-29 09:22:41,2024-12-29 09:22:41,Savings Vault topup,-2.50,0.00,EUR,COMPLETED,109.09
Transfer,Current,2024-12-29 11:39:13,2024-12-29 11:39:14,Transfer to SOPHIE MARY QUISH,-25.00,0.00,EUR,COMPLETED,84.09
Transfer,Current,2024-12-29 14:45:19,2024-12-29 14:45:19,Savings Vault topup,-1.80,0.00,EUR,COMPLETED,82.29
Card Payment,Current,2024-12-29 14:45:19,2024-12-30 10:44:53,SuperValu,-10.64,0.00,EUR,COMPLETED,71.65
Card Payment,Current,2024-12-29 09:22:41,2024-12-30 10:49:23,Lidl,-49.50,0.00,EUR,COMPLETED,22.15
Transfer,Current,2024-12-30 11:45:47,2024-12-30 11:45:47,Pocket Withdrawal,50.00,0.00,EUR,COMPLETED,72.15
Exchange,Current,2024-12-30 14:57:02,2024-12-30 14:57:02,Exchanged to EUR,67.27,0.00,EUR,COMPLETED,139.42
Transfer,Current,2024-12-30 14:57:19,2024-12-30 14:57:19,Savings Vault topup,-5.00,0.00,EUR,COMPLETED,134.42
Transfer,Current,2024-12-30 15:07:26,2024-12-30 15:07:26,From Instant Access Savings,200.00,0.00,EUR,COMPLETED,334.42
Transfer,Current,2024-12-30 15:07:33,2024-12-30 15:07:33,Savings Vault topup,-1.75,0.00,EUR,COMPLETED,332.67
Transfer,Current,2024-12-30 16:23:16,2024-12-30 16:23:16,Savings Vault topup,-0.05,0.00,EUR,COMPLETED,332.62
Card Payment,Current,2024-12-30 16:23:16,2024-12-31 09:53:21,SPAR Food & Fuel,-5.99,0.00,EUR,COMPLETED,326.63
Card Payment,Current,2024-12-30 14:57:19,2024-12-31 10:11:00,Www.footfocus.ie,-70.00,0.00,EUR,COMPLETED,256.63
Transfer,Current,2024-12-31 14:55:17,2024-12-31 14:55:17,Transfer to MARA DI RAIMONDO,-22.50,0.00,EUR,COMPLETED,234.13
Transfer,Current,2024-12-31 15:17:26,2024-12-31 15:17:26,From Instant Access Savings,100.00,0.00,EUR,COMPLETED,334.13
Transfer,Current,2024-12-31 15:17:35,2024-12-31 15:17:35,Savings Vault topup,-0.70,0.00,EUR,COMPLETED,333.43
Transfer,Current,2024-12-31 15:28:40,2024-12-31 15:28:44,To Payward Ireland Ltd.,-100.00,0.00,EUR,COMPLETED,233.43
Transfer,Current,2024-12-31 16:50:25,2024-12-31 16:50:25,From Instant Access Savings,100.00,0.00,EUR,COMPLETED,333.43
Transfer,Current,2024-12-31 16:51:20,2024-12-31 16:51:20,Savings Vault topup,-3.75,0.00,EUR,COMPLETED,329.68
Card Payment,Current,2024-12-30 15:07:32,2024-12-31 17:08:58,Zurich Insurance,-149.65,0.00,EUR,COMPLETED,180.03
Transfer,Current,2024-12-31 17:34:25,2024-12-31 17:34:25,Savings Vault topup,-5.00,0.00,EUR,COMPLETED,175.03
Transfer,Current,2024-12-31 18:17:02,2024-12-31 18:17:02,Savings Vault topup,-1.10,0.00,EUR,COMPLETED,173.93
Transfer,Current,2025-01-01 07:17:11,2025-01-01 07:17:11,Savings Vault topup,-2.55,0.00,EUR,COMPLETED,171.38
Card Payment,Current,2024-12-31 15:17:35,2025-01-01 09:48:32,Applegreen,-76.86,0.00,EUR,COMPLETED,94.52
Card Payment,Current,2024-12-31 18:17:01,2025-01-01 10:23:15,Tesco,-13.78,0.00,EUR,COMPLETED,80.74
Card Payment,Current,2024-12-31 16:51:19,2025-01-01 12:08:23,Cloud Picker Cafe,-6.25,0.00,EUR,COMPLETED,74.49
Transfer,Current,2025-01-01 15:21:19,2025-01-01 15:21:19,Savings Vault topup,-4.25,0.00,EUR,COMPLETED,70.24
Transfer,Current,2025-01-01 17:14:02,2025-01-01 17:14:02,Savings Vault topup,-0.80,0.00,EUR,COMPLETED,69.44
Card Payment,Current,2024-12-31 17:34:25,2025-01-02 09:54:10,Dublin Airport Car Park,-3.00,0.00,EUR,COMPLETED,66.44
Card Payment,Current,2025-01-01 17:14:01,2025-01-02 10:00:27,Deliveroo,-39.84,0.00,EUR,COMPLETED,26.60
Card Payment,Current,2025-01-01 07:17:11,2025-01-02 10:24:42,HP,-1.49,0.00,EUR,COMPLETED,25.11
Card Payment,Current,2025-01-01 15:21:19,2025-01-02 11:09:21,Gleesons,-8.15,0.00,EUR,COMPLETED,16.96
Transfer,Current,2025-01-02 11:47:53,2025-01-02 11:47:54,Savings Vault topup,-0.55,0.00,EUR,COMPLETED,16.41
Transfer,Current,2025-01-02 19:25:24,2025-01-02 19:25:24,From Instant Access Savings,100.00,0.00,EUR,COMPLETED,116.41
Transfer,Current,2025-01-02 19:26:17,2025-01-02 19:26:17,Savings Vault topup,-2.55,0.00,EUR,COMPLETED,113.86
Transfer,Current,2025-01-02 19:40:24,2025-01-02 19:40:24,Savings Vault topup,-0.50,0.00,EUR,COMPLETED,113.36
Card Payment,Current,2025-01-02 19:26:16,2025-01-03 10:14:25,Apple,-19.49,0.00,EUR,COMPLETED,93.87
Card Payment,Current,2025-01-02 19:40:24,2025-01-03 11:30:28,Movies@,-30.90,0.00,EUR,COMPLETED,62.97
Card Payment,Current,2025-01-02 11:47:53,2025-01-03 12:54:38,Amazon,-10.89,0.00,EUR,COMPLETED,52.08
Transfer,Current,2025-01-03 18:07:51,2025-01-03 18:07:51,Savings Vault topup,-3.60,0.00,EUR,COMPLETED,48.48
Transfer,Current,2025-01-04 02:53:32,2025-01-04 02:53:33,Savings Vault topup,-0.05,0.00,EUR,COMPLETED,48.43
Transfer,Current,2025-01-04 10:21:24,2025-01-04 10:21:24,Savings Vault topup,-0.05,0.00,EUR,COMPLETED,48.38
Card Payment,Current,2025-01-03 18:07:51,2025-01-04 12:59:47,SuperValu,-26.28,0.00,EUR,COMPLETED,22.10
Transfer,Current,2025-01-04 18:14:27,2025-01-04 18:14:27,From Instant Access Savings,100.00,0.00,EUR,COMPLETED,122.10
Transfer,Current,2025-01-04 18:15:42,2025-01-04 18:15:42,Savings Vault topup,-0.50,0.00,EUR,COMPLETED,121.60
Transfer,Current,2025-01-04 18:51:43,2025-01-04 18:51:43,Savings Vault topup,-1.50,0.00,EUR,COMPLETED,120.10
Card Payment,Current,2025-01-04 18:15:42,2025-01-05 09:24:46,Butlers Chocolates,-4.90,0.00,EUR,COMPLETED,115.20
Card Payment,Current,2025-01-04 02:53:32,2025-01-05 10:13:23,Apple,-2.99,0.00,EUR,COMPLETED,112.21
Transfer,Current,2025-01-05 12:25:14,2025-01-05 12:25:14,Savings Vault topup,-5.00,0.00,EUR,COMPLETED,107.21
Transfer,Current,2025-01-05 12:57:23,2025-01-05 12:57:23,Savings Vault topup,-0.20,0.00,EUR,COMPLETED,107.01
Transfer,Current,2025-01-05 13:08:02,2025-01-05 13:08:02,Savings Vault topup,-3.50,0.00,EUR,COMPLETED,103.51
Transfer,Current,2025-01-05 13:18:10,2025-01-05 13:18:10,Transfer from MARA DI RAIMONDO,13.78,0.00,EUR,COMPLETED,117.29
Transfer,Current,2025-01-05 13:18:14,2025-01-05 13:18:14,Transfer from MARA DI RAIMONDO,17.00,0.00,EUR,COMPLETED,134.29
Transfer,Current,2025-01-05 13:45:52,2025-01-05 13:45:52,Transfer from MARA DI RAIMONDO,18.65,0.00,EUR,COMPLETED,152.94
Transfer,Current,2025-01-05 14:39:35,2025-01-05 14:39:35,Savings Vault topup,-4.00,0.00,EUR,COMPLETED,148.94
Transfer,Current,2025-01-05 15:20:51,2025-01-05 15:20:51,Transfer to Revolut user,-60.00,0.00,EUR,COMPLETED,88.94
Transfer,Current,2025-01-05 17:37:37,2025-01-05 17:37:37,Savings Vault topup,-5.00,0.00,EUR,COMPLETED,83.94
Card Payment,Current,2025-01-05 14:39:35,2025-01-06 09:49:58,Hatch Coffee,-9.20,0.00,EUR,COMPLETED,74.74
Card Payment,Current,2025-01-05 12:25:14,2025-01-06 10:52:03,Ard Services,-1.00,0.00,EUR,COMPLETED,73.74
Card Payment,Current,2025-01-04 18:51:43,2025-01-06 11:24:05,Dundrum Car Parking,-6.70,0.00,EUR,COMPLETED,67.04
Card Payment,Current,2025-01-05 12:57:23,2025-01-06 11:32:50,Boots,-10.96,0.00,EUR,COMPLETED,56.08
Card Payment,Current,2025-01-05 17:37:37,2025-01-06 11:35:16,Stillorgan Plaza Car Park,-1.00,0.00,EUR,COMPLETED,55.08
Transfer,Current,2025-01-06 15:01:33,2025-01-06 15:01:33,From Instant Access Savings,500.00,0.00,EUR,COMPLETED,555.08
Transfer,Current,2025-01-06 15:03:52,2025-01-06 15:03:52,Savings Vault topup,-2.50,0.00,EUR,COMPLETED,552.58
Transfer,Current,2025-01-06 15:01:56,2025-01-07 01:54:59,To Colm Quish,-269.51,0.00,EUR,COMPLETED,283.07
Card Payment,Current,2025-01-06 15:03:52,2025-01-07 08:40:07,Stubble &,-175.50,0.00,EUR,COMPLETED,107.57
Card Payment,Current,2025-01-05 13:08:02,2025-01-07 09:10:05,Gibney's Of Malahide,-37.30,0.00,EUR,COMPLETED,70.27
TAX,Current,2025-01-07 09:35:26,2025-01-07 09:35:26,Irish Stamp Duty,-0.12,0.00,EUR,COMPLETED,70.15
Card Payment,Current,2025-01-04 10:21:23,2025-01-07 13:53:09,YouTube,-13.99,0.00,EUR,COMPLETED,56.16
Transfer,Current,2025-01-08 07:56:37,2025-01-08 07:56:37,Savings Vault topup,-4.60,0.00,EUR,COMPLETED,51.56
Topup,Current,2025-01-08 12:23:17,2025-01-08 12:23:18,Payment from VHI CLAIMS,35.00,0.00,EUR,COMPLETED,86.56
Transfer,Current,2025-01-08 15:20:06,2025-01-08 15:20:06,Transfer from MARA DI RAIMONDO,170.00,0.00,EUR,COMPLETED,256.56
Card Payment,Current,2025-01-08 07:56:37,2025-01-09 12:41:51,Amazon,-37.08,0.00,EUR,COMPLETED,219.48
Transfer,Current,2025-01-09 14:14:19,2025-01-09 14:14:19,Savings Vault topup,-0.20,0.00,EUR,COMPLETED,219.28
Transfer,Current,2025-01-09 17:39:35,2025-01-09 17:39:36,Transfer to MARA DI RAIMONDO,-15.00,0.00,EUR,COMPLETED,204.28
Card Payment,Current,2025-01-09 14:14:18,2025-01-10 11:50:39,Easytrip,-15.96,0.00,EUR,COMPLETED,188.32
Transfer,Current,2025-01-10 18:55:16,2025-01-10 18:55:16,Savings Vault topup,-5.00,0.00,EUR,COMPLETED,183.32
Transfer,Current,2025-01-11 10:34:15,2025-01-11 10:34:15,Savings Vault topup,-0.50,0.00,EUR,COMPLETED,182.82
Transfer,Current,2025-01-11 13:44:44,2025-01-11 13:44:44,Savings Vault topup,-5.00,0.00,EUR,COMPLETED,177.82
Transfer,Current,2025-01-11 13:47:47,2025-01-11 13:47:47,Savings Vault topup,-2.50,0.00,EUR,COMPLETED,175.32
Transfer,Current,2025-01-11 13:51:34,2025-01-11 13:51:34,Savings Vault topup,-5.00,0.00,EUR,COMPLETED,170.32
Transfer,Current,2025-01-11 15:29:10,2025-01-11 15:29:10,Savings Vault topup,-3.50,0.00,EUR,COMPLETED,166.82
Transfer,Current,2025-01-11 16:11:49,2025-01-11 16:11:49,From Instant Access Savings,140.00,0.00,EUR,COMPLETED,306.82
Transfer,Current,2025-01-11 16:15:22,2025-01-11 16:15:22,Savings Vault topup,-0.10,0.00,EUR,COMPLETED,306.72
Transfer,Current,2025-01-11 16:27:34,2025-01-11 16:27:34,Savings Vault topup,-5.00,0.00,EUR,COMPLETED,301.72
Card Payment,Current,2025-01-11 16:27:33,2025-01-12 09:22:13,LSS Ireland Limited,-28.00,0.00,EUR,COMPLETED,273.72
Card Payment,Current,2025-01-11 16:15:22,2025-01-12 09:29:29,Dublin Dundrum Centre,-79.98,0.00,EUR,COMPLETED,193.74
Card Payment,Current,2025-01-11 15:29:10,2025-01-12 09:55:28,Umai,-19.30,0.00,EUR,COMPLETED,174.44
Card Payment,Current,2025-01-10 18:55:16,2025-01-12 14:44:07,The Merry Cobbler,-70.00,0.00,EUR,COMPLETED,104.44
Card Payment,Current,2025-01-11 13:44:43,2025-01-12 14:53:55,APCOA Parking,-3.00,0.00,EUR,COMPLETED,101.44
Card Payment,Current,2025-01-11 13:51:33,2025-01-13 09:46:20,Mint,-2.00,0.00,EUR,COMPLETED,99.44
Card Payment,Current,2025-01-11 13:47:46,2025-01-13 09:47:25,Mint,-8.50,0.00,EUR,COMPLETED,90.94
Card Payment,Current,2025-01-11 10:34:15,2025-01-13 14:45:58,Hole In The Wall,-3.90,0.00,EUR,COMPLETED,87.04
Transfer,Current,2025-01-14 21:07:37,2025-01-14 21:07:37,Savings Vault topup,-4.35,0.00,EUR,COMPLETED,82.69
Transfer,Current,2025-01-14 22:49:14,2025-01-14 22:49:14,Savings Vault topup,-2.70,0.00,EUR,COMPLETED,79.99
Card Payment,Current,2025-01-14 21:07:37,2025-01-15 14:10:34,BLACK SWAN,-16.13,0.00,EUR,COMPLETED,63.86
Card Payment,Current,2025-01-14 22:49:14,2025-01-15 14:10:35,BLACK SWAN,-15.46,0.00,EUR,COMPLETED,48.40
Transfer,Current,2025-01-15 20:01:21,2025-01-15 20:01:21,From Instant Access Savings,100.00,0.00,EUR,COMPLETED,148.40
Transfer,Current,2025-01-15 20:01:58,2025-01-15 20:01:58,Savings Vault topup,-1.90,0.00,EUR,COMPLETED,146.50
Transfer,Current,2025-01-16 08:34:12,2025-01-16 08:34:12,Savings Vault topup,-3.30,0.00,EUR,COMPLETED,143.20
Card Payment,Current,2025-01-15 20:01:57,2025-01-16 10:42:52,Eventmaster,-83.62,0.00,EUR,COMPLETED,59.58
Transfer,Current,2025-01-16 18:38:12,2025-01-16 18:38:12,Pocket Withdrawal,140.00,0.00,EUR,COMPLETED,199.58
Transfer,Current,2025-01-16 18:38:37,2025-01-16 18:38:37,Pocket Withdrawal,25.00,0.00,EUR,COMPLETED,224.58
Transfer,Current,2025-01-16 18:38:52,2025-01-16 18:38:52,Savings Vault topup,-4.00,0.00,EUR,COMPLETED,220.58
Card Payment,Current,2025-01-16 08:34:11,2025-01-17 16:08:48,Amazon,-24.34,0.00,EUR,COMPLETED,196.24
Transfer,Current,2025-01-17 17:40:14,2025-01-17 17:40:14,From Instant Access Savings,150.00,0.00,EUR,COMPLETED,346.24
Transfer,Current,2025-01-17 17:40:17,2025-01-17 17:40:18,Transfer to MARA DI RAIMONDO,-5.12,0.00,EUR,COMPLETED,341.12
Transfer,Current,2025-01-17 17:41:17,2025-01-17 17:41:17,Transfer to Revolut user,-5.00,0.00,EUR,COMPLETED,336.12
Transfer,Current,2025-01-17 19:02:12,2025-01-17 19:02:13,Savings Vault topup,-0.50,0.00,EUR,COMPLETED,335.62
Card Payment,Current,2025-01-16 20:50:22,2025-01-17 19:32:05,Independent.ie,-6.00,0.00,EUR,COMPLETED,329.62
Card Payment,Current,2025-01-16 18:38:52,2025-01-18 14:56:59,Ticketmaster,-186.20,0.00,EUR,COMPLETED,143.42
Transfer,Current,2025-01-18 17:13:23,2025-01-18 17:13:23,Savings Vault topup,-5.00,0.00,EUR,COMPLETED,138.42
Transfer,Current,2025-01-18 18:00:19,2025-01-18 18:00:19,Savings Vault topup,-2.50,0.00,EUR,COMPLETED,135.92
Transfer,Current,2025-01-18 20:31:51,2025-01-18 20:31:51,Savings Vault topup,-4.00,0.00,EUR,COMPLETED,131.92
Transfer,Current,2025-01-19 10:55:18,2025-01-19 10:55:18,Savings Vault topup,-0.05,0.00,EUR,COMPLETED,131.87
Card Payment,Current,2025-01-17 19:02:12,2025-01-19 10:55:52,Sheehans Pub,-20.90,0.00,EUR,COMPLETED,110.97
Card Payment,Current,2025-01-18 20:31:50,2025-01-19 12:41:10,Jerry And Mary Ry,-11.20,0.00,EUR,COMPLETED,99.77
Transfer,Current,2025-01-19 13:58:35,2025-01-19 13:58:35,From Instant Access Savings,650.00,0.00,EUR,COMPLETED,749.77
Transfer,Current,2025-01-19 13:59:04,2025-01-19 13:59:04,Savings Vault topup,-1.70,0.00,EUR,COMPLETED,748.07
Transfer,Current,2025-01-19 17:28:10,2025-01-19 17:28:10,Savings Vault topup,-0.15,0.00,EUR,COMPLETED,747.92
Transfer,Current,2025-01-19 17:40:07,2025-01-19 17:40:07,Savings Vault topup,-3.25,0.00,EUR,COMPLETED,744.67
Transfer,Current,2025-01-19 18:51:21,2025-01-19 18:51:21,Transfer from MARA DI RAIMONDO,60.70,0.00,EUR,COMPLETED,805.37
Transfer,Current,2025-01-19 18:51:33,2025-01-19 18:51:33,Savings Vault topup,-0.65,0.00,EUR,COMPLETED,804.72
Transfer,Current,2025-01-19 18:52:37,2025-01-19 18:52:38,Transfer from MARA DI RAIMONDO,0.78,0.00,EUR,COMPLETED,805.50
Transfer,Current,2025-01-19 22:24:24,2025-01-19 22:24:24,Savings Vault topup,-2.00,0.00,EUR,COMPLETED,803.50
Card Payment,Current,2025-01-19 13:59:04,2025-01-20 09:52:15,Booking.com,-520.66,0.00,EUR,COMPLETED,282.84
Card Payment,Current,2025-01-19 17:40:07,2025-01-20 09:53:52,Tesco,-5.35,0.00,EUR,COMPLETED,277.49
Card Payment,Current,2025-01-18 18:00:19,2025-01-20 11:39:47,The Hurlers Bar,-14.50,0.00,EUR,COMPLETED,262.99
Card Payment,Current,2025-01-18 17:13:23,2025-01-20 11:39:54,The Hurlers Bar,-24.00,0.00,EUR,COMPLETED,238.99
Card Payment,Current,2025-01-19 17:28:10,2025-01-20 12:21:47,Lidl,-47.97,0.00,EUR,COMPLETED,191.02
Card Payment,Current,2025-01-19 22:24:24,2025-01-20 13:54:59,Amazon,-14.60,0.15,EUR,COMPLETED,176.27
Card Payment,Current,2025-01-19 18:51:32,2025-01-20 14:28:39,Amazon,-60.87,0.61,EUR,COMPLETED,114.79
Card Payment,Current,2025-01-19 10:55:17,2025-01-20 15:05:04,The Washington Post,-0.99,0.00,EUR,COMPLETED,113.80
Transfer,Current,2025-01-21 08:35:37,2025-01-21 08:35:37,Savings Vault topup,-3.70,0.00,EUR,COMPLETED,110.10
Transfer,Current,2025-01-21 16:19:31,2025-01-21 16:19:31,From Instant Access Savings,400.00,0.00,EUR,COMPLETED,510.10
Transfer,Current,2025-01-21 16:19:47,2025-01-21 16:19:47,Savings Vault topup,-1.50,0.00,EUR,COMPLETED,508.60
Card Payment,Current,2025-01-21 08:35:37,2025-01-22 10:45:31,SuperValu,-20.26,0.00,EUR,COMPLETED,488.34
Transfer,Current,2025-01-22 00:00:00,2025-01-22 11:45:14,To eFlow,-7.93,0.00,EUR,COMPLETED,480.41
Card Refund,Current,2025-01-22 00:00:00,2025-01-22 12:35:03,Booking.com,113.21,0.00,EUR,COMPLETED,593.62
Transfer,Current,2025-01-22 16:32:24,2025-01-22 16:32:24,From Instant Access Savings,500.00,0.00,EUR,COMPLETED,1093.62
Transfer,Current,2025-01-22 16:32:39,2025-01-23 01:56:18,To Trading 212 UK Limited,-500.00,0.00,EUR,COMPLETED,593.62
Transfer,Current,2025-01-23 09:10:28,2025-01-23 09:10:28,Savings Vault topup,-0.50,0.00,EUR,COMPLETED,593.12
Card Payment,Current,2025-01-22 12:27:40,2025-01-23 16:05:01,Centra,-6.75,0.00,EUR,COMPLETED,586.37
Card Payment,Current,2025-01-22 07:57:09,2025-01-23 16:16:14,Transport for Ireland - TFI,-40.00,0.00,EUR,COMPLETED,546.37
Transfer,Current,2025-01-23 17:21:55,2025-01-23 17:21:55,Transfer from MARA DI RAIMONDO,16.16,0.00,EUR,COMPLETED,562.53
Transfer,Current,2025-01-23 17:22:15,2025-01-23 17:22:15,Savings Vault topup,-3.25,0.00,EUR,COMPLETED,559.28
Topup,Current,2025-01-24 06:27:17,2025-01-24 06:27:18,Payment from WORKDAY LIMITED,3204.97,0.00,EUR,COMPLETED,3764.25
Transfer,Current,2025-01-24 06:27:18,2025-01-24 06:27:18,To Instant Access Savings,-275.00,0.00,EUR,COMPLETED,3489.25
Transfer,Current,2025-01-24 09:20:56,2025-01-24 09:20:56,Savings Vault topup,-1000.00,0.00,EUR,COMPLETED,2489.25
Card Payment,Current,2025-01-23 09:10:27,2025-01-24 09:37:12,The Rise Pharmacy,-31.90,0.00,EUR,COMPLETED,2457.35
Card Payment,Current,2025-01-23 17:22:15,2025-01-24 09:45:43,Deliveroo,-40.35,0.00,EUR,COMPLETED,2417.00
Card Payment,Current,2025-01-21 16:19:47,2025-01-24 11:18:19,KLM Royal Dutch Airlines,-216.35,0.00,EUR,COMPLETED,2200.65
Card Payment,Current,2025-01-21 00:00:00,2025-01-24 11:18:21,KLM Royal Dutch Airlines,-216.35,0.00,EUR,COMPLETED,1984.30
Transfer,Current,2025-01-24 11:18:21,2025-01-24 11:18:21,Savings Vault topup,-3.25,0.00,EUR,COMPLETED,1981.05
Transfer,Current,2025-01-24 11:56:46,2025-01-24 11:56:46,Savings Vault topup,-2.55,0.00,EUR,COMPLETED,1978.50
Transfer,Current,2025-01-24 12:55:59,2025-01-24 12:55:59,Transfer from MARA DI RAIMONDO,550.00,0.00,EUR,COMPLETED,2528.50
Transfer,Current,2025-01-24 12:56:53,2025-01-24 12:56:53,Savings Vault topup,-550.00,0.00,EUR,COMPLETED,1978.50
Transfer,Current,2025-01-24 12:56:36,2025-01-24 13:51:15,To Colm Quish,-71.16,0.00,EUR,COMPLETED,1907.34
Transfer,Current,2025-01-24 16:33:12,2025-01-24 16:33:12,Savings Vault topup,-2.15,0.00,EUR,COMPLETED,1905.19
Transfer,Current,2025-01-24 18:33:21,2025-01-24 18:33:21,From Instant Access Savings,364.00,0.00,EUR,COMPLETED,2269.19
Transfer,Current,2025-01-24 18:53:41,2025-01-24 18:53:41,Savings Vault topup,-3.30,0.00,EUR,COMPLETED,2265.89
Transfer,Current,2025-01-25 08:56:38,2025-01-25 08:56:38,From Instant Access Savings,500.00,0.00,EUR,COMPLETED,2765.89
Card Payment,Current,2025-01-24 11:56:46,2025-01-25 09:55:01,SuperValu,-30.49,0.00,EUR,COMPLETED,2735.40
Transfer,Current,2025-01-25 10:16:09,2025-01-25 10:16:09,To pocket EUR Subscriptions from EUR,-400.00,0.00,EUR,COMPLETED,2335.40
Card Payment,Current,2025-01-24 18:53:41,2025-01-25 12:47:52,Amazon,-11.34,0.00,EUR,COMPLETED,2324.06
Card Payment,Current,2025-01-24 16:33:12,2025-01-25 12:48:15,Amazon,-85.57,0.00,EUR,COMPLETED,2238.49
Transfer,Current,2025-01-25 16:57:33,2025-01-25 16:57:33,Savings Vault topup,-1.50,0.00,EUR,COMPLETED,2236.99
Transfer,Current,2025-01-26 09:10:02,2025-01-26 09:10:02,Savings Vault topup,-0.05,0.00,EUR,COMPLETED,2236.94
Transfer,Current,2025-01-26 10:54:33,2025-01-26 10:54:33,From Flexible Cash Funds,21716.53,0.00,EUR,COMPLETED,23953.47
Transfer,Current,2025-01-26 10:54:53,2025-01-26 10:54:53,Savings Vault topup,-21764.00,0.00,EUR,COMPLETED,2189.47
Card Payment,Current,2025-01-25 16:57:32,2025-01-26 12:34:12,SuperValu,-44.70,0.00,EUR,COMPLETED,2144.77
Transfer,Current,2025-01-26 13:22:58,2025-01-26 13:22:58,Savings Vault topup,-5.00,0.00,EUR,COMPLETED,2139.77
Transfer,Current,2025-01-26 16:04:50,2025-01-26 16:04:50,Savings Vault topup,-4.10,0.00,EUR,COMPLETED,2135.67
Transfer,Current,2025-01-25 07:20:02,2025-01-27 02:00:32,To Trading 212 UK Limited,-500.00,0.00,EUR,COMPLETED,1635.67
Transfer,Current,2025-01-25 07:20:01,2025-01-27 02:00:33,To Finance Ireland,-1424.50,0.00,EUR,COMPLETED,211.17
Card Payment,Current,2025-01-26 13:22:58,2025-01-27 12:01:41,The Irish Times,-20.00,0.00,EUR,COMPLETED,191.17
Card Payment,Current,2025-01-26 09:10:02,2025-01-27 12:31:30,PlayStation,-69.99,0.00,EUR,COMPLETED,121.18
Card Payment,Current,2025-01-26 16:04:50,2025-01-27 12:56:25,Lidl,-36.18,0.00,EUR,COMPLETED,85.00
Transfer,Current,2025-01-27 14:44:47,2025-01-27 14:44:47,Savings Vault topup,-5.00,0.00,EUR,COMPLETED,80.00
Transfer,Current,2025-01-28 08:34:06,2025-01-28 08:34:06,Savings Vault topup,-3.90,0.00,EUR,COMPLETED,76.10
Card Payment,Current,2025-01-27 14:44:47,2025-01-28 11:20:52,The Rise Pharmacy,-48.00,0.00,EUR,COMPLETED,28.10
Transfer,Current,2025-01-28 13:31:20,2025-01-28 13:31:20,Pocket Withdrawal,100.00,0.00,EUR,COMPLETED,128.10
Transfer,Current,2025-01-28 13:31:27,2025-01-28 13:31:27,Savings Vault topup,-0.25,0.00,EUR,COMPLETED,127.85
Transfer,Current,2025-01-29 08:51:36,2025-01-29 08:51:36,From Flexible Cash Funds,0.91,0.00,EUR,COMPLETED,128.76
Card Payment,Current,2025-01-28 08:34:06,2025-01-29 10:47:54,Apple,-9.22,0.00,EUR,COMPLETED,119.54
Card Payment,Current,2025-01-28 13:31:27,2025-01-29 11:59:24,Hatch Coffee,-26.95,0.00,EUR,COMPLETED,92.59
Transfer,Current,2025-01-29 11:59:47,2025-01-29 11:59:47,Savings Vault topup,-3.50,0.00,EUR,COMPLETED,89.09
Transfer,Current,2025-01-29 13:55:49,2025-01-29 13:55:49,From Instant Access Savings,185.00,0.00,EUR,COMPLETED,274.09
Transfer,Current,2025-01-29 13:56:03,2025-01-29 13:56:03,Savings Vault topup,-5.00,0.00,EUR,COMPLETED,269.09
Transfer,Current,2025-01-29 14:59:54,2025-01-29 14:59:54,Savings Vault topup,-4.25,0.00,EUR,COMPLETED,264.84
Transfer,Current,2025-01-29 19:16:50,2025-01-29 19:16:50,From Instant Access Savings,100.00,0.00,EUR,COMPLETED,364.84
Transfer,Current,2025-01-29 19:18:31,2025-01-29 19:18:32,To Payward Ireland Ltd.,-100.00,0.00,EUR,COMPLETED,264.84
Transfer,Current,2025-01-30 02:05:04,2025-01-30 02:05:04,Savings Vault topup,-5.00,0.00,EUR,COMPLETED,259.84
Card Payment,Current,2025-01-29 13:56:03,2025-01-30 10:36:03,VMS Ireland,-185.00,0.00,EUR,COMPLETED,74.84
Card Payment,Current,2025-01-29 11:59:47,2025-01-30 10:39:15,Mint,-4.30,0.00,EUR,COMPLETED,70.54
Card Payment,Current,2025-01-29 14:59:54,2025-01-30 11:16:58,Lidl,-29.15,0.00,EUR,COMPLETED,41.39
Transfer,Current,2025-01-30 13:08:07,2025-01-30 13:08:08,From Instant Access Savings,100.00,0.00,EUR,COMPLETED,141.39
Transfer,Current,2025-01-30 13:08:14,2025-01-30 13:08:14,Savings Vault topup,-1.00,0.00,EUR,COMPLETED,140.39
Transfer,Current,2025-01-30 13:36:22,2025-01-30 13:36:22,From Instant Access Savings,200.00,0.00,EUR,COMPLETED,340.39
Transfer,Current,2025-01-30 13:36:27,2025-01-30 13:36:27,Savings Vault topup,-0.10,0.00,EUR,COMPLETED,340.29
Transfer,Current,2025-01-30 16:58:08,2025-01-30 16:58:09,Savings Vault topup,-3.10,0.00,EUR,COMPLETED,337.19
Transfer,Current,2025-01-30 17:18:32,2025-01-30 17:18:32,From Instant Access Savings,2000.00,0.00,EUR,COMPLETED,2337.19
Transfer,Current,2025-01-30 17:18:49,2025-01-30 17:18:49,Savings Vault topup,-1.00,0.00,EUR,COMPLETED,2336.19
Card Payment,Current,2025-01-30 17:18:49,2025-01-31 10:37:31,Wifimedia,-2016.80,0.00,EUR,COMPLETED,319.39
Transfer,Current,2025-01-31 10:44:39,2025-01-31 10:44:40,Savings Vault topup,-5.00,0.00,EUR,COMPLETED,314.39
Transfer,Current,2025-01-31 11:04:35,2025-01-31 11:04:35,Savings Vault topup,-2.00,0.00,EUR,COMPLETED,312.39
Transfer,Current,2025-01-31 11:28:02,2025-01-31 11:28:02,Savings Vault topup,-0.35,0.00,EUR,COMPLETED,312.04
Card Payment,Current,2025-01-30 16:58:08,2025-01-31 11:30:36,Deliveroo,-19.38,0.00,EUR,COMPLETED,292.66
Transfer,Current,2025-01-31 11:39:17,2025-01-31 11:39:17,Savings Vault topup,-3.15,0.00,EUR,COMPLETED,289.51
Card Payment,Current,2025-01-30 02:05:04,2025-01-31 11:59:57,FLYEfit,-37.00,0.00,EUR,COMPLETED,252.51
Transfer,Current,2025-01-31 14:34:35,2025-01-31 14:34:36,Transfer from MARA DI RAIMONDO,19.38,0.00,EUR,COMPLETED,271.89
Card Payment,Current,2025-01-30 13:08:14,2025-01-31 16:34:40,Butlers Chocolates,-9.80,0.00,EUR,COMPLETED,262.09
Card Payment,Current,2025-01-30 13:36:27,2025-01-31 16:49:55,Woodie's,-134.98,0.00,EUR,COMPLETED,127.11
Transfer,Current,2025-01-31 17:49:25,2025-01-31 17:49:25,To Instant Access Savings,-1.05,0.00,EUR,COMPLETED,126.06
Transfer,Current,2025-02-01 07:19:51,2025-02-01 07:19:51,To Instant Access Savings,-2.55,0.00,EUR,COMPLETED,123.51
Card Payment,Current,2025-01-31 11:04:35,2025-02-01 11:16:31,Hatch Coffee,-8.60,0.00,EUR,COMPLETED,114.91
Card Payment,Current,2025-01-31 10:44:39,2025-02-01 11:16:35,Hatch Coffee,-13.00,0.00,EUR,COMPLETED,101.91
Card Payment,Current,2025-01-31 11:39:17,2025-02-01 11:31:26,SuperValu,-11.37,0.00,EUR,COMPLETED,90.54
Transfer,Current,2025-02-01 13:17:39,2025-02-01 13:17:39,To Instant Access Savings,-1.45,0.00,EUR,COMPLETED,89.09
Card Refund,Current,2025-02-01 00:00:00,2025-02-01 15:21:32,Wifimedia,2016.80,0.00,EUR,COMPLETED,2105.89
Card Payment,Current,2025-01-31 11:28:02,2025-02-01 15:52:07,LloydsPharmacy,-17.93,0.00,EUR,COMPLETED,2087.96
Transfer,Current,2025-02-01 16:14:35,2025-02-01 16:14:35,To Instant Access Savings,-2.65,0.00,EUR,COMPLETED,2085.31
Card Payment,Current,2025-01-31 17:49:25,2025-02-01 16:16:00,Deliveroo,-41.79,0.00,EUR,COMPLETED,2043.52
Transfer,Current,2025-02-01 23:41:05,2025-02-01 23:41:05,To Instant Access Savings,-2.45,0.00,EUR,COMPLETED,2041.07
Card Payment,Current,2025-02-01 07:19:51,2025-02-02 10:41:05,HP,-1.49,0.00,EUR,COMPLETED,2039.58
Card Payment,Current,2025-02-01 13:17:38,2025-02-02 10:53:43,SuperValu,-19.71,0.00,EUR,COMPLETED,2019.87
Transfer,Current,2025-02-02 12:04:22,2025-02-02 12:04:22,To Instant Access Savings,-1.05,0.00,EUR,COMPLETED,2018.82
Card Payment,Current,2025-02-01 23:41:05,2025-02-02 14:23:28,Amazon,-6.51,0.07,EUR,COMPLETED,2012.24
Card Payment,Current,2025-02-01 16:14:34,2025-02-02 15:11:18,Obsidian,-46.47,0.46,EUR,COMPLETED,1965.31
Transfer,Current,2025-02-02 17:03:24,2025-02-02 17:03:24,To Instant Access Savings,-1.25,0.00,EUR,COMPLETED,1964.06
Transfer,Current,2025-02-02 18:56:22,2025-02-02 18:56:22,To Instant Access Savings,-1800.00,0.00,EUR,COMPLETED,164.06
Card Payment,Current,2025-02-02 17:03:23,2025-02-03 09:51:03,ALDI,-52.75,0.00,EUR,COMPLETED,111.31
Card Payment,Current,2025-02-02 12:04:22,2025-02-03 14:17:48,Amazon,-10.79,0.11,EUR,COMPLETED,100.41
Transfer,Current,2025-02-05 14:15:11,2025-02-05 14:15:11,To Instant Access Savings,-2.75,0.00,EUR,COMPLETED,97.66
Transfer,Current,2025-02-05 16:28:15,2025-02-05 16:28:15,To Instant Access Savings,-2.50,0.00,EUR,COMPLETED,95.16
Transfer,Current,2025-02-05 17:36:30,2025-02-05 17:36:30,To Instant Access Savings,-2.50,0.00,EUR,COMPLETED,92.66
Transfer,Current,2025-02-05 18:22:25,2025-02-05 18:22:25,To Instant Access Savings,-2.55,0.00,EUR,COMPLETED,90.11
Card Payment,Current,2025-02-05 14:15:11,2025-02-06 09:33:50,OXMANTOWN,-4.45,0.00,EUR,COMPLETED,85.66
Card Payment,Current,2025-02-05 18:22:25,2025-02-06 12:19:19,Deliveroo,-59.49,0.00,EUR,COMPLETED,26.17
Card Payment,Current,2025-02-05 16:28:15,2025-02-06 13:03:41,Delaney's,-6.50,0.00,EUR,COMPLETED,19.67
Card Payment,Current,2025-02-05 17:36:30,2025-02-06 13:04:20,Delaney's,-19.50,0.00,EUR,COMPLETED,0.17
Transfer,Current,2025-02-06 13:18:42,2025-02-06 13:18:42,From Instant Access Savings,100.00,0.00,EUR,COMPLETED,100.17
Transfer,Current,2025-02-06 13:27:31,2025-02-06 13:27:31,To Instant Access Savings,-3.75,0.00,EUR,COMPLETED,96.42
Exchange,Current,2025-02-06 17:08:06,2025-02-06 17:08:06,Exchanged to EUR,15095.65,0.00,EUR,COMPLETED,15192.07
Transfer,Current,2025-02-06 17:08:19,2025-02-06 17:08:19,To Instant Access Savings,-15000.00,0.00,EUR,COMPLETED,192.07
Transfer,Current,2025-02-06 19:32:15,2025-02-06 19:32:15,To Instant Access Savings,-5.00,0.00,EUR,COMPLETED,187.07
Transfer,Current,2025-02-06 20:03:50,2025-02-06 20:03:51,Transfer from MARA DI RAIMONDO,24.00,0.00,EUR,COMPLETED,211.07
Card Payment,Current,2025-02-06 13:27:30,2025-02-07 11:49:51,Boojum,-14.25,0.00,EUR,COMPLETED,196.82
Transfer,Current,2025-02-07 14:00:25,2025-02-07 14:00:25,To Instant Access Savings,-1.30,0.00,EUR,COMPLETED,195.52
Transfer,Current,2025-02-07 14:17:27,2025-02-07 14:17:27,To Instant Access Savings,-1.50,0.00,EUR,COMPLETED,194.02
Transfer,Current,2025-02-08 09:28:56,2025-02-08 09:28:56,To Instant Access Savings,-5.00,0.00,EUR,COMPLETED,189.02
Card Payment,Current,2025-02-07 14:00:25,2025-02-08 09:50:06,Lidl,-22.74,0.00,EUR,COMPLETED,166.28
Card Payment,Current,2025-02-06 19:32:15,2025-02-08 10:43:41,The Merry Cobbler,-60.00,0.00,EUR,COMPLETED,106.28
Card Payment,Current,2025-02-07 14:17:26,2025-02-08 11:48:05,Insomnia Coffee Company,-4.70,0.00,EUR,COMPLETED,101.58
Transfer,Current,2025-02-08 12:16:57,2025-02-08 12:16:57,To Instant Access Savings,-5.00,0.00,EUR,COMPLETED,96.58
Transfer,Current,2025-02-08 13:05:57,2025-02-08 13:05:57,From Instant Access Savings,100.00,0.00,EUR,COMPLETED,196.58
Transfer,Current,2025-02-08 13:06:15,2025-02-08 13:06:15,To Instant Access Savings,-0.05,0.00,EUR,COMPLETED,196.53
Transfer,Current,2025-02-08 13:08:58,2025-02-08 13:08:58,To Instant Access Savings,-3.25,0.00,EUR,COMPLETED,193.28
Transfer,Current,2025-02-08 17:05:33,2025-02-08 17:05:33,From Instant Access Savings,200.00,0.00,EUR,COMPLETED,393.28
Transfer,Current,2025-02-08 17:06:03,2025-02-08 17:06:03,Transfer to MARA DI RAIMONDO,-169.95,0.00,EUR,COMPLETED,223.33
Transfer,Current,2025-02-08 17:22:55,2025-02-08 17:22:55,To Instant Access Savings,-4.70,0.00,EUR,COMPLETED,218.63
Transfer,Current,2025-02-08 21:24:29,2025-02-08 21:24:30,To Instant Access Savings,-0.75,0.00,EUR,COMPLETED,217.88
Card Payment,Current,2025-02-08 17:22:54,2025-02-09 09:29:27,Lidl,-32.06,0.00,EUR,COMPLETED,185.82
Card Payment,Current,2025-02-08 21:24:29,2025-02-09 10:16:01,Yeeros,-10.85,0.00,EUR,COMPLETED,174.97
Card Payment,Current,2025-02-08 13:08:58,2025-02-09 10:24:38,Hatch Coffee,-9.35,0.00,EUR,COMPLETED,165.62
Card Payment,Current,2025-02-08 12:59:49,2025-02-09 10:24:43,The Joinery Barbersho,-32.00,0.00,EUR,COMPLETED,133.62
Transfer,Current,2025-02-09 12:55:54,2025-02-09 12:55:55,To Instant Access Savings,-5.00,0.00,EUR,COMPLETED,128.62
Transfer,Current,2025-02-09 14:56:05,2025-02-09 14:56:06,From Instant Access Savings,100.00,0.00,EUR,COMPLETED,228.62
Transfer,Current,2025-02-09 14:56:10,2025-02-09 14:56:10,To Instant Access Savings,-4.40,0.00,EUR,COMPLETED,224.22
Card Payment,Current,2025-02-08 12:16:56,2025-02-09 15:40:27,Payzone,-10.00,0.00,EUR,COMPLETED,214.22
Card Payment,Current,2025-02-08 13:06:15,2025-02-09 15:50:11,Centra,-5.99,0.00,EUR,COMPLETED,208.23
Transfer,Current,2025-02-09 21:04:36,2025-02-09 21:04:36,Transfer to MARA DI RAIMONDO,-48.00,0.00,EUR,COMPLETED,160.23
Transfer,Current,2025-02-09 21:05:52,2025-02-09 21:05:52,Transfer from MARA DI RAIMONDO,47.38,0.00,EUR,COMPLETED,207.61
Card Payment,Current,2025-02-09 12:55:54,2025-02-10 09:49:17,The Dean,-55.00,0.00,EUR,COMPLETED,152.61
Card Payment,Current,2025-02-09 14:56:10,2025-02-10 12:56:09,Søstrene Grene,-33.12,0.00,EUR,COMPLETED,119.49
Card Payment,Current,2025-02-08 09:28:56,2025-02-11 09:19:00,lululemon,-54.00,0.00,EUR,COMPLETED,65.49
Transfer,Current,2025-02-11 13:51:40,2025-02-11 13:51:40,To Instant Access Savings,-0.50,0.00,EUR,COMPLETED,64.99
Transfer,Current,2025-02-11 17:39:28,2025-02-11 17:39:28,From Instant Access Savings,100.00,0.00,EUR,COMPLETED,164.99
Transfer,Current,2025-02-11 19:05:50,2025-02-11 19:05:50,From Instant Access Savings,1200.00,0.00,EUR,COMPLETED,1364.99
Card Payment,Current,2025-02-11 19:07:17,,Amazon,-86.69,0.00,EUR,REVERTED,
Transfer,Current,2025-02-11 19:07:17,2025-02-11 19:07:17,To Instant Access Savings,-5.00,0.00,EUR,COMPLETED,1359.99
Transfer,Current,2025-02-11 19:07:17,2025-02-11 19:07:17,To Instant Access Savings,-1.55,0.00,EUR,COMPLETED,1358.44
Transfer,Current,2025-02-11 20:05:24,2025-02-11 20:05:24,To Instant Access Savings,-2.30,0.00,EUR,COMPLETED,1356.14
Transfer,Current,2025-02-12 08:44:31,2025-02-12 08:44:31,To Instant Access Savings,-0.35,0.00,EUR,COMPLETED,1355.79
Card Payment,Current,2025-02-11 13:51:40,2025-02-12 10:17:13,Boojum,-10.90,0.00,EUR,COMPLETED,1344.89
Transfer,Current,2025-02-12 16:49:55,2025-02-12 16:49:55,To Instant Access Savings,-2.90,0.00,EUR,COMPLETED,1341.99
Transfer,Current,2025-02-12 17:49:51,2025-02-12 17:49:51,To Instant Access Savings,-3.25,0.00,EUR,COMPLETED,1338.74
Transfer,Current,2025-02-12 19:28:05,2025-02-12 19:28:05,Transfer to JOHN DANIEL KIELY,-18.00,0.00,EUR,COMPLETED,1320.74
Card Payment,Current,2025-02-12 16:49:55,2025-02-13 10:38:34,GoMo,-14.42,0.00,EUR,COMPLETED,1306.32
Card Payment,Current,2025-02-12 08:44:30,2025-02-13 10:55:52,Lidl,-25.93,0.00,EUR,COMPLETED,1280.39
Card Payment,Current,2025-02-11 20:05:23,2025-02-13 13:11:42,Amazon,-197.54,0.00,EUR,COMPLETED,1082.85
Card Payment,Current,2025-02-12 17:49:51,2025-02-13 15:25:50,Parking Payments,-2.35,0.00,EUR,COMPLETED,1080.50
Transfer,Current,2025-02-13 20:40:40,2025-02-13 20:40:41,To Instant Access Savings,-5.00,0.00,EUR,COMPLETED,1075.50
Transfer,Current,2025-02-14 08:58:52,2025-02-14 08:58:52,To Instant Access Savings,-2.50,0.00,EUR,COMPLETED,1073.00
Transfer,Current,2025-02-14 09:04:55,2025-02-14 09:04:55,To Instant Access Savings,-5.00,0.00,EUR,COMPLETED,1068.00
Transfer,Current,2025-02-14 09:11:42,2025-02-14 09:11:42,To Instant Access Savings,-2.50,0.00,EUR,COMPLETED,1065.50
Card Payment,Current,2025-02-11 19:07:16,2025-02-14 09:43:43,Sonos,-947.00,0.00,EUR,COMPLETED,118.50
Card Payment,Current,2025-02-13 20:40:40,2025-02-14 09:54:41,PlayStation,-10.00,0.00,EUR,COMPLETED,108.50
Transfer,Current,2025-02-14 13:51:54,2025-02-14 13:51:55,Transfer from MARA DI RAIMONDO,9.50,0.00,EUR,COMPLETED,118.00
Transfer,Current,2025-02-14 17:58:30,2025-02-14 17:58:30,To Instant Access Savings,-3.55,0.00,EUR,COMPLETED,114.45
Transfer,Current,2025-02-14 18:20:07,2025-02-14 18:20:07,To Instant Access Savings,-3.50,0.00,EUR,COMPLETED,110.95
Transfer,Current,2025-02-14 18:42:26,2025-02-14 18:42:26,To Instant Access Savings,-5.00,0.00,EUR,COMPLETED,105.95
Transfer,Current,2025-02-14 21:59:00,2025-02-14 21:59:00,From Instant Access Savings,50.00,0.00,EUR,COMPLETED,155.95
Transfer,Current,2025-02-14 22:00:57,2025-02-14 22:00:57,To Instant Access Savings,-1.80,0.00,EUR,COMPLETED,154.15
Transfer,Current,2025-02-14 23:06:10,2025-02-14 23:06:10,To Instant Access Savings,-1.50,0.00,EUR,COMPLETED,152.65
Card Payment,Current,2025-02-14 17:58:30,2025-02-15 08:57:50,FREE NOW,-18.30,0.00,EUR,COMPLETED,134.35
Card Payment,Current,2025-02-14 09:04:55,2025-02-15 09:24:41,Tesco,-9.00,0.00,EUR,COMPLETED,125.35
Card Payment,Current,2025-02-14 23:06:10,2025-02-15 10:07:25,FREE NOW,-21.70,0.00,EUR,COMPLETED,103.65
Card Payment,Current,2025-02-14 08:58:52,2025-02-15 10:08:14,Starbucks,-5.50,0.00,EUR,COMPLETED,98.15
Transfer,Current,2025-02-15 10:34:30,2025-02-15 10:34:30,To Instant Access Savings,-2.00,0.00,EUR,COMPLETED,96.15
Card Payment,Current,2025-02-14 22:00:57,2025-02-15 11:32:01,Deliveroo,-35.64,0.00,EUR,COMPLETED,60.51
Transfer,Current,2025-02-15 11:40:53,2025-02-15 11:40:53,From Instant Access Savings,100.00,0.00,EUR,COMPLETED,160.51
Transfer,Current,2025-02-15 11:41:58,2025-02-15 11:41:58,To Instant Access Savings,-3.75,0.00,EUR,COMPLETED,156.76
Transfer,Current,2025-02-15 16:05:19,2025-02-15 16:05:19,From Instant Access Savings,600.00,0.00,EUR,COMPLETED,756.76
Card Payment,Current,2025-02-15 16:30:35,,Sonos,-498.00,0.00,EUR,REVERTED,
Transfer,Current,2025-02-15 16:30:35,2025-02-15 16:30:35,To Instant Access Savings,-5.00,0.00,EUR,COMPLETED,751.76
Transfer,Current,2025-02-15 19:02:49,2025-02-15 19:02:49,To Instant Access Savings,-5.00,0.00,EUR,COMPLETED,746.76
Transfer,Current,2025-02-15 22:09:45,2025-02-15 22:09:45,To Instant Access Savings,-5.00,0.00,EUR,COMPLETED,741.76
Transfer,Current,2025-02-16 00:24:37,2025-02-16 00:24:37,To Instant Access Savings,-5.00,0.00,EUR,COMPLETED,736.76
Transfer,Current,2025-02-16 00:46:11,2025-02-16 00:46:11,To Instant Access Savings,-1.50,0.00,EUR,COMPLETED,735.26
Transfer,Current,2025-02-16 01:04:03,2025-02-16 01:04:04,To Instant Access Savings,-5.00,0.00,EUR,COMPLETED,730.26
Transfer,Current,2025-02-16 01:46:05,2025-02-16 01:46:05,To Instant Access Savings,-2.00,0.00,EUR,COMPLETED,728.26
Transfer,Current,2025-02-16 02:44:03,2025-02-16 02:44:04,To Instant Access Savings,-2.50,0.00,EUR,COMPLETED,725.76
Card Payment,Current,2025-02-15 11:41:58,2025-02-16 10:13:54,Brownes of Sandymount,-57.25,0.00,EUR,COMPLETED,668.51
Card Payment,Current,2025-02-14 18:20:07,2025-02-16 10:17:20,The Ferryman,-7.30,0.00,EUR,COMPLETED,661.21
Transfer,Current,2025-02-16 10:55:20,2025-02-16 10:55:20,To Instant Access Savings,-0.05,0.00,EUR,COMPLETED,661.16
Card Payment,Current,2025-02-14 18:42:26,2025-02-16 11:14:44,Bord Gáis Energy Theatre,-22.00,0.00,EUR,COMPLETED,639.16
Card Payment,Current,2025-02-15 10:34:30,2025-02-16 11:14:58,Parking Payments,-2.60,0.00,EUR,COMPLETED,636.56
Transfer,Current,2025-02-16 11:15:25,2025-02-16 11:15:25,To Instant Access Savings,-0.05,0.00,EUR,COMPLETED,636.51
Card Payment,Current,2025-02-16 01:04:03,2025-02-16 11:41:30,Pawn Shop,-20.00,0.00,EUR,COMPLETED,616.51
Card Payment,Current,2025-02-16 00:46:11,2025-02-16 11:42:13,Pawn Shop,-15.70,0.00,EUR,COMPLETED,600.81
Card Payment,Current,2025-02-16 00:24:36,2025-02-16 11:42:14,Pawn Shop,-13.00,0.00,EUR,COMPLETED,587.81
Transfer,Current,2025-02-16 13:11:22,2025-02-16 13:11:22,To Instant Access Savings,-2.55,0.00,EUR,COMPLETED,585.26
Card Payment,Current,2025-02-16 13:11:21,2025-02-17 09:03:14,Domino's pizza,-32.49,0.00,EUR,COMPLETED,552.77
Card Payment,Current,2025-02-15 19:02:49,2025-02-17 10:48:39,Blackbird,-29.00,0.00,EUR,COMPLETED,523.77
Card Payment,Current,2025-02-15 22:09:45,2025-02-17 10:52:03,Blackbird,-39.00,0.00,EUR,COMPLETED,484.77
Card Payment,Current,2025-02-16 01:46:04,2025-02-17 11:38:15,Savas Demir / Tax,-23.60,0.00,EUR,COMPLETED,461.17
Card Payment,Current,2025-02-16 02:44:03,2025-02-17 11:53:58,FREE NOW,-13.50,0.00,EUR,COMPLETED,447.67
Card Payment,Current,2025-02-16 11:15:25,2025-02-17 12:47:21,Amazon,-0.99,0.01,EUR,COMPLETED,446.67
Card Payment,Current,2025-02-16 10:55:20,2025-02-17 13:28:56,The Washington Post,-0.99,0.00,EUR,COMPLETED,445.68
Transfer,Current,2025-02-17 17:42:10,2025-02-17 17:42:10,To Instant Access Savings,-1.00,0.00,EUR,COMPLETED,444.68
Transfer,Current,2025-02-17 18:39:19,2025-02-17 18:39:19,To Instant Access Savings,-3.95,0.00,EUR,COMPLETED,440.73
Transfer,Current,2025-02-18 13:05:40,2025-02-18 13:05:41,To Intercultural Psychology,-90.00,0.00,EUR,COMPLETED,350.73
Card Payment,Current,2025-02-17 18:39:18,2025-02-18 13:33:16,Zakura,-56.21,0.00,EUR,COMPLETED,294.52
Card Payment,Current,2025-02-14 09:11:42,2025-02-18 13:37:53,An Post,-9.50,0.00,EUR,COMPLETED,285.02
Card Payment,Current,2025-02-17 17:42:10,2025-02-18 13:48:39,Parking Payments,-3.80,0.00,EUR,COMPLETED,281.22
Transfer,Current,2025-02-18 16:18:23,2025-02-18 16:18:23,To Instant Access Savings,-4.35,0.00,EUR,COMPLETED,276.87
Transfer,Current,2025-02-18 21:41:08,2025-02-18 21:41:08,To Instant Access Savings,-3.80,0.00,EUR,COMPLETED,273.07
Card Payment,Current,2025-02-18 16:18:23,2025-02-19 11:51:00,Lidl,-33.13,0.00,EUR,COMPLETED,239.94
Transfer,Current,2025-02-19 12:45:16,2025-02-19 12:45:16,To Instant Access Savings,-5.00,0.00,EUR,COMPLETED,234.94
Transfer,Current,2025-02-19 12:45:24,2025-02-19 12:45:24,From Instant Access Savings,195.00,0.00,EUR,COMPLETED,429.94
Transfer,Current,2025-02-19 12:49:53,2025-02-19 12:49:53,To Instant Access Savings,-5.00,0.00,EUR,COMPLETED,424.94
Card Payment,Current,2025-02-18 21:41:08,2025-02-19 14:02:24,Cursor,-19.24,0.00,EUR,COMPLETED,405.70
Card Payment,Current,2025-02-19 12:45:16,2025-02-20 10:00:41,Tropical Medical Bureau,-195.00,0.00,EUR,COMPLETED,210.70
Card Payment,Current,2025-02-19 12:49:52,2025-02-20 10:46:04,Centra,-6.00,0.00,EUR,COMPLETED,204.70
Topup,Current,2025-02-20 12:23:12,2025-02-20 12:23:13,Payment from VHI CLAIMS,30.00,0.00,EUR,COMPLETED,234.70
Transfer,Current,2025-02-20 14:41:52,2025-02-20 14:41:53,To Instant Access Savings,-2.50,0.00,EUR,COMPLETED,232.20
Transfer,Current,2025-02-20 14:54:42,2025-02-20 14:54:42,To Instant Access Savings,-0.50,0.00,EUR,COMPLETED,231.70
Transfer,Current,2025-02-20 19:05:16,2025-02-20 19:05:16,To Instant Access Savings,-2.00,0.00,EUR,COMPLETED,229.70
Transfer,Current,2025-02-21 08:02:37,2025-02-21 08:02:37,To Instant Access Savings,-3.50,0.00,EUR,COMPLETED,226.20
Card Payment,Current,2025-02-20 14:41:52,2025-02-21 09:52:21,Centra,-6.50,0.00,EUR,COMPLETED,219.70
Transfer,Current,2025-02-21 11:33:01,2025-02-21 11:33:01,To Instant Access Savings,-1.75,0.00,EUR,COMPLETED,217.95
Card Payment,Current,2025-02-20 19:05:16,2025-02-21 12:20:09,Deliveroo,-47.60,0.00,EUR,COMPLETED,170.35
Card Payment,Current,2025-02-20 14:54:41,2025-02-21 12:30:02,Butler's Chocolate Masters,-4.90,0.00,EUR,COMPLETED,165.45
Transfer,Current,2025-02-21 16:06:13,2025-02-21 16:06:13,To Instant Access Savings,-5.00,0.00,EUR,COMPLETED,160.45
Card Payment,Current,2025-02-21 11:33:01,2025-02-22 09:13:55,SuperValu,-31.65,0.00,EUR,COMPLETED,128.80
Card Payment,Current,2025-02-21 16:06:12,2025-02-22 09:17:27,The Dropping Well,-50.00,0.00,EUR,COMPLETED,78.80
Transfer,Current,2025-02-22 09:55:08,2025-02-22 09:55:08,To Instant Access Savings,-3.50,0.00,EUR,COMPLETED,75.30
Transfer,Current,2025-02-22 14:43:48,2025-02-22 14:43:48,To Instant Access Savings,-2.00,0.00,EUR,COMPLETED,73.30
Transfer,Current,2025-02-22 15:27:13,2025-02-22 15:27:13,Pocket Withdrawal,150.00,0.00,EUR,COMPLETED,223.30
Transfer,Current,2025-02-22 15:27:20,2025-02-22 15:27:20,To Instant Access Savings,-3.45,0.00,EUR,COMPLETED,219.85
Transfer,Current,2025-02-22 15:28:39,2025-02-22 15:28:39,Transfer from MARA DI RAIMONDO,14.52,0.00,EUR,COMPLETED,234.37
Transfer,Current,2025-02-23 09:56:07,2025-02-23 09:56:07,To Instant Access Savings,-0.50,0.00,EUR,COMPLETED,233.87
Card Payment,Current,2025-02-22 09:55:08,2025-02-23 10:02:56,Applegreen,-11.30,0.00,EUR,COMPLETED,222.57
Card Payment,Current,2025-02-21 08:02:37,2025-02-23 12:20:11,Ticketmaster,-52.30,0.00,EUR,COMPLETED,170.27
Card Payment,Current,2025-02-22 14:43:48,2025-02-23 12:55:44,Parking Payments,-3.60,0.00,EUR,COMPLETED,166.67
Transfer,Current,2025-02-23 13:43:49,2025-02-23 13:43:50,Transfer to MARA DI RAIMONDO,-16.00,0.00,EUR,COMPLETED,150.67
Transfer,Current,2025-02-23 14:48:36,2025-02-23 14:48:36,From Instant Access Savings,160.00,0.00,EUR,COMPLETED,310.67
Transfer,Current,2025-02-23 14:48:43,2025-02-23 14:48:43,To Instant Access Savings,-2.50,0.00,EUR,COMPLETED,308.17
Transfer,Current,2025-02-23 16:18:52,2025-02-23 16:18:52,To Instant Access Savings,-2.05,0.00,EUR,COMPLETED,306.12
Transfer,Current,2025-02-23 16:23:18,2025-02-23 16:23:18,To Instant Access Savings,-1.50,0.00,EUR,COMPLETED,304.62
Card Payment,Current,2025-02-22 15:27:20,2025-02-24 10:17:32,Bunsen,-35.31,0.00,EUR,COMPLETED,269.31
Card Payment,Current,2025-02-23 16:23:18,2025-02-24 10:18:34,Centra,-12.70,0.00,EUR,COMPLETED,256.61
Card Payment,Current,2025-02-23 13:02:29,2025-02-24 10:40:28,Transport for Ireland - TFI,-40.00,0.00,EUR,COMPLETED,216.61
Card Payment,Current,2025-02-23 16:18:52,2025-02-24 11:33:12,Townhouse Leisure,-18.59,0.00,EUR,COMPLETED,198.02
Transfer,Current,2025-02-24 00:00:00,2025-02-24 11:49:20,To eFlow,-20.33,0.00,EUR,COMPLETED,177.69
Card Payment,Current,2025-02-23 09:56:07,2025-02-24 13:24:36,OpenAI,-5.90,0.06,EUR,COMPLETED,171.73
Transfer,Current,2025-02-24 18:14:35,2025-02-24 18:14:36,From Instant Access Savings,2100.00,0.00,EUR,COMPLETED,2271.73
Transfer,Current,2025-02-24 18:43:21,2025-02-24 18:43:21,To Instant Access Savings,-0.20,0.00,EUR,COMPLETED,2271.53
Transfer,Current,2025-02-24 19:16:53,2025-02-24 19:16:53,Transfer from MARA DI RAIMONDO,550.00,0.00,EUR,COMPLETED,2821.53
Transfer,Current,2025-02-24 19:48:37,2025-02-24 19:48:37,To Instant Access Savings,-0.50,0.00,EUR,COMPLETED,2821.03
Transfer,Current,2025-02-25 01:05:50,2025-02-25 01:05:50,To pocket EUR Subscriptions from EUR,-400.00,0.00,EUR,COMPLETED,2421.03
Topup,Current,2025-02-25 06:34:59,2025-02-25 06:35:00,Payment from WORKDAY LIMITED,2972.93,0.00,EUR,COMPLETED,5393.96
Transfer,Current,2025-02-25 06:35:00,2025-02-25 06:35:00,To Instant Access Savings,-275.00,0.00,EUR,COMPLETED,5118.96
Transfer,Current,2025-02-25 07:34:28,2025-02-25 07:34:30,To Payward Ireland Ltd.,-100.00,0.00,EUR,COMPLETED,5018.96
Transfer,Current,2025-02-25 07:21:54,2025-02-25 07:51:49,To Finance Ireland,-1424.50,0.00,EUR,COMPLETED,3594.46
Transfer,Current,2025-02-25 07:21:55,2025-02-25 07:51:50,To Trading 212 UK Limited,-500.00,0.00,EUR,COMPLETED,3094.46
Transfer,Current,2025-02-25 08:32:17,2025-02-25 08:32:17,To pocket EUR Subscriptions from EUR,-400.00,0.00,EUR,COMPLETED,2694.46
Transfer,Current,2025-02-25 08:39:02,2025-02-25 08:39:02,To Instant Access Savings,-2.50,0.00,EUR,COMPLETED,2691.96
Transfer,Current,2025-02-25 07:30:56,2025-02-25 08:52:05,To Colm Quish,-1974.54,0.00,EUR,COMPLETED,717.42
Card Payment,Current,2025-02-24 18:43:21,2025-02-25 09:39:46,Lidl,-19.96,0.00,EUR,COMPLETED,697.46
Card Payment,Current,2025-02-24 19:48:37,2025-02-25 15:12:11,Claude.ai,-5.90,0.00,EUR,COMPLETED,691.56
Transfer,Current,2025-02-25 17:23:15,2025-02-25 17:23:15,To Instant Access Savings,-5.00,0.00,EUR,COMPLETED,686.56
Transfer,Current,2025-02-25 20:15:15,2025-02-25 20:15:15,To Instant Access Savings,-1.00,0.00,EUR,COMPLETED,685.56
Transfer,Current,2025-02-26 07:53:26,2025-02-26 07:53:26,To Instant Access Savings,-1.50,0.00,EUR,COMPLETED,684.06
Transfer,Current,2025-02-26 07:54:04,2025-02-26 07:54:04,To Instant Access Savings,-1.00,0.00,EUR,COMPLETED,683.06
Card Payment,Current,2025-02-25 20:15:15,2025-02-26 09:33:49,Finnegans Wake,-16.80,0.00,EUR,COMPLETED,666.26
Card Payment,Current,2025-02-25 17:23:15,2025-02-26 09:49:25,Phone Care,-7.00,0.00,EUR,COMPLETED,659.26
Card Payment,Current,2025-02-25 08:39:02,2025-02-26 11:48:10,Copper + Straw,-9.50,0.00,EUR,COMPLETED,649.76
Transfer,Current,2025-02-26 14:15:23,2025-02-26 14:15:23,To Instant Access Savings,-2.50,0.00,EUR,COMPLETED,647.26
Transfer,Current,2025-02-27 08:26:52,2025-02-27 08:26:54,To Intercultural Psychology,-90.00,0.00,EUR,COMPLETED,557.26
Transfer,Current,2025-02-27 08:46:32,2025-02-27 08:46:32,To Instant Access Savings,-2.75,0.00,EUR,COMPLETED,554.51
Card Payment,Current,2025-02-23 14:48:43,2025-02-27 11:08:48,Jam Art Factory,-146.50,0.00,EUR,COMPLETED,408.01
Card Payment,Current,2025-02-26 07:53:26,2025-02-27 11:15:01,FREE NOW,-17.70,0.00,EUR,COMPLETED,390.31
Card Payment,Current,2025-02-26 14:15:22,2025-02-27 11:20:57,Mad Yolks,-22.50,0.00,EUR,COMPLETED,367.81
Topup,Current,2025-02-27 12:26:19,2025-02-27 12:26:20,Payment from VHI CLAIMS,127.50,0.00,EUR,COMPLETED,495.31
Card Payment,Current,2025-02-26 07:54:03,2025-02-27 12:36:34,Hatch Coffee,-42.80,0.00,EUR,COMPLETED,452.51
Transfer,Current,2025-02-27 14:24:24,2025-02-27 14:24:24,To Instant Access Savings,-1.75,0.00,EUR,COMPLETED,450.76
Transfer,Current,2025-02-27 20:59:55,2025-02-27 20:59:55,To Instant Access Savings,-2.65,0.00,EUR,COMPLETED,448.11
Card Payment,Current,2025-02-27 14:24:24,2025-02-28 08:53:04,SuperValu,-9.65,0.00,EUR,COMPLETED,438.46
Card Payment,Current,2025-02-27 20:59:55,2025-02-28 10:22:25,Centra,-51.47,0.00,EUR,COMPLETED,386.99
Transfer,Current,2025-02-28 16:13:52,2025-02-28 16:13:52,To Instant Access Savings,-2.75,0.00,EUR,COMPLETED,384.24
Transfer,Current,2025-03-01 09:07:05,2025-03-01 09:07:05,To Instant Access Savings,-4.90,0.00,EUR,COMPLETED,379.34
Card Payment,Current,2025-02-27 08:46:31,2025-03-01 10:01:58,YUNO,-90.45,0.00,EUR,COMPLETED,288.89
Card Payment,Current,2025-02-28 16:13:51,2025-03-01 10:31:48,Zest!,-17.45,0.00,EUR,COMPLETED,271.44
Transfer,Current,2025-03-01 12:03:39,2025-03-01 12:03:39,To Instant Access Savings,-0.25,0.00,EUR,COMPLETED,271.19
Card Payment,Current,2025-03-01 09:07:05,2025-03-01 14:00:05,Amazon,-10.02,0.10,EUR,COMPLETED,261.07
Transfer,Current,2025-03-01 15:12:30,2025-03-01 15:12:30,To Instant Access Savings,-2.50,0.00,EUR,COMPLETED,258.57
Transfer,Current,2025-03-01 18:47:53,2025-03-01 18:47:53,Transfer from Andrew James Fullen,26.00,0.00,EUR,COMPLETED,284.57
Transfer,Current,2025-03-01 18:48:45,2025-03-01 18:48:45,To Instant Access Savings,-5.00,0.00,EUR,COMPLETED,279.57
Card Payment,Current,2025-03-01 18:48:45,2025-03-02 09:13:33,Locke Burger,-70.00,0.00,EUR,COMPLETED,209.57
Card Payment,Current,2025-03-01 12:03:39,2025-03-02 09:26:06,Hook & Ladder,-70.95,0.00,EUR,COMPLETED,138.62
Transfer,Current,2025-03-02 12:01:44,2025-03-02 12:01:44,To Instant Access Savings,-0.35,0.00,EUR,COMPLETED,138.27
Card Payment,Current,2025-03-01 15:12:30,2025-03-02 12:51:52,Amazon,-3.50,0.04,EUR,COMPLETED,134.73
Transfer,Current,2025-03-02 14:29:46,2025-03-02 14:29:46,From Instant Access Savings,300.00,0.00,EUR,COMPLETED,434.73
Transfer,Current,2025-03-02 17:40:32,2025-03-02 17:40:32,To Instant Access Savings,-3.25,0.00,EUR,COMPLETED,431.48
Transfer,Current,2025-03-02 20:08:15,2025-03-02 20:08:18,To Colm Quish,-25.00,0.00,EUR,COMPLETED,406.48
Card Payment,Current,2025-03-02 17:40:31,2025-03-03 11:44:47,SuperValu,-17.35,0.00,EUR,COMPLETED,389.13
Card Payment,Current,2025-03-02 12:01:44,2025-03-03 13:04:09,Amazon,-10.93,0.11,EUR,COMPLETED,378.09
Transfer,Current,2025-03-03 17:21:21,2025-03-03 17:21:21,To Instant Access Savings,-4.25,0.00,EUR,COMPLETED,373.84
Transfer,Current,2025-03-03 17:57:12,2025-03-03 17:57:12,Transfer from MARA DI RAIMONDO,18.00,0.00,EUR,COMPLETED,391.84
Card Payment,Current,2025-03-03 17:21:21,2025-03-04 08:37:43,SuperValu,-29.15,0.00,EUR,COMPLETED,362.69
Transfer,Current,2025-03-04 14:55:21,2025-03-04 14:55:21,To Instant Access Savings,-2.55,0.00,EUR,COMPLETED,360.14
Transfer,Current,2025-03-04 19:03:47,2025-03-04 19:03:47,To Instant Access Savings,-2.25,0.00,EUR,COMPLETED,357.89
Transfer,Current,2025-03-04 17:05:52,2025-03-05 01:49:56,To Colm Quish,-30.00,0.00,EUR,COMPLETED,327.89
Transfer,Current,2025-03-05 08:20:00,2025-03-05 08:20:00,To Instant Access Savings,-1.50,0.00,EUR,COMPLETED,326.39
Transfer,Current,2025-03-05 09:10:10,2025-03-05 09:10:10,To Instant Access Savings,-2.50,0.00,EUR,COMPLETED,323.89
Card Payment,Current,2025-03-04 19:03:47,2025-03-05 10:08:34,SuperValu,-9.55,0.00,EUR,COMPLETED,314.34
Card Payment,Current,2025-03-04 14:55:21,2025-03-05 11:54:36,HP,-1.49,0.00,EUR,COMPLETED,312.85
Transfer,Current,2025-03-05 12:20:12,2025-03-05 12:20:12,To Instant Access Savings,-2.50,0.00,EUR,COMPLETED,310.35
Card Payment,Current,2025-03-05 09:10:09,2025-03-06 09:03:13,Spar,-8.50,0.00,EUR,COMPLETED,301.85
Card Payment,Current,2025-03-05 12:20:11,2025-03-06 10:48:47,Centra,-4.50,0.00,EUR,COMPLETED,297.35
Card Payment,Current,2025-03-05 08:20:00,2025-03-06 13:34:41,Kaldi's Coffee,-3.70,0.00,EUR,COMPLETED,293.65
Transfer,Current,2025-03-06 20:59:28,2025-03-06 20:59:28,To Instant Access Savings,-2.15,0.00,EUR,COMPLETED,291.50
Transfer,Current,2025-03-07 08:20:09,2025-03-07 08:20:09,To Instant Access Savings,-2.50,0.00,EUR,COMPLETED,289.00
Transfer,Current,2025-03-07 13:44:41,2025-03-07 13:44:41,To Instant Access Savings,-3.00,0.00,EUR,COMPLETED,286.00
Transfer,Current,2025-03-07 14:23:05,2025-03-07 14:23:05,To Instant Access Savings,-5.00,0.00,EUR,COMPLETED,281.00
Transfer,Current,2025-03-07 19:26:56,2025-03-07 19:26:56,To Instant Access Savings,-0.35,0.00,EUR,COMPLETED,280.65
Transfer,Current,2025-03-07 19:27:31,2025-03-07 19:27:31,Transfer from MARA DI RAIMONDO,22.93,0.00,EUR,COMPLETED,303.58
Card Payment,Current,2025-03-07 13:44:40,2025-03-08 09:18:08,UTS Parking and Transportation,-2.40,0.00,EUR,COMPLETED,301.18
Card Payment,Current,2025-03-07 08:20:08,2025-03-08 09:18:51,Mint,-8.50,0.00,EUR,COMPLETED,292.68
Card Payment,Current,2025-03-07 14:23:04,2025-03-08 09:28:23,KSG Catering,-6.00,0.00,EUR,COMPLETED,286.68
Card Payment,Current,2025-03-07 19:26:56,2025-03-08 09:54:54,Deliveroo,-22.93,0.00,EUR,COMPLETED,263.75
Transfer,Current,2025-03-08 10:29:42,2025-03-08 10:29:42,To Instant Access Savings,-4.00,0.00,EUR,COMPLETED,259.75
Transfer,Current,2025-03-08 10:34:37,2025-03-08 10:34:37,To Instant Access Savings,-4.25,0.00,EUR,COMPLETED,255.50
Transfer,Current,2025-03-08 11:35:17,2025-03-08 11:35:17,To Instant Access Savings,-0.50,0.00,EUR,COMPLETED,255.00
Transfer,Current,2025-03-08 13:00:09,2025-03-08 13:00:10,Transfer to BRYAN DALTON,-20.00,0.00,EUR,COMPLETED,235.00
Transfer,Current,2025-03-08 13:03:12,2025-03-08 13:03:12,To Instant Access Savings,-1.00,0.00,EUR,COMPLETED,234.00
Transfer,Current,2025-03-08 13:07:25,2025-03-08 13:07:25,To Instant Access Savings,-0.50,0.00,EUR,COMPLETED,233.50
Transfer,Current,2025-03-08 13:54:21,2025-03-08 13:54:21,To Instant Access Savings,-5.00,0.00,EUR,COMPLETED,228.50
Card Payment,Current,2025-03-06 20:59:28,2025-03-08 14:38:38,Amazon,-10.57,0.00,EUR,COMPLETED,217.93
Transfer,Current,2025-03-08 14:50:54,2025-03-08 14:50:54,To Instant Access Savings,-3.00,0.00,EUR,COMPLETED,214.93
Transfer,Current,2025-03-08 15:45:05,2025-03-08 15:45:05,To Instant Access Savings,-3.00,0.00,EUR,COMPLETED,211.93
Transfer,Current,2025-03-08 19:25:29,2025-03-08 19:25:29,To Instant Access Savings,-2.60,0.00,EUR,COMPLETED,209.33
Card Payment,Current,2025-03-08 11:35:16,2025-03-09 08:57:56,ODEON,-31.90,0.00,EUR,COMPLETED,177.43
Card Payment,Current,2025-03-08 13:03:12,2025-03-09 08:58:13,Parking Payments,-2.80,0.00,EUR,COMPLETED,174.63
Card Payment,Current,2025-03-08 13:54:20,2025-03-09 08:59:12,Parking Payments,-5.00,0.00,EUR,COMPLETED,169.63
Card Payment,Current,2025-03-08 19:25:28,2025-03-09 09:27:55,Camile Thai,-33.48,0.00,EUR,COMPLETED,136.15
Transfer,Current,2025-03-09 10:57:18,2025-03-09 10:57:18,To Instant Access Savings,-0.35,0.00,EUR,COMPLETED,135.80
Transfer,Current,2025-03-09 11:07:23,2025-03-09 11:07:23,To Instant Access Savings,-0.35,0.00,EUR,COMPLETED,135.45
Card Payment,Current,2025-03-08 10:34:37,2025-03-09 13:43:58,Applegreen,-6.15,0.00,EUR,COMPLETED,129.30
Card Payment,Current,2025-03-08 10:29:41,2025-03-09 13:44:02,Applegreen,-12.20,0.00,EUR,COMPLETED,117.10
Transfer,Current,2025-03-09 14:28:45,2025-03-09 14:28:45,To Instant Access Savings,-5.00,0.00,EUR,COMPLETED,112.10
Transfer,Current,2025-03-09 17:07:06,2025-03-09 17:07:06,From Instant Access Savings,125.00,0.00,EUR,COMPLETED,237.10
Transfer,Current,2025-03-09 17:07:41,2025-03-09 17:07:41,To Instant Access Savings,-0.05,0.00,EUR,COMPLETED,237.05
Card Payment,Current,2025-03-08 15:45:05,2025-03-10 11:41:21,The Circular,-6.40,0.00,EUR,COMPLETED,230.65
Card Payment,Current,2025-03-08 14:50:54,2025-03-10 11:44:49,The Circular,-6.40,0.00,EUR,COMPLETED,224.25
Card Payment,Current,2025-03-08 13:07:24,2025-03-10 11:45:50,Hillbilly's,-23.90,0.00,EUR,COMPLETED,200.35
Card Payment,Current,2025-03-09 14:28:45,2025-03-10 12:11:27,SuperValu,-8.00,0.00,EUR,COMPLETED,192.35
Card Payment,Current,2025-03-09 17:07:41,2025-03-10 12:13:30,PlayStation,-49.99,0.00,EUR,COMPLETED,142.36
Transfer,Current,2025-03-10 22:07:15,2025-03-10 22:07:15,From Instant Access Savings,200.00,0.00,EUR,COMPLETED,342.36
Transfer,Current,2025-03-11 00:00:00,2025-03-11 11:44:53,To Flogas Natural Gas,-186.23,0.00,EUR,COMPLETED,156.13
Transfer,Current,2025-03-11 12:44:18,2025-03-11 12:44:18,To Instant Access Savings,-2.50,0.00,EUR,COMPLETED,153.63
Card Payment,Current,2025-03-09 10:57:18,2025-03-11 14:27:39,Cuc Ql Xuat Nhap Canh,-23.93,0.24,EUR,COMPLETED,129.46
Card Payment,Current,2025-03-09 11:07:23,2025-03-11 14:27:39,Cuc Ql Xuat Nhap Canh,-23.93,0.24,EUR,COMPLETED,105.29
Card Payment,Current,2025-03-11 12:44:17,2025-03-12 09:28:57,Centra,-10.50,0.00,EUR,COMPLETED,94.79
Transfer,Current,2025-03-12 13:27:10,2025-03-12 13:27:11,To Instant Access Savings,-0.50,0.00,EUR,COMPLETED,94.29
Transfer,Current,2025-03-12 15:09:05,2025-03-12 15:09:05,From Instant Access Savings,133.93,0.00,EUR,COMPLETED,228.22
Transfer,Current,2025-03-13 08:18:11,2025-03-13 08:18:11,To Instant Access Savings,-0.05,0.00,EUR,COMPLETED,228.17
Card Payment,Current,2025-03-12 13:27:10,2025-03-13 11:27:55,SuperValu,-37.90,0.00,EUR,COMPLETED,190.27
Transfer,Current,2025-03-13 17:20:21,2025-03-13 17:20:21,To Instant Access Savings,-4.60,0.00,EUR,COMPLETED,185.67
Transfer,Current,2025-03-13 17:26:32,2025-03-13 17:26:32,To Instant Access Savings,-3.75,0.00,EUR,COMPLETED,181.92
Transfer,Current,2025-03-13 19:00:23,2025-03-13 19:00:23,To Instant Access Savings,-2.50,0.00,EUR,COMPLETED,179.42
Transfer,Current,2025-03-13 20:39:44,2025-03-13 20:39:44,Transfer from MARA DI RAIMONDO,23.08,0.00,EUR,COMPLETED,202.50
Transfer,Current,2025-03-13 22:18:00,2025-03-13 22:18:00,To Instant Access Savings,-5.00,0.00,EUR,COMPLETED,197.50
Transfer,Current,2025-03-13 23:22:55,2025-03-13 23:22:55,To Instant Access Savings,-5.00,0.00,EUR,COMPLETED,192.50
Transfer,Current,2025-03-13 23:43:33,2025-03-13 23:43:33,To Instant Access Savings,-5.00,0.00,EUR,COMPLETED,187.50
Transfer,Current,2025-03-14 00:06:29,2025-03-14 00:06:29,To Instant Access Savings,-0.75,0.00,EUR,COMPLETED,186.75
Transfer,Current,2025-03-14 00:32:14,2025-03-14 00:32:14,From Instant Access Savings,100.00,0.00,EUR,COMPLETED,286.75
Transfer,Current,2025-03-14 00:32:27,2025-03-14 00:32:27,To Instant Access Savings,-5.00,0.00,EUR,COMPLETED,281.75
Transfer,Current,2025-03-14 01:03:36,2025-03-14 01:03:36,To Instant Access Savings,-3.00,0.00,EUR,COMPLETED,278.75
Card Payment,Current,2025-03-13 08:18:11,2025-03-14 10:08:36,Clark’s Newsagent,-8.99,0.00,EUR,COMPLETED,269.76
Card Payment,Current,2025-03-13 17:20:20,2025-03-14 10:24:44,Deliveroo,-23.08,0.00,EUR,COMPLETED,246.68
Card Payment,Current,2025-03-14 00:32:26,2025-03-14 10:53:33,Pawn Shop,-10.00,0.00,EUR,COMPLETED,236.68
Card Payment,Current,2025-03-14 00:06:29,2025-03-14 10:54:25,Pawn Shop,-33.85,0.00,EUR,COMPLETED,202.83
Card Payment,Current,2025-03-13 23:43:33,2025-03-14 11:13:42,SPAR Food & Fuel,-10.00,0.00,EUR,COMPLETED,192.83
Card Payment,Current,2025-03-13 23:22:55,2025-03-14 11:14:39,O Regans Bar,-28.00,0.00,EUR,COMPLETED,164.83
Card Payment,Current,2025-03-13 17:26:32,2025-03-14 11:25:25,Boojum,-14.25,0.00,EUR,COMPLETED,150.58
Transfer,Current,2025-03-14 11:30:02,2025-03-14 11:30:02,Transfer from Revolut user,3.59,0.00,EUR,COMPLETED,154.17
Card Payment,Current,2025-03-13 19:00:23,2025-03-14 11:30:27,The Stags Head,-29.50,0.00,EUR,COMPLETED,124.67
Transfer,Current,2025-03-14 11:30:30,2025-03-14 11:30:30,To Instant Access Savings,-4.55,0.00,EUR,COMPLETED,120.12
Card Payment,Current,2025-03-13 22:18:00,2025-03-14 11:31:29,The Liquor Rooms,-15.00,0.00,EUR,COMPLETED,105.12
Transfer,Current,2025-03-14 11:41:03,2025-03-14 11:41:03,To Instant Access Savings,-5.00,0.00,EUR,COMPLETED,100.12
Transfer,Current,2025-03-14 19:02:23,2025-03-14 19:02:23,To Instant Access Savings,-5.00,0.00,EUR,COMPLETED,95.12
Fee,Current,2025-03-15 00:22:08,2025-03-15 00:22:08,Premium plan fee,-90.00,0.00,EUR,COMPLETED,5.12
Transfer,Current,2025-03-15 08:22:01,2025-03-15 08:22:01,From Instant Access Savings,200.00,0.00,EUR,COMPLETED,205.12
Card Payment,Current,2025-03-14 11:41:03,2025-03-15 09:22:22,Payzone,-10.00,0.00,EUR,COMPLETED,195.12
Transfer,Current,2025-03-15 09:32:31,2025-03-15 09:32:31,To Instant Access Savings,-5.00,0.00,EUR,COMPLETED,190.12
Transfer,Current,2025-03-15 09:56:25,2025-03-15 09:56:25,To Instant Access Savings,-3.50,0.00,EUR,COMPLETED,186.62
Card Payment,Current,2025-03-14 11:30:21,2025-03-15 16:56:01,Tst Parlour Restaurant,-27.09,0.00,EUR,COMPLETED,159.53
Card Payment,Current,2025-03-14 01:03:36,2025-03-15 17:08:58,Taxi N6584,-21.40,0.00,EUR,COMPLETED,138.13
Transfer,Current,2025-03-15 20:18:27,2025-03-15 20:18:27,To Instant Access Savings,-2.60,0.00,EUR,COMPLETED,135.53
Transfer,Current,2025-03-16 09:50:24,2025-03-16 09:50:24,To Instant Access Savings,-4.60,0.00,EUR,COMPLETED,130.93
Transfer,Current,2025-03-16 09:55:16,2025-03-16 09:55:16,To Instant Access Savings,-0.05,0.00,EUR,COMPLETED,130.88
Card Payment,Current,2025-03-15 09:56:24,2025-03-16 09:59:48,Applegreen,-13.30,0.00,EUR,COMPLETED,117.58
Transfer,Current,2025-03-16 10:57:45,2025-03-16 10:57:45,To Instant Access Savings,-2.70,0.00,EUR,COMPLETED,114.88
Transfer,Current,2025-03-16 11:18:04,2025-03-16 11:18:04,To Instant Access Savings,-4.00,0.00,EUR,COMPLETED,110.88
Transfer,Current,2025-03-16 11:45:16,2025-03-16 11:45:16,To Instant Access Savings,-5.00,0.00,EUR,COMPLETED,105.88
Card Payment,Current,2025-03-15 20:18:26,2025-03-16 12:00:12,Amazon,-3.48,0.03,EUR,COMPLETED,102.37
Card Payment,Current,2025-03-15 09:32:30,2025-03-16 15:29:47,Dublin Waste to Energy Facility,-15.00,0.00,EUR,COMPLETED,87.37
Transfer,Current,2025-03-16 19:35:54,2025-03-16 19:35:54,To Instant Access Savings,-0.50,0.00,EUR,COMPLETED,86.87
Transfer,Current,2025-03-16 21:59:35,2025-03-16 21:59:35,From Instant Access Savings,50.00,0.00,EUR,COMPLETED,136.87
Transfer,Current,2025-03-16 21:59:47,2025-03-16 21:59:47,To Instant Access Savings,-3.70,0.00,EUR,COMPLETED,133.17
Transfer,Current,2025-03-17 06:02:25,2025-03-17 06:02:25,To Instant Access Savings,-0.05,0.00,EUR,COMPLETED,133.12
Transfer,Current,2025-03-17 06:04:51,2025-03-17 06:04:51,To Instant Access Savings,-4.50,0.00,EUR,COMPLETED,128.62
Transfer,Current,2025-03-17 06:41:17,2025-03-17 06:41:17,To Instant Access Savings,-2.00,0.00,EUR,COMPLETED,126.62
Card Payment,Current,2025-03-14 19:02:23,2025-03-17 08:24:36,Easytrip,-10.00,0.00,EUR,COMPLETED,116.62
Card Payment,Current,2025-03-16 11:18:03,2025-03-17 10:13:28,Donnybrook Fair,-12.20,0.00,EUR,COMPLETED,104.42
Card Payment,Current,2025-03-16 10:57:45,2025-03-17 10:15:14,Holland & Barrett,-2.46,0.00,EUR,COMPLETED,101.96
Card Payment,Current,2025-03-16 19:35:53,2025-03-17 10:16:27,McDonald's,-13.90,0.00,EUR,COMPLETED,88.06
Card Payment,Current,2025-03-16 11:45:15,2025-03-17 12:22:07,Lovisa,-20.00,0.00,EUR,COMPLETED,68.06
Card Payment,Current,2025-03-16 09:50:24,2025-03-17 13:16:04,Tesco,-16.08,0.00,EUR,COMPLETED,51.98
Card Payment,Current,2025-03-16 21:59:47,2025-03-17 14:17:30,Amazon,-14.26,0.14,EUR,COMPLETED,37.58
Transfer,Current,2025-03-17 15:42:34,2025-03-17 15:42:34,From Instant Access Savings,753.00,0.00,EUR,COMPLETED,790.58
Transfer,Current,2025-03-17 15:44:21,2025-03-17 15:44:21,To Instant Access Savings,-2.85,0.00,EUR,COMPLETED,787.73
Transfer,Current,2025-03-17 15:44:55,2025-03-17 15:44:55,To Instant Access Savings,-4.50,0.00,EUR,COMPLETED,783.23
Card Payment,Current,2025-03-16 09:55:15,2025-03-17 15:59:53,The Washington Post,-0.99,0.00,EUR,COMPLETED,782.24
Transfer,Current,2025-03-17 16:01:50,2025-03-17 16:01:50,To Instant Access Savings,-3.40,0.00,EUR,COMPLETED,778.84
Transfer,Current,2025-03-17 19:11:42,2025-03-17 19:11:42,To Instant Access Savings,-0.85,0.00,EUR,COMPLETED,777.99
Transfer,Current,2025-03-18 01:34:27,2025-03-18 01:34:27,To Instant Access Savings,-1.20,0.00,EUR,COMPLETED,776.79
Card Payment,Current,2025-03-17 06:02:25,2025-03-18 10:45:03,WHSmith,-19.99,0.00,EUR,COMPLETED,756.80
Card Payment,Current,2025-03-17 06:41:17,2025-03-18 10:45:05,WHSmith,-2.60,0.00,EUR,COMPLETED,754.20
Card Payment,Current,2025-03-17 06:04:51,2025-03-18 11:27:18,Butlers Chocolates,-5.10,0.00,EUR,COMPLETED,749.10
Transfer,Current,2025-03-18 12:09:54,2025-03-18 12:09:54,To Instant Access Savings,-4.80,0.00,EUR,COMPLETED,744.30
Card Payment,Current,2025-03-17 15:44:20,2025-03-18 15:09:35,Airalo,-29.43,0.00,EUR,COMPLETED,714.87
Card Payment,Current,2025-03-18 22:41:29,,Cursor,-18.37,0.00,EUR,REVERTED,
Transfer,Current,2025-03-18 22:41:30,2025-03-18 22:41:30,To Instant Access Savings,-3.15,0.00,EUR,COMPLETED,711.72
Transfer,Current,2025-03-19 03:53:09,2025-03-19 03:53:09,Transfer from MARA DI RAIMONDO,18.04,0.00,EUR,COMPLETED,729.76
Transfer,Current,2025-03-19 07:42:53,2025-03-19 07:42:54,To Instant Access Savings,-4.00,0.00,EUR,COMPLETED,725.76
Transfer,Current,2025-03-19 00:00:00,2025-03-19 11:41:40,To Flogas Natural Gas,-78.01,0.00,EUR,COMPLETED,647.75
Transfer,Current,2025-03-19 12:47:17,2025-03-19 12:47:17,To Instant Access Savings,-1.65,0.00,EUR,COMPLETED,646.10
Card Payment,Current,2025-03-18 01:34:27,2025-03-19 15:52:49,Ha Noi Coffee Cultre,-5.76,0.00,EUR,COMPLETED,640.34
ATM,Current,2025-03-18 10:26:46,2025-03-19 15:59:25,Cash withdrawal at Vpbank Nguyenhuuhuan Cdm,-36.01,0.00,EUR,COMPLETED,604.33
ATM,Current,2025-03-19 08:51:17,2025-03-19 16:00:01,Cash withdrawal at Vpbank Nguyenhuuhuan Cdm,-36.11,0.00,EUR,COMPLETED,568.22
ATM,Current,2025-03-19 08:50:24,2025-03-19 16:00:54,Cash withdrawal at Vpbank Nguyenhuuhuan Cdm,-36.11,0.00,EUR,COMPLETED,532.11
Card Payment,Current,2025-03-17 16:01:49,2025-03-19 16:03:18,Qatar Duty Free - QDF,-6.32,0.00,EUR,COMPLETED,525.79
Card Payment,Current,2025-03-17 15:44:53,2025-03-19 16:04:38,Joe & the Juice,-10.10,0.00,EUR,COMPLETED,515.69
Transfer,Current,2025-03-20 02:14:15,2025-03-20 02:14:15,To Instant Access Savings,-1.95,0.00,EUR,COMPLETED,513.74
Card Payment,Current,2025-03-17 19:11:42,2025-03-20 16:07:42,Classyc Hotel 3,-96.83,0.00,EUR,COMPLETED,416.91
Card Payment,Current,2025-03-19 12:47:17,2025-03-20 16:11:50,Timeline Coffee,-12.67,0.00,EUR,COMPLETED,404.24
Card Payment,Current,2025-03-18 12:09:53,2025-03-20 16:13:09,Maison Du Jade,-18.04,0.00,EUR,COMPLETED,386.20
Transfer,Current,2025-03-21 04:42:55,2025-03-21 04:42:55,To Instant Access Savings,-2.65,0.00,EUR,COMPLETED,383.55
Transfer,Current,2025-03-21 04:50:58,2025-03-21 04:50:59,Transfer from MARA DI RAIMONDO,18.01,0.00,EUR,COMPLETED,401.56
Transfer,Current,2025-03-21 04:51:05,2025-03-21 04:51:05,Transfer from MARA DI RAIMONDO,18.06,0.00,EUR,COMPLETED,419.62
Transfer,Current,2025-03-21 05:46:23,2025-03-21 05:46:23,To Instant Access Savings,-2.25,0.00,EUR,COMPLETED,417.37
Transfer,Current,2025-03-21 11:11:52,2025-03-21 11:11:53,To Instant Access Savings,-0.05,0.00,EUR,COMPLETED,417.32
Transfer,Current,2025-03-21 12:22:49,2025-03-21 12:22:49,To Instant Access Savings,-4.65,0.00,EUR,COMPLETED,412.67
Transfer,Current,2025-03-21 13:50:55,2025-03-21 13:50:55,To Instant Access Savings,-0.65,0.00,EUR,COMPLETED,412.02
Card Payment,Current,2025-03-20 02:14:14,2025-03-21 15:45:03,My Nghe Phuong Anh 1,-3.61,0.00,EUR,COMPLETED,408.41
Card Payment,Current,2025-03-19 07:42:53,2025-03-21 15:50:32,Sua Ca Phe,-4.20,0.00,EUR,COMPLETED,404.21
Transfer,Current,2025-03-22 05:23:43,2025-03-22 05:23:43,Transfer from MARA DI RAIMONDO,60.00,0.00,EUR,COMPLETED,464.21
Transfer,Current,2025-03-22 05:24:07,2025-03-22 05:24:07,Transfer from MARA DI RAIMONDO,92.66,0.00,EUR,COMPLETED,556.87
Card Refund,Current,2025-03-21 06:07:33,2025-03-22 15:08:56,Amazon,10.93,-0.11,EUR,COMPLETED,567.91
Card Payment,Current,2025-03-21 05:46:23,2025-03-22 15:15:09,Acv Noi Bai,-2.55,0.00,EUR,COMPLETED,565.36
Transfer,Current,2025-03-23 03:38:12,2025-03-23 03:38:12,Transfer from MARA DI RAIMONDO,24.62,0.00,EUR,COMPLETED,589.98
Transfer,Current,2025-03-23 13:07:12,2025-03-23 13:07:12,To Instant Access Savings,-1.50,0.00,EUR,COMPLETED,588.48
Transfer,Current,2025-03-23 13:28:40,2025-03-23 13:28:40,To Instant Access Savings,-2.45,0.00,EUR,COMPLETED,586.03
ATM,Current,2025-03-22 11:39:15,2025-03-23 15:18:19,Cash withdrawal at Acb Atm Hoi An Market,-72.62,0.73,EUR,COMPLETED,512.68
Card Payment,Current,2025-03-21 11:11:51,2025-03-23 15:31:22,Vnpay Tired City,-5.99,0.00,EUR,COMPLETED,506.69
Card Payment,Current,2025-03-21 13:50:49,2025-03-23 15:31:24,Mpos Metrestaurant2,-20.87,0.00,EUR,COMPLETED,485.82
Card Payment,Current,2025-03-21 12:22:49,2025-03-23 15:32:23,Mango,-6.07,0.00,EUR,COMPLETED,479.75
Card Payment,Current,2025-03-21 04:42:54,2025-03-23 15:35:30,Sky 1 T1,-6.47,0.00,EUR,COMPLETED,473.28
Card Payment,Current,2025-03-24 03:48:04,,Grab,-0.04,0.00,EUR,REVERTED,
Transfer,Current,2025-03-24 03:48:04,2025-03-24 03:48:04,To Instant Access Savings,-4.80,0.00,EUR,COMPLETED,468.48
Transfer,Current,2025-03-24 04:04:09,2025-03-24 04:04:09,To Instant Access Savings,-0.50,0.00,EUR,COMPLETED,467.98
Transfer,Current,2025-03-24 00:00:00,2025-03-24 11:47:30,To eFlow,-11.83,0.00,EUR,COMPLETED,456.15
Topup,Current,2025-03-24 12:25:28,2025-03-24 12:25:30,Payment from HANLEY & LYNCH SOLICITORS,641.73,0.00,EUR,COMPLETED,1097.88
Transfer,Current,2025-03-25 02:54:11,2025-03-25 02:54:11,To Instant Access Savings,-3.60,0.00,EUR,COMPLETED,1094.28
Transfer,Current,2025-03-25 06:07:19,2025-03-25 06:07:21,To Payward Ireland Ltd.,-1.00,0.00,EUR,COMPLETED,1093.28
Transfer,Current,2025-03-25 06:09:57,2025-03-25 06:09:59,To Payward Ireland Ltd.,-99.00,0.00,EUR,COMPLETED,994.28
Topup,Current,2025-03-25 06:51:27,2025-03-25 06:51:27,Payment from WORKDAY LIMITED,2972.93,0.00,EUR,COMPLETED,3967.21
Transfer,Current,2025-03-25 07:44:01,2025-03-25 07:44:01,Credit card repayment,-1000.00,0.00,EUR,COMPLETED,2967.21
Transfer,Current,2025-03-25 07:22:43,2025-03-25 07:51:38,To Trading 212 UK Limited,-500.00,0.00,EUR,COMPLETED,2467.21
Transfer,Current,2025-03-25 08:37:16,2025-03-25 08:37:16,To pocket EUR Subscriptions from EUR,-250.00,0.00,EUR,COMPLETED,2217.21
Transfer,Current,2025-03-25 00:00:00,2025-03-25 11:47:15,To Royal London,-16.72,0.00,EUR,COMPLETED,2200.49
Card Payment,Current,2025-03-23 13:07:11,2025-03-25 13:54:34,Vnpay Namthanh 3,-22.70,0.23,EUR,COMPLETED,2177.56
Card Payment,Current,2025-03-23 13:28:39,2025-03-25 13:59:17,Phe La Chi Nhanh Hoi An,-2.51,0.03,EUR,COMPLETED,2175.02
Card Payment,Current,2025-03-24 04:04:09,2025-03-25 13:59:30,Grab,-6.90,0.00,EUR,COMPLETED,2168.12
Transfer,Current,2025-03-26 01:19:48,2025-03-26 01:19:48,To Instant Access Savings,-500.00,0.00,EUR,COMPLETED,1668.12
Transfer,Current,2025-03-26 12:18:09,2025-03-26 12:18:09,To Instant Access Savings,-3.00,0.00,EUR,COMPLETED,1665.12
Transfer,Current,2025-03-26 12:55:06,2025-03-26 12:55:06,Transfer from MARA DI RAIMONDO,21.64,0.00,EUR,COMPLETED,1686.76
Transfer,Current,2025-03-26 13:10:05,2025-03-26 13:10:05,To Instant Access Savings,-2.40,0.00,EUR,COMPLETED,1684.36
Transfer,Current,2025-03-26 14:17:26,2025-03-26 14:17:26,To Instant Access Savings,-4.35,0.00,EUR,COMPLETED,1680.01
Card Payment,Current,2025-03-25 02:54:11,2025-03-26 16:00:55,Grab,-43.28,0.00,EUR,COMPLETED,1636.73
Transfer,Current,2025-03-27 11:08:55,2025-03-27 11:08:55,To Instant Access Savings,-3.75,0.00,EUR,COMPLETED,1632.98
Transfer,Current,2025-03-27 15:42:29,2025-03-27 15:42:29,To Instant Access Savings,-0.10,0.00,EUR,COMPLETED,1632.88
Card Payment,Current,2025-03-26 13:10:03,2025-03-27 16:14:31,Adidas,-65.52,0.00,EUR,COMPLETED,1567.36
Transfer,Current,2025-03-27 19:40:37,2025-03-27 19:40:37,To Instant Access Savings,-3.45,0.00,EUR,COMPLETED,1563.91
Transfer,Current,2025-03-27 23:34:07,2025-03-27 23:34:07,To Instant Access Savings,-0.05,0.00,EUR,COMPLETED,1563.86
Transfer,Current,2025-03-28 08:57:28,2025-03-28 08:57:28,To Instant Access Savings,-4.75,0.00,EUR,COMPLETED,1559.11
Card Payment,Current,2025-03-28 09:05:59,,The New York Times,-0.94,0.00,EUR,REVERTED,
Transfer,Current,2025-03-28 09:06:00,2025-03-28 09:06:00,To Instant Access Savings,-0.30,0.00,EUR,COMPLETED,1558.81
Transfer,Current,2025-03-28 09:06:02,2025-03-28 09:06:02,To Instant Access Savings,-5.00,0.00,EUR,COMPLETED,1553.81
Transfer,Current,2025-03-28 11:05:39,2025-03-28 11:05:40,To Instant Access Savings,-1.50,0.00,EUR,COMPLETED,1552.31
Card Payment,Current,2025-03-27 19:40:37,2025-03-28 14:52:02,YUNO,-64.31,0.00,EUR,COMPLETED,1488.00
Card Payment,Current,2025-03-27 23:34:07,2025-03-28 15:32:55,Apple,-9.99,0.00,EUR,COMPLETED,1478.01
ATM,Current,2025-03-27 11:42:13,2025-03-28 17:40:24,Cash withdrawal at Acb Atm Hoi An Market,-109.36,0.00,EUR,COMPLETED,1368.65
Card Payment,Current,2025-03-26 12:18:08,2025-03-28 17:48:50,Grab,-6.40,0.00,EUR,COMPLETED,1362.25
Card Payment,Current,2025-03-26 14:17:23,2025-03-28 17:48:51,Grab,-6.13,0.00,EUR,COMPLETED,1356.12
Transfer,Current,2025-03-29 03:40:46,2025-03-29 03:40:46,Transfer from MARA DI RAIMONDO,300.00,0.00,EUR,COMPLETED,1656.12
Transfer,Current,2025-03-29 03:45:35,2025-03-29 03:45:36,To Instant Access Savings,-3.55,0.00,EUR,COMPLETED,1652.57
Transfer,Current,2025-03-29 04:13:18,2025-03-29 04:13:18,To Instant Access Savings,-0.90,0.00,EUR,COMPLETED,1651.67
Transfer,Current,2025-03-29 04:13:46,2025-03-29 04:13:46,Transfer from MARA DI RAIMONDO,71.82,0.00,EUR,COMPLETED,1723.49
Transfer,Current,2025-03-29 04:14:54,2025-03-29 04:14:54,To Instant Access Savings,-3.10,0.00,EUR,COMPLETED,1720.39
Transfer,Current,2025-03-29 07:15:36,2025-03-29 07:15:36,To Instant Access Savings,-4.90,0.00,EUR,COMPLETED,1715.49
Transfer,Current,2025-03-29 07:16:10,2025-03-29 07:16:10,Transfer from Robin O Connell,33.00,0.00,EUR,COMPLETED,1748.49
Transfer,Current,2025-03-29 11:19:34,2025-03-29 11:19:35,Transfer to Robin O Connell,-5.00,0.00,EUR,COMPLETED,1743.49
Transfer,Current,2025-03-29 11:19:49,2025-03-29 11:19:51,Transfer to Robin O Connell,-3.00,0.00,EUR,COMPLETED,1740.49
Transfer,Current,2025-03-29 11:21:10,2025-03-29 11:21:10,To Instant Access Savings,-1.10,0.00,EUR,COMPLETED,1739.39
Card Payment,Current,2025-03-28 08:57:27,2025-03-29 15:16:21,Amazon,-10.05,0.00,EUR,COMPLETED,1729.34
Transfer,Current,2025-03-29 15:58:41,2025-03-29 15:58:42,To Instant Access Savings,-3.35,0.00,EUR,COMPLETED,1725.99
Transfer,Current,2025-03-29 16:07:22,2025-03-29 16:07:22,To Instant Access Savings,-1.65,0.00,EUR,COMPLETED,1724.34
Card Payment,Current,2025-03-27 11:08:54,2025-03-29 17:20:12,Grab,-6.25,0.00,EUR,COMPLETED,1718.09
Card Payment,Current,2025-03-27 15:40:56,2025-03-29 17:20:22,Grab,-5.98,0.00,EUR,COMPLETED,1712.11
Card Payment,Current,2025-03-28 09:06:02,2025-03-29 17:32:01,The New York Times,-25.00,0.00,EUR,COMPLETED,1687.11
Transfer,Current,2025-03-29 18:21:47,2025-03-29 18:21:48,To Instant Access Savings,-2.95,0.00,EUR,COMPLETED,1684.16
Card Payment,Current,2025-03-29 03:45:35,2025-03-30 14:04:48,Fusion Da Nang,-398.29,3.98,EUR,COMPLETED,1281.89
Card Payment,Current,2025-03-29 04:13:17,2025-03-30 14:04:48,Fusion Da Nang,-71.82,0.72,EUR,COMPLETED,1209.35
Card Payment,Current,2025-03-28 11:05:38,2025-03-30 14:07:29,Grab,-5.70,0.00,EUR,COMPLETED,1203.65
Card Payment,Current,2025-03-29 04:14:53,2025-03-30 14:07:36,Grab,-2.38,0.02,EUR,COMPLETED,1201.25
ATM,Current,2025-03-29 12:04:49,2025-03-30 14:19:17,Cash withdrawal at Acb Atm Hoi An Market,-72.60,0.73,EUR,COMPLETED,1127.92
Transfer,Current,2025-03-30 20:50:58,2025-03-30 20:50:58,To Instant Access Savings,-0.60,0.00,EUR,COMPLETED,1127.32
Transfer,Current,2025-03-30 21:21:38,2025-03-30 21:21:38,To Instant Access Savings,-0.35,0.00,EUR,COMPLETED,1126.97
Transfer,Current,2025-03-31 13:34:26,2025-03-31 13:34:27,Transfer from CONOR THOMAS BONFIL,90.00,0.00,EUR,COMPLETED,1216.97
Transfer,Current,2025-03-31 15:04:27,2025-03-31 15:04:28,To Instant Access Savings,-3.95,0.00,EUR,COMPLETED,1213.02
Transfer,Current,2025-03-31 15:05:01,2025-03-31 15:05:02,To Instant Access Savings,-0.80,0.00,EUR,COMPLETED,1212.22
Transfer,Current,2025-03-31 15:56:25,2025-03-31 15:56:57,To Instant Access Savings,-0.80,0.00,EUR,COMPLETED,1211.42
Card Payment,Current,2025-03-29 18:21:46,2025-03-31 17:08:02,Diem Diem Cloth Shop,-31.41,0.31,EUR,COMPLETED,1179.70
Card Payment,Current,2025-03-29 11:21:07,2025-03-31 17:08:37,Grab,-11.78,0.12,EUR,COMPLETED,1167.80
Card Payment,Current,2025-03-29 07:15:35,2025-03-31 17:12:39,Hyattregencydanangresort$,-81.02,0.81,EUR,COMPLETED,1085.97
Transfer,Current,2025-04-01 09:13:09,2025-04-01 09:13:09,To Instant Access Savings,-2.55,0.00,EUR,COMPLETED,1083.42
Transfer,Current,2025-04-01 09:19:54,2025-04-01 09:20:00,To Instant Access Savings,-2.45,0.00,EUR,COMPLETED,1080.97
Transfer,Current,2025-04-01 09:20:42,2025-04-01 09:20:47,To Instant Access Savings,-3.10,0.00,EUR,COMPLETED,1077.87
Transfer,Current,2025-04-01 09:21:32,2025-04-01 09:21:32,To Instant Access Savings,-3.75,0.00,EUR,COMPLETED,1074.12
Transfer,Current,2025-04-01 10:31:40,2025-04-01 10:31:42,From Instant Access Savings,1600.00,0.00,EUR,COMPLETED,2674.12
Transfer,Current,2025-04-01 10:47:51,2025-04-01 10:47:53,To Instant Access Savings,-4.80,0.00,EUR,COMPLETED,2669.32
Card Payment,Current,2025-03-29 15:58:41,2025-04-01 15:52:24,Cty Tnhh Tm Dv Taste Of V,-29.33,0.29,EUR,COMPLETED,2639.70
Card Payment,Current,2025-03-29 16:07:17,2025-04-01 15:52:24,Cty Tnhh Tm Dv Taste Of V,-3.67,0.04,EUR,COMPLETED,2635.99
Card Payment,Current,2025-03-30 20:50:58,2025-04-01 16:03:06,Ct Silver Shore F01,-188.88,1.89,EUR,COMPLETED,2445.22
Card Payment,Current,2025-03-30 21:21:38,2025-04-01 16:03:45,Grab,-1.93,0.02,EUR,COMPLETED,2443.27
Transfer,Current,2025-04-01 21:51:14,2025-04-01 21:51:14,To Instant Access Savings,-0.85,0.00,EUR,COMPLETED,2442.42
Transfer,Current,2025-04-02 07:34:32,2025-04-02 07:34:32,To Instant Access Savings,-2.50,0.00,EUR,COMPLETED,2439.92
Transfer,Current,2025-04-02 09:20:11,2025-04-02 09:20:12,To Instant Access Savings,-0.50,0.00,EUR,COMPLETED,2439.42
Transfer,Current,2025-04-02 10:49:35,2025-04-02 10:49:36,To Instant Access Savings,-1.80,0.00,EUR,COMPLETED,2437.62
Transfer,Current,2025-04-02 11:02:14,2025-04-02 11:02:14,To Instant Access Savings,-4.60,0.00,EUR,COMPLETED,2433.02
Card Payment,Current,2025-04-01 08:23:10,2025-04-02 15:28:31,HP,-1.49,0.00,EUR,COMPLETED,2431.53
Card Payment,Current,2025-04-01 05:57:31,2025-04-02 17:20:35,Acv Da Nang,-2.25,0.00,EUR,COMPLETED,2429.28
Card Payment,Current,2025-03-31 15:56:23,2025-04-02 17:21:05,Hyatt Hotels,-4.84,0.00,EUR,COMPLETED,2424.44
Card Payment,Current,2025-03-31 15:04:27,2025-04-02 17:21:07,Hyatt Hotels,-4.21,0.00,EUR,COMPLETED,2420.23
Card Payment,Current,2025-03-31 15:04:57,2025-04-02 17:21:07,Hyatt Hotels,-4.84,0.00,EUR,COMPLETED,2415.39
Card Payment,Current,2025-04-01 05:15:49,2025-04-02 17:21:17,Grab,-5.51,0.00,EUR,COMPLETED,2409.88
Card Payment,Current,2025-04-01 05:41:20,2025-04-02 17:21:17,Grab,-0.38,0.00,EUR,COMPLETED,2409.50
Transfer,Current,2025-04-02 17:59:31,2025-04-02 17:59:31,To Instant Access Savings,-4.60,0.00,EUR,COMPLETED,2404.90
Transfer,Current,2025-04-03 08:32:02,2025-04-03 08:32:03,Transfer to MICHAEL DAVID DOOLEY,-200.00,0.00,EUR,COMPLETED,2204.90
Card Payment,Current,2025-04-02 07:34:32,2025-04-03 09:39:22,Peter Mc Gonagle,-61.50,0.00,EUR,COMPLETED,2143.40
Card Payment,Current,2025-04-02 17:59:29,2025-04-03 09:55:16,Parking Payments,-4.08,0.00,EUR,COMPLETED,2139.32
Card Payment,Current,2025-04-02 09:20:10,2025-04-03 09:56:47,Booterstown Pharmacy,-23.90,0.00,EUR,COMPLETED,2115.42
Card Payment,Current,2025-04-02 11:02:13,2025-04-03 11:41:55,SuperValu,-8.08,0.00,EUR,COMPLETED,2107.34
Card Payment,Current,2025-04-02 10:49:33,2025-04-03 11:48:47,Lidl,-50.64,0.00,EUR,COMPLETED,2056.70
Card Payment,Current,2025-04-01 10:47:50,2025-04-03 16:59:52,Acv Noi Bai,-23.04,0.00,EUR,COMPLETED,2033.66
Transfer,Current,2025-04-04 08:20:01,2025-04-04 08:20:02,To Instant Access Savings,-4.00,0.00,EUR,COMPLETED,2029.66
Transfer,Current,2025-04-04 10:44:21,2025-04-04 10:44:22,To Instant Access Savings,-1.60,0.00,EUR,COMPLETED,2028.06
Transfer,Current,2025-04-04 10:55:44,2025-04-04 10:55:44,To Instant Access Savings,-0.15,0.00,EUR,COMPLETED,2027.91
Transfer,Current,2025-04-04 18:00:00,2025-04-04 18:00:00,To Instant Access Savings,-5.00,0.00,EUR,COMPLETED,2022.91
Transfer,Current,2025-04-04 18:05:33,2025-04-04 18:05:33,To Instant Access Savings,-4.30,0.00,EUR,COMPLETED,2018.61
Card Payment,Current,2025-04-01 21:51:14,2025-04-04 18:53:04,Qatar Duty Free - QDF,-14.83,0.00,EUR,COMPLETED,2003.78
Transfer,Current,2025-04-05 10:33:53,2025-04-05 10:33:54,To Instant Access Savings,-5.00,0.00,EUR,COMPLETED,1998.78
Transfer,Current,2025-04-05 11:22:52,2025-04-05 11:22:52,To Instant Access Savings,-4.00,0.00,EUR,COMPLETED,1994.78
Card Payment,Current,2025-04-04 18:05:33,2025-04-05 11:57:53,SuperValu,-22.14,0.00,EUR,COMPLETED,1972.64
Card Payment,Current,2025-04-04 18:00:00,2025-04-05 12:21:08,Xl,-9.00,0.00,EUR,COMPLETED,1963.64
Card Payment,Current,2025-04-04 08:20:01,2025-04-05 12:38:43,Hatch Coffee,-9.20,0.00,EUR,COMPLETED,1954.44
Card Payment,Current,2025-04-04 10:44:21,2025-04-05 16:23:33,Amazon,-10.68,0.00,EUR,COMPLETED,1943.76
Card Payment,Current,2025-04-04 10:52:56,2025-04-05 16:24:18,Amazon,-4.97,0.00,EUR,COMPLETED,1938.79
Transfer,Current,2025-04-05 18:16:50,2025-04-05 18:16:50,To Instant Access Savings,-2.65,0.00,EUR,COMPLETED,1936.14
Transfer,Current,2025-04-05 18:25:55,2025-04-05 18:25:56,To Instant Access Savings,-0.05,0.00,EUR,COMPLETED,1936.09
Card Payment,Current,2025-04-05 11:22:51,2025-04-06 12:17:58,Brownes of Sandymount,-20.20,0.00,EUR,COMPLETED,1915.89
Card Payment,Current,2025-04-05 18:25:54,2025-04-06 12:33:51,plex.tv,-119.99,0.00,EUR,COMPLETED,1795.90
Transfer,Current,2025-04-06 13:06:18,2025-04-06 13:06:18,To Instant Access Savings,-3.90,0.00,EUR,COMPLETED,1792.00
Card Payment,Current,2025-04-05 18:16:50,2025-04-06 13:10:00,Camile Thai,-44.47,0.00,EUR,COMPLETED,1747.53
Transfer,Current,2025-04-06 13:28:58,2025-04-06 13:28:58,To Instant Access Savings,-2.20,0.00,EUR,COMPLETED,1745.33
Card Payment,Current,2025-04-05 10:33:53,2025-04-06 14:00:56,McAuliffes totalhealth Pharmacy,-19.00,0.00,EUR,COMPLETED,1726.33
Card Payment,Current,2025-04-06 13:28:26,2025-04-07 09:20:29,SuperValu,-43.56,0.00,EUR,COMPLETED,1682.77
Card Payment,Current,2025-04-06 13:06:17,2025-04-07 15:59:11,Lidl,-33.22,0.00,EUR,COMPLETED,1649.55
Transfer,Current,2025-04-08 08:45:34,2025-04-08 08:45:37,To Instant Access Savings,-5.00,0.00,EUR,COMPLETED,1644.55
Transfer,Current,2025-04-08 08:46:18,2025-04-08 08:46:18,To Instant Access Savings,-5.00,0.00,EUR,COMPLETED,1639.55
Transfer,Current,2025-04-08 08:47:48,2025-04-08 08:47:48,To Instant Access Savings,-0.05,0.00,EUR,COMPLETED,1639.50
Transfer,Current,2025-04-08 13:52:42,2025-04-08 13:53:28,To Instant Access Savings,-3.50,0.00,EUR,COMPLETED,1636.00
Card Payment,Current,2025-04-08 08:47:31,2025-04-09 10:01:05,Clark’s Newsagent,-8.99,0.00,EUR,COMPLETED,1627.01
Transfer,Current,2025-04-09 12:10:53,2025-04-09 12:10:53,From Instant Access Savings,2500.00,0.00,EUR,COMPLETED,4127.01
Card Payment,Current,2025-04-08 08:45:34,2025-04-09 14:44:31,Ann Griffin,-48.00,0.00,EUR,COMPLETED,4079.01
Exchange,Current,2025-04-09 15:20:46,2025-04-09 15:20:46,Exchanged to EUR,9935.93,0.00,EUR,COMPLETED,14014.94
Transfer,Current,2025-04-09 15:21:01,2025-04-09 15:21:01,To Instant Access Savings,-10000.00,0.00,EUR,COMPLETED,4014.94
Card Payment,Current,2025-04-08 08:46:15,2025-04-09 15:30:32,Dr Maurice Treacy,-80.00,0.00,EUR,COMPLETED,3934.94
Card Payment,Current,2025-04-08 13:51:36,2025-04-09 15:46:53,OXMANTOWN,-4.30,0.00,EUR,COMPLETED,3930.64
Transfer,Current,2025-04-09 17:58:27,2025-04-09 17:58:27,To Instant Access Savings,-5.00,0.00,EUR,COMPLETED,3925.64
Transfer,Current,2025-04-09 19:22:26,2025-04-09 19:22:26,To Instant Access Savings,-5.00,0.00,EUR,COMPLETED,3920.64
Card Payment,Current,2025-04-09 17:58:27,2025-04-10 09:11:25,Vape Paradise,-8.00,0.00,EUR,COMPLETED,3912.64
Card Payment,Current,2025-04-09 19:22:26,2025-04-10 10:48:32,National Car Testing Service,-84.00,0.00,EUR,COMPLETED,3828.64
Transfer,Current,2025-04-10 19:29:19,2025-04-10 19:29:19,To Instant Access Savings,-5.00,0.00,EUR,COMPLETED,3823.64
Transfer,Current,2025-04-10 19:35:18,2025-04-10 19:35:19,Transfer from MARA DI RAIMONDO,26.00,0.00,EUR,COMPLETED,3849.64
Transfer,Current,2025-04-11 08:44:16,2025-04-11 08:44:16,To Instant Access Savings,-3.25,0.00,EUR,COMPLETED,3846.39
Transfer,Current,2025-04-11 08:50:06,2025-04-11 08:50:06,To Instant Access Savings,-1.75,0.00,EUR,COMPLETED,3844.64
Transfer,Current,2025-04-11 01:00:00,2025-04-11 11:46:53,To Bankinter SA Ireland Branch,-1649.75,0.00,EUR,COMPLETED,2194.89
Exchange,Current,2025-04-11 18:41:09,2025-04-11 18:41:09,Exchanged to GBP,-231.89,0.00,EUR,COMPLETED,1963.00
Transfer,Current,2025-04-12 10:49:01,2025-04-12 10:49:02,From Instant Access Savings,500.00,0.00,EUR,COMPLETED,2463.00
Transfer,Current,2025-04-12 10:54:07,2025-04-12 10:54:07,To Instant Access Savings,-5.00,0.00,EUR,COMPLETED,2458.00
Transfer,Current,2025-04-12 11:21:55,2025-04-12 11:21:55,To Instant Access Savings,-2.00,0.00,EUR,COMPLETED,2456.00
Card Payment,Current,2025-04-11 08:50:05,2025-04-12 12:05:47,Tesco,-1.65,0.00,EUR,COMPLETED,2454.35
Card Payment,Current,2025-04-10 19:29:18,2025-04-12 12:38:47,The Merry Cobbler,-60.00,0.00,EUR,COMPLETED,2394.35
Card Payment,Current,2025-04-11 08:44:16,2025-04-12 13:23:53,Starbucks,-4.35,0.00,EUR,COMPLETED,2390.00
Transfer,Current,2025-04-12 15:17:11,2025-04-12 15:17:11,To Instant Access Savings,-1.25,0.00,EUR,COMPLETED,2388.75
Transfer,Current,2025-04-12 15:30:39,2025-04-12 15:30:39,To Instant Access Savings,-1.50,0.00,EUR,COMPLETED,2387.25
Transfer,Current,2025-04-13 08:51:33,2025-04-13 08:51:33,To Instant Access Savings,-3.50,0.00,EUR,COMPLETED,2383.75
Transfer,Current,2025-04-13 09:15:30,2025-04-13 09:15:30,To Instant Access Savings,-4.00,0.00,EUR,COMPLETED,2379.75
Card Payment,Current,2025-04-12 10:54:06,2025-04-13 10:01:01,Richer Sounds,-2189.00,0.00,EUR,COMPLETED,190.75
Transfer,Current,2025-04-13 10:55:15,2025-04-13 10:55:15,To Instant Access Savings,-0.05,0.00,EUR,COMPLETED,190.70
Transfer,Current,2025-04-13 11:21:12,2025-04-13 11:21:13,From Instant Access Savings,140.00,0.00,EUR,COMPLETED,330.70
Transfer,Current,2025-04-13 11:21:52,2025-04-13 11:21:52,Transfer to MAXIMILIAN BRINZA,-140.00,0.00,EUR,COMPLETED,190.70
Card Payment,Current,2025-04-12 15:17:10,2025-04-13 12:06:43,Applegreen,-7.75,0.00,EUR,COMPLETED,182.95
Card Payment,Current,2025-04-12 15:30:38,2025-04-13 12:06:43,Applegreen,-3.70,0.00,EUR,COMPLETED,179.25
Card Payment,Current,2025-04-12 11:21:54,2025-04-13 13:18:43,Titanic Belfast,-57.60,0.58,EUR,COMPLETED,121.07
Transfer,Current,2025-04-13 17:31:29,2025-04-13 17:31:29,To Instant Access Savings,-4.70,0.00,EUR,COMPLETED,116.37
Card Payment,Current,2025-04-13 17:29:04,2025-04-14 09:07:32,SuperValu,-20.06,0.00,EUR,COMPLETED,96.31
Transfer,Current,2025-04-14 10:35:31,2025-04-14 10:35:31,To Instant Access Savings,-2.00,0.00,EUR,COMPLETED,94.31
Card Payment,Current,2025-04-13 09:15:29,2025-04-14 12:12:27,Applegreen,-9.20,0.00,EUR,COMPLETED,85.11
Card Payment,Current,2025-04-13 08:51:33,2025-04-14 12:12:30,Applegreen,-16.30,0.00,EUR,COMPLETED,68.81
Transfer,Current,2025-04-14 12:25:42,2025-04-14 12:25:42,From Instant Access Savings,200.00,0.00,EUR,COMPLETED,268.81
Transfer,Current,2025-04-14 12:25:50,2025-04-14 12:25:50,To Instant Access Savings,-5.00,0.00,EUR,COMPLETED,263.81
Transfer,Current,2025-04-14 12:40:46,2025-04-14 12:40:49,To Instant Access Savings,-4.40,0.00,EUR,COMPLETED,259.41
Card Payment,Current,2025-04-13 10:55:15,2025-04-14 15:20:17,The Washington Post,-0.99,0.00,EUR,COMPLETED,258.42
Card Payment,Current,2025-04-14 12:40:46,2025-04-15 10:47:37,Lidl,-31.12,0.00,EUR,COMPLETED,227.30
Card Payment,Current,2025-04-14 12:25:50,2025-04-15 14:12:37,Applegreen,-8.00,0.00,EUR,COMPLETED,219.30
Transfer,Current,2025-04-15 22:37:57,2025-04-15 22:37:57,To Instant Access Savings,-0.10,0.00,EUR,COMPLETED,219.20
Transfer,Current,2025-04-15 22:39:27,2025-04-15 22:39:27,Transfer from MARA DI RAIMONDO,21.99,0.00,EUR,COMPLETED,241.19
Transfer,Current,2025-04-16 08:41:12,2025-04-16 08:41:12,To Instant Access Savings,-1.50,0.00,EUR,COMPLETED,239.69
Card Payment,Current,2025-04-15 22:37:57,2025-04-16 09:28:57,Cineworld,-43.98,0.00,EUR,COMPLETED,195.71
Card Payment,Current,2025-04-14 10:35:30,2025-04-16 15:10:49,Amazon,-66.60,0.00,EUR,COMPLETED,129.11
Card Payment,Current,2025-04-16 17:42:08,,Guinness Storehouse,-1.00,0.00,EUR,REVERTED,
Transfer,Current,2025-04-16 17:44:09,2025-04-16 17:44:10,To Instant Access Savings,-5.00,0.00,EUR,COMPLETED,124.11
Transfer,Current,2025-04-16 18:50:09,2025-04-16 18:50:09,From Instant Access Savings,150.00,0.00,EUR,COMPLETED,274.11
Transfer,Current,2025-04-16 18:50:16,2025-04-16 18:50:16,To Instant Access Savings,-5.00,0.00,EUR,COMPLETED,269.11
Card Payment,Current,2025-04-16 18:50:16,2025-04-17 09:14:58,Life Style Sports,-150.00,0.00,EUR,COMPLETED,119.11
Card Payment,Current,2025-04-16 08:41:12,2025-04-17 12:21:29,Applegreen,-11.70,0.00,EUR,COMPLETED,107.41
Transfer,Current,2025-04-17 20:04:56,2025-04-17 20:04:56,To Instant Access Savings,-3.10,0.00,EUR,COMPLETED,104.31
Transfer,Current,2025-04-17 20:05:59,2025-04-17 20:05:59,Transfer from MARA DI RAIMONDO,19.38,0.00,EUR,COMPLETED,123.69
Transfer,Current,2025-04-18 09:36:22,2025-04-18 09:36:22,To Instant Access Savings,-4.00,0.00,EUR,COMPLETED,119.69
Card Payment,Current,2025-04-17 20:04:56,2025-04-18 12:52:37,Deliveroo,-19.38,0.00,EUR,COMPLETED,100.31
Transfer,Current,2025-04-18 13:20:37,2025-04-18 13:20:37,To Instant Access Savings,-2.00,0.00,EUR,COMPLETED,98.31
Transfer,Current,2025-04-18 14:10:34,2025-04-18 14:10:35,To Instant Access Savings,-0.70,0.00,EUR,COMPLETED,97.61
Transfer,Current,2025-04-18 14:32:38,2025-04-18 14:32:38,From Instant Access Savings,200.00,0.00,EUR,COMPLETED,297.61
Transfer,Current,2025-04-18 14:34:38,2025-04-18 14:34:39,To Instant Access Savings,-1.45,0.00,EUR,COMPLETED,296.16
Transfer,Current,2025-04-18 16:21:30,2025-04-18 16:21:31,Transfer from MARA DI RAIMONDO,15.00,0.00,EUR,COMPLETED,311.16
Transfer,Current,2025-04-18 18:49:16,2025-04-18 18:53:35,To Instant Access Savings,-1.00,0.00,EUR,COMPLETED,310.16
Transfer,Current,2025-04-18 19:39:50,2025-04-18 19:39:51,Transfer to MARA DI RAIMONDO,-7.00,0.00,EUR,COMPLETED,303.16
Card Payment,Current,2025-04-18 14:10:34,2025-04-19 09:14:54,Brownes of Sandymount,-46.86,0.00,EUR,COMPLETED,256.30
Transfer,Current,2025-04-19 09:50:26,2025-04-19 09:50:27,To Instant Access Savings,-4.25,0.00,EUR,COMPLETED,252.05
Card Payment,Current,2025-04-18 13:20:37,2025-04-19 10:01:43,Parking Payments,-1.60,0.00,EUR,COMPLETED,250.45
Card Refund,Current,2025-04-18 10:17:26,2025-04-19 10:17:08,Life Style Sports,150.00,0.00,EUR,COMPLETED,400.45
Card Payment,Current,2025-04-18 09:36:22,2025-04-19 10:30:58,Butlers Chocolates,-9.20,0.00,EUR,COMPLETED,391.25
Card Payment,Current,2025-04-18 18:49:16,2025-04-19 11:28:21,SuperValu,-17.80,0.00,EUR,COMPLETED,373.45
Card Payment,Current,2025-04-18 14:34:38,2025-04-19 11:40:02,Applegreen,-63.71,0.00,EUR,COMPLETED,309.74
Transfer,Current,2025-04-19 13:12:25,2025-04-19 13:12:25,To Instant Access Savings,-5.00,0.00,EUR,COMPLETED,304.74
Transfer,Current,2025-04-19 13:39:40,2025-04-19 13:39:40,To Instant Access Savings,-0.05,0.00,EUR,COMPLETED,304.69
Transfer,Current,2025-04-19 13:55:09,2025-04-19 13:55:09,From Instant Access Savings,150.00,0.00,EUR,COMPLETED,454.69
Transfer,Current,2025-04-19 13:55:52,2025-04-19 13:55:52,To Instant Access Savings,-5.00,0.00,EUR,COMPLETED,449.69
Transfer,Current,2025-04-19 14:00:42,2025-04-19 14:00:42,To Instant Access Savings,-5.00,0.00,EUR,COMPLETED,444.69
Transfer,Current,2025-04-19 15:37:41,2025-04-19 15:37:41,From Instant Access Savings,150.00,0.00,EUR,COMPLETED,594.69
Transfer,Current,2025-04-19 15:39:06,2025-04-19 15:39:06,To Instant Access Savings,-2.10,0.00,EUR,COMPLETED,592.59
Transfer,Current,2025-04-19 15:54:08,2025-04-19 15:54:08,To Instant Access Savings,-3.75,0.00,EUR,COMPLETED,588.84
Transfer,Current,2025-04-19 16:07:40,2025-04-19 16:07:41,To Instant Access Savings,-2.00,0.00,EUR,COMPLETED,586.84
Transfer,Current,2025-04-19 20:30:50,2025-04-19 20:30:50,To Instant Access Savings,-3.15,0.00,EUR,COMPLETED,583.69
Card Payment,Current,2025-04-19 14:00:21,2025-04-20 10:14:06,Dunnes Stores,-60.00,0.00,EUR,COMPLETED,523.69
Card Payment,Current,2025-04-19 13:39:40,2025-04-20 10:18:31,Dublin Dundrum Centre,-19.99,0.00,EUR,COMPLETED,503.70
Card Payment,Current,2025-04-19 20:30:50,2025-04-20 11:00:37,SuperValu,-51.37,0.00,EUR,COMPLETED,452.33
Card Payment,Current,2025-04-19 09:50:26,2025-04-20 11:12:12,Applegreen,-11.15,0.00,EUR,COMPLETED,441.18
Card Payment,Current,2025-04-19 15:39:05,2025-04-20 11:14:32,Zakura,-74.58,0.00,EUR,COMPLETED,366.60
Card Payment,Current,2025-04-19 16:07:40,2025-04-20 16:12:56,Tesco,-9.60,0.00,EUR,COMPLETED,357.00
Card Payment,Current,2025-04-19 13:12:24,2025-04-20 16:13:29,Brown Thomas,-118.00,0.00,EUR,COMPLETED,239.00
Card Payment,Current,2025-04-19 13:55:51,2025-04-20 16:17:18,LSS Ireland Limited,-188.00,0.00,EUR,COMPLETED,51.00
Transfer,Current,2025-04-21 08:36:26,2025-04-21 08:36:26,To Instant Access Savings,-4.00,0.00,EUR,COMPLETED,47.00
Transfer,Current,2025-04-21 08:37:40,2025-04-21 08:37:40,To Instant Access Savings,-3.20,0.00,EUR,COMPLETED,43.80
Card Payment,Current,2025-04-19 15:54:08,2025-04-21 11:29:20,Spar,-9.25,0.00,EUR,COMPLETED,34.55
Topup,Current,2025-04-22 08:02:11,2025-04-22 08:02:12,Payment from VHI CLAIMS,25.00,0.00,EUR,COMPLETED,59.55
Transfer,Current,2025-04-22 08:59:04,2025-04-22 08:59:04,To Instant Access Savings,-1.25,0.00,EUR,COMPLETED,58.30
Card Payment,Current,2025-04-21 08:37:39,2025-04-22 12:10:05,Applegreen,-23.36,0.00,EUR,COMPLETED,34.94
Card Payment,Current,2025-04-21 08:36:26,2025-04-22 12:10:06,Applegreen,-9.20,0.00,EUR,COMPLETED,25.74
Card Payment,Current,2025-04-22 08:59:04,2025-04-23 09:44:53,Lidl,-17.75,0.00,EUR,COMPLETED,7.99
Transfer,Current,2025-04-23 13:41:35,2025-04-23 13:41:35,From Instant Access Savings,100.00,0.00,EUR,COMPLETED,107.99
Transfer,Current,2025-04-23 13:41:44,2025-04-23 13:41:44,To Instant Access Savings,-5.00,0.00,EUR,COMPLETED,102.99
Transfer,Current,2025-04-23 17:52:43,2025-04-23 17:52:43,To Instant Access Savings,-4.05,0.00,EUR,COMPLETED,98.94
Card Payment,Current,2025-04-23 13:41:44,2025-04-24 10:37:32,Vape Paradise,-20.00,0.00,EUR,COMPLETED,78.94
Transfer,Current,2025-04-24 01:00:00,2025-04-24 11:45:38,To eFlow,-3.53,0.00,EUR,COMPLETED,75.41
Card Payment,Current,2025-04-23 17:52:43,2025-04-24 14:18:52,Parking Payments,-2.19,0.00,EUR,COMPLETED,73.22
Card Payment,Current,2025-04-23 09:00:28,2025-04-24 15:14:01,Copper + Straw,-5.00,0.00,EUR,COMPLETED,68.22
Topup,Current,2025-04-25 08:12:33,2025-04-25 08:12:34,Payment from WORKDAY LIMITED,6313.87,0.00,EUR,COMPLETED,6382.09
Transfer,Current,2025-04-25 08:12:58,2025-04-25 08:12:58,Credit card repayment,-2744.85,0.00,EUR,COMPLETED,3637.24
Transfer,Current,2025-04-25 08:32:14,2025-04-25 09:23:03,To Payward Ireland Ltd.,-125.00,0.00,EUR,COMPLETED,3512.24
Transfer,Current,2025-04-25 08:32:13,2025-04-25 09:23:03,To Trading 212 UK Limited,-500.00,0.00,EUR,COMPLETED,3012.24
Transfer,Current,2025-04-25 09:48:33,2025-04-25 09:48:33,To pocket EUR Subscriptions from EUR,-250.00,0.00,EUR,COMPLETED,2762.24
Transfer,Current,2025-04-25 09:48:33,2025-04-25 09:48:33,To pocket EUR Subscriptions from EUR,-780.42,0.00,EUR,COMPLETED,1981.82
Transfer,Current,2025-04-25 10:26:01,2025-04-25 10:26:02,Transfer from MARA DI RAIMONDO,35.00,0.00,EUR,COMPLETED,2016.82
Transfer,Current,2025-04-25 12:50:17,2025-04-25 12:50:18,Transfer to Robin O Connell,-70.00,0.00,EUR,COMPLETED,1946.82
Transfer,Current,2025-04-25 13:08:25,2025-04-25 13:08:25,To Instant Access Savings,-5.00,0.00,EUR,COMPLETED,1941.82
Transfer,Current,2025-04-25 13:55:02,2025-04-25 13:55:03,Transfer from JACK WHELAN,500.00,0.00,EUR,COMPLETED,2441.82
Transfer,Current,2025-04-25 16:03:54,2025-04-25 16:03:54,To Instant Access Savings,-0.05,0.00,EUR,COMPLETED,2441.77
Transfer,Current,2025-04-25 16:07:02,2025-04-25 16:07:02,To pocket EUR Subscriptions from EUR,-855.00,0.00,EUR,COMPLETED,1586.77
Transfer,Current,2025-04-25 16:07:10,2025-04-25 16:07:10,To Instant Access Savings,-1000.00,0.00,EUR,COMPLETED,586.77
Topup,Current,2025-04-25 18:53:29,2025-04-25 18:53:29,Payment from FINANCE IRELAND CREDIT SOLUTIONS,81.14,0.00,EUR,COMPLETED,667.91
Transfer,Current,2025-04-26 10:30:49,2025-04-26 10:30:50,To Instant Access Savings,-5.00,0.00,EUR,COMPLETED,662.91
Transfer,Current,2025-04-26 13:17:45,2025-04-26 13:17:45,To Instant Access Savings,-1.25,0.00,EUR,COMPLETED,661.66
Transfer,Current,2025-04-26 14:02:30,2025-04-26 14:02:30,To Instant Access Savings,-1.75,0.00,EUR,COMPLETED,659.91
Card Payment,Current,2025-04-25 16:03:53,2025-04-26 16:31:25,PlayStation,-49.99,0.00,EUR,COMPLETED,609.92
Card Payment,Current,2025-04-25 13:08:25,2025-04-26 16:48:27,Centra,-19.00,0.00,EUR,COMPLETED,590.92
Transfer,Current,2025-04-26 17:59:44,2025-04-26 17:59:44,To Instant Access Savings,-2.65,0.00,EUR,COMPLETED,588.27
Card Payment,Current,2025-04-26 10:30:49,2025-04-27 10:38:31,Eddie Doyle,-50.00,0.00,EUR,COMPLETED,538.27
Card Payment,Current,2025-04-26 13:17:45,2025-04-27 10:44:10,Tesco,-2.75,0.00,EUR,COMPLETED,535.52
Card Payment,Current,2025-04-26 17:59:43,2025-04-27 11:18:50,Camile Thai,-23.47,0.00,EUR,COMPLETED,512.05
Transfer,Current,2025-04-27 12:07:40,2025-04-27 12:07:40,To Instant Access Savings,-1.50,0.00,EUR,COMPLETED,510.55
Card Payment,Current,2025-04-26 14:02:30,2025-04-27 12:10:23,Applegreen,-13.65,0.00,EUR,COMPLETED,496.90
Transfer,Current,2025-04-27 13:41:12,2025-04-27 13:41:12,To Instant Access Savings,-5.00,0.00,EUR,COMPLETED,491.90
Transfer,Current,2025-04-27 13:51:04,2025-04-27 13:51:04,To Instant Access Savings,-5.00,0.00,EUR,COMPLETED,486.90
Transfer,Current,2025-04-27 13:57:01,2025-04-27 13:57:01,To Instant Access Savings,-5.00,0.00,EUR,COMPLETED,481.90
Transfer,Current,2025-04-27 16:21:37,2025-04-27 16:21:37,To Instant Access Savings,-1.90,0.00,EUR,COMPLETED,480.00
Transfer,Current,2025-04-28 00:35:16,2025-04-28 00:35:16,To Instant Access Savings,-0.05,0.00,EUR,COMPLETED,479.95
Topup,Current,2025-04-28 02:03:25,2025-04-28 02:03:25,Payment from ALBERTO U. BIRGIT DI RAIMONDO,1184.30,0.00,EUR,COMPLETED,1664.25
Card Payment,Current,2025-04-27 16:21:37,2025-04-28 09:09:11,Lidl,-18.62,0.00,EUR,COMPLETED,1645.63
Card Payment,Current,2025-04-27 13:51:03,2025-04-28 09:09:20,Dunnes Stores,-25.00,0.00,EUR,COMPLETED,1620.63
Card Payment,Current,2025-04-27 13:57:00,2025-04-28 09:59:36,Fastfix,-45.00,0.00,EUR,COMPLETED,1575.63
Card Payment,Current,2025-04-27 12:07:39,2025-04-28 12:45:25,Hatch Coffee,-17.70,0.00,EUR,COMPLETED,1557.93
Card Payment,Current,2025-04-27 13:41:11,2025-04-28 13:28:40,Marks & Spencer,-41.00,0.00,EUR,COMPLETED,1516.93
Transfer,Current,2025-04-28 14:30:33,2025-04-28 14:30:33,To Instant Access Savings,-1000.00,0.00,EUR,COMPLETED,516.93
Transfer,Current,2025-04-28 17:58:17,2025-04-28 17:58:17,To Instant Access Savings,-0.30,0.00,EUR,COMPLETED,516.63
Transfer,Current,2025-04-28 18:03:34,2025-04-28 18:03:34,To Instant Access Savings,-1.00,0.00,EUR,COMPLETED,515.63
Transfer,Current,2025-04-28 19:43:41,2025-04-28 19:43:41,To Instant Access Savings,-3.20,0.00,EUR,COMPLETED,512.43
Topup,Current,2025-04-29 02:04:20,2025-04-29 02:04:22,"Payment from BANKINTER S.A., IRELAND BRANCH",3720.00,0.00,EUR,COMPLETED,4232.43
Transfer,Current,2025-04-29 04:05:34,2025-04-29 04:05:34,To Instant Access Savings,-0.70,0.00,EUR,COMPLETED,4231.73
Transfer,Current,2025-04-29 07:13:01,2025-04-29 07:13:01,To Instant Access Savings,-3720.00,0.00,EUR,COMPLETED,511.73
Transfer,Current,2025-04-29 07:13:46,2025-04-29 07:13:47,Transfer from Robin O Connell,70.00,0.00,EUR,COMPLETED,581.73
Transfer,Current,2025-04-29 08:20:09,2025-04-29 08:20:09,Transfer to BARRY NEVILLE,-110.00,0.00,EUR,COMPLETED,471.73
Transfer,Current,2025-04-29 08:50:56,2025-04-29 08:50:57,Transfer from MARA DI RAIMONDO,20.00,0.00,EUR,COMPLETED,491.73
Card Payment,Current,2025-04-28 00:35:15,2025-04-29 12:25:42,Apple,-9.99,0.00,EUR,COMPLETED,481.74
Card Payment,Current,2025-04-28 17:58:17,2025-04-29 15:37:02,Sp Aer Uk,-268.94,0.00,EUR,COMPLETED,212.80
Card Payment,Current,2025-04-28 18:03:34,2025-04-29 15:50:41,Tech House,-11.80,0.00,EUR,COMPLETED,201.00
Card Payment,Current,2025-04-29 04:05:34,2025-04-29 15:57:23,Transport for London,-6.86,0.00,EUR,COMPLETED,194.14
Transfer,Current,2025-04-29 18:25:02,2025-04-29 18:25:02,To Instant Access Savings,-0.95,0.00,EUR,COMPLETED,193.19
Transfer,Current,2025-04-30 06:05:33,2025-04-30 06:05:33,To Instant Access Savings,-1.30,0.00,EUR,COMPLETED,191.89
Card Payment,Current,2025-04-28 19:43:40,2025-04-30 13:38:15,YUNO,-85.36,0.00,EUR,COMPLETED,106.53
Transfer,Current,2025-04-30 15:27:17,2025-04-30 15:27:17,To Instant Access Savings,-3.20,0.00,EUR,COMPLETED,103.33
Card Payment,Current,2025-04-29 18:25:01,2025-04-30 16:14:53,UNIQLO,-52.81,0.00,EUR,COMPLETED,50.52
Transfer,Current,2025-04-30 20:48:11,2025-04-30 20:48:12,From Instant Access Savings,300.00,0.00,EUR,COMPLETED,350.52
Transfer,Current,2025-04-30 20:48:29,2025-04-30 20:48:29,To Instant Access Savings,-0.70,0.00,EUR,COMPLETED,349.82
Transfer,Current,2025-04-30 20:49:17,2025-04-30 20:49:17,To Instant Access Savings,-3.80,0.00,EUR,COMPLETED,346.02
Transfer,Current,2025-05-01 00:17:56,2025-05-01 00:17:56,Credit card excess funds transfer,0.74,0.00,EUR,COMPLETED,346.76
Transfer,Current,2025-05-01 09:10:42,2025-05-01 09:10:42,To Instant Access Savings,-5.00,0.00,EUR,COMPLETED,341.76
Transfer,Current,2025-05-01 09:14:47,2025-05-01 09:14:47,To Instant Access Savings,-1.30,0.00,EUR,COMPLETED,340.46
Card Payment,Current,2025-04-30 06:05:33,2025-05-01 15:36:12,Transport for London,-6.74,0.00,EUR,COMPLETED,333.72
Card Payment,Current,2025-04-30 20:49:17,2025-05-01 16:26:36,Amazon,-11.24,0.00,EUR,COMPLETED,322.48
Card Payment,Current,2025-04-30 20:48:29,2025-05-01 16:33:57,Amazon,-228.86,0.00,EUR,COMPLETED,93.62
Card Payment,Current,2025-04-30 15:27:17,2025-05-01 16:44:44,WHSmith,-4.36,0.00,EUR,COMPLETED,89.26
Transfer,Current,2025-05-02 07:49:48,2025-05-02 07:49:50,To Colm Quish,-10.00,0.00,EUR,COMPLETED,79.26
Transfer,Current,2025-05-02 08:20:37,2025-05-02 08:20:37,From Instant Access Savings,250.00,0.00,EUR,COMPLETED,329.26
Transfer,Current,2025-05-02 08:20:45,2025-05-02 08:20:45,To Instant Access Savings,-0.15,0.00,EUR,COMPLETED,329.11
Transfer,Current,2025-05-02 08:24:38,2025-05-02 08:24:39,To Instant Access Savings,-1.00,0.00,EUR,COMPLETED,328.11
Transfer,Current,2025-05-02 08:37:18,2025-05-02 08:37:18,To Instant Access Savings,-2.55,0.00,EUR,COMPLETED,325.56
Transfer,Current,2025-05-02 11:30:53,2025-05-02 11:30:54,Transfer from Andrew James Fullen,999.00,0.00,EUR,COMPLETED,1324.56
Transfer,Current,2025-05-02 12:00:11,2025-05-02 12:00:11,To Instant Access Savings,-999.00,0.00,EUR,COMPLETED,325.56
Card Payment,Current,2025-05-01 09:14:46,2025-05-02 12:44:07,SuperValu,-21.74,0.00,EUR,COMPLETED,303.82
Card Payment,Current,2025-05-01 09:10:42,2025-05-02 13:15:42,Xl,-9.00,0.00,EUR,COMPLETED,294.82
Transfer,Current,2025-05-02 14:42:08,2025-05-02 14:42:08,From Instant Access Savings,250.00,0.00,EUR,COMPLETED,544.82
Transfer,Current,2025-05-03 11:19:29,2025-05-03 11:19:29,To Instant Access Savings,-5.00,0.00,EUR,COMPLETED,539.82
Card Payment,Current,2025-05-02 08:37:17,2025-05-03 11:53:53,HP,-1.49,0.00,EUR,COMPLETED,538.33
Transfer,Current,2025-05-03 12:02:55,2025-05-03 12:02:55,To Instant Access Savings,-0.05,0.00,EUR,COMPLETED,538.28
Transfer,Current,2025-05-03 16:57:08,2025-05-03 16:57:08,To Instant Access Savings,-0.05,0.00,EUR,COMPLETED,538.23
Card Payment,Current,2025-05-02 08:24:38,2025-05-03 19:53:28,Applegreen,-11.80,0.00,EUR,COMPLETED,526.43
Card Payment,Current,2025-05-02 08:20:44,2025-05-03 19:53:28,Applegreen,-70.97,0.00,EUR,COMPLETED,455.46
Transfer,Current,2025-05-04 11:34:22,2025-05-04 11:34:22,To Instant Access Savings,-2.05,0.00,EUR,COMPLETED,453.41
Card Payment,Current,2025-05-03 11:19:22,2025-05-04 13:47:39,Decathlon,-6.00,0.00,EUR,COMPLETED,447.41
Card Payment,Current,2025-05-03 16:57:07,2025-05-04 13:53:24,Netflix,-10.99,0.00,EUR,COMPLETED,436.42
Card Payment,Current,2025-05-03 12:02:55,2025-05-04 15:04:50,Dunnes Stores,-1.99,0.00,EUR,COMPLETED,434.43
Transfer,Current,2025-05-04 15:12:27,2025-05-04 15:12:27,To Instant Access Savings,-5.00,0.00,EUR,COMPLETED,429.43
Transfer,Current,2025-05-04 17:07:54,2025-05-04 17:07:54,To Instant Access Savings,-4.50,0.00,EUR,COMPLETED,424.93
Transfer,Current,2025-05-04 18:43:09,2025-05-04 18:43:09,To Instant Access Savings,-3.25,0.00,EUR,COMPLETED,421.68
Transfer,Current,2025-05-04 20:01:39,2025-05-04 20:01:39,To Instant Access Savings,-2.05,0.00,EUR,COMPLETED,419.63
Transfer,Current,2025-05-02 14:43:14,2025-05-05 01:51:01,To Trading 212 UK Limited,-250.00,0.00,EUR,COMPLETED,169.63
Card Payment,Current,2025-05-04 15:12:27,2025-05-05 11:42:12,Spar,-8.00,0.00,EUR,COMPLETED,161.63
Card Payment,Current,2025-05-04 20:01:39,2025-05-05 13:49:32,Deliveroo,-22.59,0.00,EUR,COMPLETED,139.04
Card Payment,Current,2025-05-04 11:34:22,2025-05-05 14:28:53,Amazon,-10.59,0.00,EUR,COMPLETED,128.45
Exchange,Current,2025-05-05 16:27:01,2025-05-05 16:27:01,Exchanged to EUR,4868.39,0.00,EUR,COMPLETED,4996.84
Transfer,Current,2025-05-05 16:27:24,2025-05-05 16:27:24,To Instant Access Savings,-3600.00,0.00,EUR,COMPLETED,1396.84
Transfer,Current,2025-05-06 07:25:52,2025-05-06 07:25:52,To Instant Access Savings,-0.25,0.00,EUR,COMPLETED,1396.59
Transfer,Current,2025-05-06 08:49:50,2025-05-06 08:49:50,To Instant Access Savings,-1.50,0.00,EUR,COMPLETED,1395.09
Card Payment,Current,2025-05-04 17:07:54,2025-05-06 12:30:29,PaMcGrath's,-12.10,0.00,EUR,COMPLETED,1382.99
Card Payment,Current,2025-05-04 18:43:08,2025-05-06 12:31:00,PaMcGrath's,-9.35,0.00,EUR,COMPLETED,1373.64
Transfer,Current,2025-05-06 15:45:20,2025-05-06 15:45:21,Transfer to MARA DI RAIMONDO,-22.50,0.00,EUR,COMPLETED,1351.14
Card Payment,Current,2025-05-06 07:25:51,2025-05-06 16:12:00,Marathon Photos Live,-19.95,0.00,EUR,COMPLETED,1331.19
Transfer,Current,2025-05-06 21:14:52,2025-05-06 21:14:52,To Instant Access Savings,-3.60,0.00,EUR,COMPLETED,1327.59
Transfer,Current,2025-05-07 08:52:50,2025-05-07 08:52:50,To Instant Access Savings,-4.10,0.00,EUR,COMPLETED,1323.49
Card Payment,Current,2025-05-06 08:49:50,2025-05-07 12:27:13,Lidl,-31.70,0.00,EUR,COMPLETED,1291.79
Transfer,Current,2025-05-07 16:12:27,2025-05-07 16:12:27,To Instant Access Savings,-2.40,0.00,EUR,COMPLETED,1289.39
Transfer,Current,2025-05-07 17:49:46,2025-05-07 17:49:46,To Instant Access Savings,-0.90,0.00,EUR,COMPLETED,1288.49
Transfer,Current,2025-05-07 19:21:51,2025-05-07 19:21:51,To Instant Access Savings,-1.65,0.00,EUR,COMPLETED,1286.84
Transfer,Current,2025-05-08 08:15:06,2025-05-08 08:15:06,To Instant Access Savings,-0.05,0.00,EUR,COMPLETED,1286.79
Card Payment,Current,2025-05-07 16:12:27,2025-05-08 12:12:26,Eventmaster,-40.52,0.00,EUR,COMPLETED,1246.27
Card Payment,Current,2025-05-07 08:52:50,2025-05-08 16:41:23,Amazon,-24.18,0.00,EUR,COMPLETED,1222.09
Card Payment,Current,2025-05-06 21:14:52,2025-05-08 16:42:29,Amazon,-28.28,0.00,EUR,COMPLETED,1193.81
Card Payment,Current,2025-05-07 17:49:46,2025-05-08 17:20:00,Amazon,-15.42,0.00,EUR,COMPLETED,1178.39
Card Payment,Current,2025-05-07 19:21:51,2025-05-08 17:20:01,Amazon,-96.67,0.00,EUR,COMPLETED,1081.72
Transfer,Current,2025-05-09 08:57:30,2025-05-09 08:57:30,To Instant Access Savings,-2.20,0.00,EUR,COMPLETED,1079.52
Transfer,Current,2025-05-09 09:12:00,2025-05-09 09:12:00,To Instant Access Savings,-2.75,0.00,EUR,COMPLETED,1076.77
Card Payment,Current,2025-05-08 08:15:05,2025-05-09 13:00:02,Clark’s Newsagent,-8.99,0.00,EUR,COMPLETED,1067.78
Transfer,Current,2025-05-09 15:33:43,2025-05-09 15:33:43,To Instant Access Savings,-4.75,0.00,EUR,COMPLETED,1063.03
Transfer,Current,2025-05-09 18:14:21,2025-05-09 18:14:21,To Instant Access Savings,-1.50,0.00,EUR,COMPLETED,1061.53
Transfer,Current,2025-05-09 18:20:28,2025-05-09 18:20:28,To Instant Access Savings,-2.50,0.00,EUR,COMPLETED,1059.03
Transfer,Current,2025-05-09 18:26:26,2025-05-09 18:26:26,To Instant Access Savings,-0.05,0.00,EUR,COMPLETED,1058.98
Transfer,Current,2025-05-09 21:42:17,2025-05-09 21:42:17,To Instant Access Savings,-1.50,0.00,EUR,COMPLETED,1057.48
Transfer,Current,2025-05-09 23:14:52,2025-05-09 23:14:52,To Instant Access Savings,-5.00,0.00,EUR,COMPLETED,1052.48
Transfer,Current,2025-05-09 23:18:19,2025-05-09 23:18:19,To Instant Access Savings,-2.35,0.00,EUR,COMPLETED,1050.13
Transfer,Current,2025-05-10 00:35:37,2025-05-10 00:35:37,To Instant Access Savings,-5.00,0.00,EUR,COMPLETED,1045.13
Card Payment,Current,2025-05-09 23:18:19,2025-05-10 10:31:20,GoMo,-16.53,0.00,EUR,COMPLETED,1028.60
Card Payment,Current,2025-05-09 09:11:59,2025-05-10 10:33:29,Applegreen,-6.45,0.00,EUR,COMPLETED,1022.15
Card Payment,Current,2025-05-09 18:14:20,2025-05-10 10:35:57,McDonald's,-10.70,0.00,EUR,COMPLETED,1011.45
Transfer,Current,2025-05-10 10:43:09,2025-05-10 10:43:10,To Instant Access Savings,-4.25,0.00,EUR,COMPLETED,1007.20
Transfer,Current,2025-05-10 11:16:44,2025-05-10 11:16:44,To Instant Access Savings,-4.75,0.00,EUR,COMPLETED,1002.45
Card Payment,Current,2025-05-09 18:20:27,2025-05-10 17:34:07,Tesco,-29.50,0.00,EUR,COMPLETED,972.95
Card Payment,Current,2025-05-09 18:26:25,2025-05-10 17:34:08,Tesco,-0.99,0.00,EUR,COMPLETED,971.96
Card Payment,Current,2025-05-09 21:42:16,2025-05-10 17:40:06,Lane7,-46.70,0.00,EUR,COMPLETED,925.26
Transfer,Current,2025-05-10 18:10:27,2025-05-10 18:10:27,To Instant Access Savings,-4.50,0.00,EUR,COMPLETED,920.76
Transfer,Current,2025-05-10 18:12:15,2025-05-10 18:12:15,Transfer to EMMA SADBH MURPHY,-16.90,0.00,EUR,COMPLETED,903.86
Card Payment,Current,2025-05-09 08:57:29,2025-05-10 18:54:59,Lidl,-13.56,0.00,EUR,COMPLETED,890.30
Card Payment,Current,2025-05-09 15:33:42,2025-05-10 21:48:25,Amazon,-23.05,0.00,EUR,COMPLETED,867.25
Card Payment,Current,2025-05-09 23:14:52,2025-05-11 10:40:47,Pye Dundrum,-5.00,0.00,EUR,COMPLETED,862.25
Card Payment,Current,2025-05-10 18:10:26,2025-05-11 10:45:23,Deliveroo,-57.10,0.00,EUR,COMPLETED,805.15
Card Payment,Current,2025-05-10 10:43:09,2025-05-11 12:43:28,Applegreen,-11.15,0.00,EUR,COMPLETED,794.00
Card Payment,Current,2025-05-10 11:16:43,2025-05-11 12:43:28,Applegreen,-3.05,0.00,EUR,COMPLETED,790.95
Card Payment,Current,2025-05-10 00:35:37,2025-05-12 09:28:11,Easytrip,-10.00,0.00,EUR,COMPLETED,780.95
Card Payment,Current,2025-05-11 10:09:31,2025-05-12 13:39:16,SuperValu,-41.09,0.00,EUR,COMPLETED,739.86
Transfer,Current,2025-05-12 14:59:31,2025-05-12 14:59:35,Transfer from MARA DI RAIMONDO,52.00,0.00,EUR,COMPLETED,791.86
Transfer,Current,2025-05-12 15:51:03,2025-05-12 15:51:05,Transfer to BARRY NEVILLE,-104.00,0.00,EUR,COMPLETED,687.86
Card Payment,Current,2025-05-11 10:55:19,2025-05-12 20:30:07,The Washington Post,-0.99,0.00,EUR,COMPLETED,686.87
Card Payment,Current,2025-05-12 18:47:47,2025-05-13 11:00:12,SuperValu,-34.65,0.00,EUR,COMPLETED,652.22
Transfer,Current,2025-05-14 08:22:37,2025-05-14 08:22:37,From Instant Access Savings,1000.00,0.00,EUR,COMPLETED,1652.22
Card Payment,Current,2025-05-13 19:34:43,2025-05-14 11:05:16,Gleesons,-3.40,0.00,EUR,COMPLETED,1648.82
Transfer,Current,2025-05-14 19:47:38,2025-05-14 19:47:38,Transfer from MARA DI RAIMONDO,18.59,0.00,EUR,COMPLETED,1667.41
Card Payment,Current,2025-05-14 19:18:37,2025-05-15 10:43:57,Amazon,-18.59,0.00,EUR,COMPLETED,1648.82
Card Payment,Current,2025-05-14 13:53:11,2025-05-15 11:22:06,Boojum,-14.25,0.00,EUR,COMPLETED,1634.57
Card Payment,Current,2025-05-14 12:08:07,2025-05-15 13:11:18,SuperValu,-2.85,0.00,EUR,COMPLETED,1631.72
Transfer,Current,2025-05-15 19:09:36,2025-05-15 19:09:36,Transfer to MARA DI RAIMONDO,-22.00,0.00,EUR,COMPLETED,1609.72
Card Payment,Current,2025-05-15 19:09:06,2025-05-16 10:13:17,Deliveroo,-45.35,0.00,EUR,COMPLETED,1564.37
Card Payment,Current,2025-05-15 13:36:05,2025-05-16 10:29:36,Boojum,-10.90,0.00,EUR,COMPLETED,1553.47
Card Payment,Current,2025-05-15 08:07:18,2025-05-16 10:32:14,Transport for Ireland - TFI,-50.00,0.00,EUR,COMPLETED,1503.47
Card Payment,Current,2025-05-15 18:00:38,2025-05-16 13:04:17,Centra,-17.00,0.00,EUR,COMPLETED,1486.47
Card Payment,Current,2025-05-15 08:54:53,2025-05-16 13:23:56,Copper + Straw,-9.50,0.00,EUR,COMPLETED,1476.97
Transfer,Current,2025-05-16 19:30:49,2025-05-16 19:30:50,Transfer to Andrew James Fullen,-25.00,0.00,EUR,COMPLETED,1451.97
Transfer,Current,2025-05-17 10:33:24,2025-05-17 10:33:24,Transfer to MARA DI RAIMONDO,-27.00,0.00,EUR,COMPLETED,1424.97
Card Payment,Current,2025-05-16 21:23:30,2025-05-17 17:13:51,4b Factory,-55.00,0.00,EUR,COMPLETED,1369.97
Card Payment,Current,2025-05-16 22:29:09,2025-05-17 17:37:18,LE CLOS,-13.40,0.00,EUR,COMPLETED,1356.57
Card Payment,Current,2025-05-16 21:43:56,2025-05-17 17:37:18,LE CLOS,-33.50,0.00,EUR,COMPLETED,1323.07
Card Payment,Current,2025-05-16 22:08:59,2025-05-17 17:37:18,LE CLOS,-33.50,0.00,EUR,COMPLETED,1289.57
Card Payment,Current,2025-05-16 23:04:11,2025-05-17 17:37:29,LE CLOS,-6.70,0.00,EUR,COMPLETED,1282.87
Card Payment,Current,2025-05-16 10:26:04,2025-05-17 17:39:33,FREE NOW,-54.50,0.00,EUR,COMPLETED,1228.37
Card Payment,Current,2025-05-16 09:51:08,2025-05-17 18:19:24,WHSmith,-26.56,0.00,EUR,COMPLETED,1201.81
Card Payment,Current,2025-05-16 10:01:44,2025-05-17 18:23:49,Butlers Chocolates,-10.20,0.00,EUR,COMPLETED,1191.61
Card Payment,Current,2025-05-16 16:50:30,2025-05-18 11:09:28,Keolis,-9.50,0.00,EUR,COMPLETED,1182.11
Transfer,Current,2025-05-18 19:48:50,2025-05-18 19:48:51,Transfer to Robin O Connell,-6.00,0.00,EUR,COMPLETED,1176.11
Card Payment,Current,2025-05-18 13:44:38,2025-05-19 12:29:12,Fernand,-5.50,0.00,EUR,COMPLETED,1170.61
Card Payment,Current,2025-05-18 10:58:20,2025-05-19 12:34:02,Boulangerie,-10.00,0.00,EUR,COMPLETED,1160.61
Card Payment,Current,2025-05-18 17:35:24,2025-05-19 14:28:34,Le 22,-6.99,0.00,EUR,COMPLETED,1153.62
Card Payment,Current,2025-05-18 17:41:51,2025-05-19 14:42:40,Central Hostel,-12.00,0.00,EUR,COMPLETED,1141.62
Card Payment,Current,2025-05-17 10:37:52,2025-05-19 14:49:26,Vival,-1.60,0.00,EUR,COMPLETED,1140.02
Card Payment,Current,2025-05-16 18:03:17,2025-05-19 14:52:41,Novotel,-22.44,0.00,EUR,COMPLETED,1117.58
Transfer,Current,2025-05-19 23:45:52,2025-05-19 23:45:52,Transfer from MARA DI RAIMONDO,18.08,0.00,EUR,COMPLETED,1135.66
Transfer,Current,2025-05-19 23:45:57,2025-05-19 23:45:57,Transfer from MARA DI RAIMONDO,18.18,0.00,EUR,COMPLETED,1153.84
Transfer,Current,2025-05-20 10:33:25,2025-05-20 10:33:26,Transfer from Andrew James Fullen,18.06,0.00,EUR,COMPLETED,1171.90
Transfer,Current,2025-05-20 10:33:35,2025-05-20 10:33:36,Transfer from Andrew James Fullen,18.16,0.00,EUR,COMPLETED,1190.06
Card Payment,Current,2025-05-19 10:09:32,2025-05-20 11:08:41,Boulangerie,-2.90,0.00,EUR,COMPLETED,1187.16
Card Payment,Current,2025-05-18 13:23:24,2025-05-20 13:20:41,La Mere Michel,-96.20,0.00,EUR,COMPLETED,1090.96
Card Payment,Current,2025-05-18 20:32:00,2025-05-20 13:21:51,Cajou Caffé,-8.50,0.00,EUR,COMPLETED,1082.46
Card Payment,Current,2025-05-18 21:10:39,2025-05-20 13:21:51,Cajou Caffé,-12.70,0.00,EUR,COMPLETED,1069.76
Card Payment,Current,2025-05-19 11:54:30,2025-05-20 14:34:21,Ginkho,-24.20,0.00,EUR,COMPLETED,1045.56
Card Payment,Current,2025-05-19 14:25:49,2025-05-20 14:38:27,RELAY,-3.80,0.00,EUR,COMPLETED,1041.76
Card Payment,Current,2025-05-19 23:16:50,2025-05-20 14:50:05,Michael Ojigbogi,-54.20,0.00,EUR,COMPLETED,987.56
Card Payment,Current,2025-05-19 18:13:07,2025-05-20 14:58:10,HMSHost International,-26.70,0.00,EUR,COMPLETED,960.86
Transfer,Current,2025-05-20 18:28:51,2025-05-20 18:28:51,Transfer from MARA DI RAIMONDO,22.20,0.00,EUR,COMPLETED,983.06
Card Payment,Current,2025-05-20 18:28:09,2025-05-21 09:23:55,Deliveroo,-22.20,0.00,EUR,COMPLETED,960.86
Card Payment,Current,2025-05-19 20:11:21,2025-05-21 13:48:09,WHSmith,-4.05,0.00,EUR,COMPLETED,956.81
Card Payment,Current,2025-05-19 13:06:06,2025-05-21 14:05:18,Keolis,-3.80,0.00,EUR,COMPLETED,953.01
Card Payment,Current,2025-05-20 08:40:24,2025-05-21 14:59:10,SuperValu,-21.76,0.00,EUR,COMPLETED,931.25
Transfer,Current,2025-05-22 01:00:00,2025-05-22 11:49:58,To eFlow,-32.83,0.00,EUR,COMPLETED,898.42
Card Payment,Current,2025-05-21 12:29:33,2025-05-22 17:53:22,Amazon,-1.99,0.00,EUR,COMPLETED,896.43
Topup,Current,2025-05-23 06:28:14,2025-05-23 06:28:14,Payment from WORKDAY LIMITED,3015.97,0.00,EUR,COMPLETED,3912.40
Card Payment,Current,2025-05-22 21:39:14,2025-05-23 13:49:12,FREE NOW,-38.00,0.00,EUR,COMPLETED,3874.40
Card Payment,Current,2025-05-22 08:48:51,2025-05-23 16:28:12,Copper + Straw,-9.50,0.00,EUR,COMPLETED,3864.90
Card Payment,Current,2025-05-23 12:53:08,2025-05-24 09:02:09,Dublin Dundrum Centre,-49.99,0.00,EUR,COMPLETED,3814.91
Card Payment,Current,2025-05-23 13:44:38,2025-05-24 09:49:16,Boots,-6.99,0.00,EUR,COMPLETED,3807.92
Card Payment,Current,2025-05-23 11:57:30,2025-05-24 14:41:10,Spar,-3.30,0.00,EUR,COMPLETED,3804.62
Card Payment,Current,2025-05-23 18:16:44,2025-05-24 14:59:17,Deliveroo,-70.64,0.00,EUR,COMPLETED,3733.98
Card Payment,Current,2025-05-23 13:39:50,2025-05-24 15:08:41,Dunnes Stores,-93.00,0.00,EUR,COMPLETED,3640.98
Card Payment,Current,2025-05-23 14:17:31,2025-05-24 15:19:01,SuperValu,-26.41,0.00,EUR,COMPLETED,3614.57
Card Payment,Current,2025-05-23 22:22:18,2025-05-24 15:54:39,All4running,-159.95,0.00,EUR,COMPLETED,3454.62
Transfer,Current,2025-05-24 21:51:44,2025-05-24 21:51:44,Transfer from MARA DI RAIMONDO,390.00,0.00,EUR,COMPLETED,3844.62
Transfer,Current,2025-05-25 09:43:58,2025-05-25 09:43:58,To pocket EUR Subscriptions from EUR,-250.00,0.00,EUR,COMPLETED,3594.62
Transfer,Current,2025-05-25 09:43:58,2025-05-25 09:43:58,To pocket EUR Subscriptions from EUR,-780.42,0.00,EUR,COMPLETED,2814.20
Card Payment,Current,2025-05-24 12:14:08,2025-05-25 11:07:31,Centra,-4.80,0.00,EUR,COMPLETED,2809.40
Card Payment,Current,2025-05-24 18:31:13,2025-05-25 11:07:56,SuperValu,-30.99,0.00,EUR,COMPLETED,2778.41
Card Payment,Current,2025-05-23 21:05:23,2025-05-25 13:13:24,Amazon,-15.34,0.00,EUR,COMPLETED,2763.07
Card Payment,Current,2025-05-23 20:14:41,2025-05-25 13:13:37,Amazon,-19.79,0.00,EUR,COMPLETED,2743.28
Transfer,Current,2025-05-25 17:31:05,2025-05-25 17:31:05,Transfer to CONOR NAYLOR,-32.00,0.00,EUR,COMPLETED,2711.28
Card Payment,Current,2025-05-24 12:16:33,2025-05-25 17:31:34,Parlour,-14.40,0.00,EUR,COMPLETED,2696.88
Card Payment,Current,2025-05-24 12:42:43,2025-05-25 17:31:34,Parlour,-5.90,0.00,EUR,COMPLETED,2690.98
Card Refund,Current,2025-05-24 08:03:33,2025-05-25 17:32:22,All4running,159.95,0.00,EUR,COMPLETED,2850.93
Card Payment,Current,2025-05-24 10:43:40,2025-05-25 17:32:22,All4running,-159.95,0.00,EUR,COMPLETED,2690.98
Card Payment,Current,2025-05-24 14:23:09,2025-05-25 18:33:28,Applegreen,-69.20,0.00,EUR,COMPLETED,2621.78
Transfer,Current,2025-05-25 08:21:35,2025-05-26 02:07:09,To Payward Ireland Ltd.,-125.00,0.00,EUR,COMPLETED,2496.78
Transfer,Current,2025-05-25 08:21:35,2025-05-26 02:07:09,To Trading 212 UK Limited,-750.00,0.00,EUR,COMPLETED,1746.78
Transfer,Current,2025-05-26 08:35:39,2025-05-26 08:35:40,Transfer to MARA DI RAIMONDO,-60.00,0.00,EUR,COMPLETED,1686.78
Card Payment,Current,2025-05-24 17:36:28,2025-05-26 09:41:39,The Merry Cobbler,-60.00,0.00,EUR,COMPLETED,1626.78
Card Payment,Current,2025-05-25 16:21:34,2025-05-26 13:53:05,Payzone,-10.00,0.00,EUR,COMPLETED,1616.78
Card Payment,Current,2025-05-25 14:41:36,2025-05-26 13:54:15,SuperValu,-9.79,0.00,EUR,COMPLETED,1606.99
Card Payment,Current,2025-05-26 03:00:37,2025-05-26 14:58:10,DSPCA,-15.00,0.00,EUR,COMPLETED,1591.99
Card Payment,Current,2025-05-23 21:33:55,2025-05-27 09:59:01,Adidas,-450.00,0.00,EUR,COMPLETED,1141.99
Card Payment,Current,2025-05-26 08:56:12,2025-05-27 10:56:41,SuperValu,-37.76,0.00,EUR,COMPLETED,1104.23
Transfer,Current,2025-05-27 11:40:03,2025-05-27 11:40:04,Transfer to PAUL MICHAEL MC CARTHY,-272.00,0.00,EUR,COMPLETED,832.23
Card Payment,Current,2025-05-27 19:42:59,2025-05-28 13:20:14,Six By Nico,-111.65,0.00,EUR,COMPLETED,720.58
Card Payment,Current,2025-05-27 19:41:31,2025-05-28 13:28:00,YUNO,-126.82,0.00,EUR,COMPLETED,593.76
Card Payment,Current,2025-05-28 00:34:38,2025-05-28 13:49:05,Apple,-9.99,0.00,EUR,COMPLETED,583.77
Transfer,Current,2025-05-28 17:23:49,2025-05-28 17:23:49,To pocket EUR Subscriptions from EUR,-500.00,0.00,EUR,COMPLETED,83.77
Transfer,Current,2025-05-28 20:05:33,2025-05-28 20:05:34,Transfer to JOHN DANIEL KIELY,-23.00,0.00,EUR,COMPLETED,60.77
Transfer,Current,2025-05-28 20:05:43,2025-05-28 20:05:43,Transfer to JOHN DANIEL KIELY,-3.00,0.00,EUR,COMPLETED,57.77
Transfer,Current,2025-05-29 12:52:11,2025-05-29 12:52:12,From Instant Access Savings,370.00,0.00,EUR,COMPLETED,427.77
Transfer,Current,2025-05-29 12:52:31,2025-05-29 12:52:32,Transfer to PAUL MICHAEL MC CARTHY,-272.00,0.00,EUR,COMPLETED,155.77
Transfer,Current,2025-05-29 14:47:47,2025-05-29 14:48:00,To Instant Access Savings,-5.00,0.00,EUR,COMPLETED,150.77
Transfer,Current,2025-05-29 21:44:57,2025-05-29 21:44:57,To Instant Access Savings,-3.60,0.00,EUR,COMPLETED,147.17
Transfer,Current,2025-05-30 09:04:15,2025-05-30 09:04:15,To Instant Access Savings,-1.10,0.00,EUR,COMPLETED,146.07
Transfer,Current,2025-05-30 09:19:43,2025-05-30 09:19:43,To Instant Access Savings,-4.75,0.00,EUR,COMPLETED,141.32
Transfer,Current,2025-05-30 09:57:49,2025-05-30 09:57:50,From Instant Access Savings,150.00,0.00,EUR,COMPLETED,291.32
Transfer,Current,2025-05-30 10:01:01,2025-05-30 10:01:01,To Instant Access Savings,-5.00,0.00,EUR,COMPLETED,286.32
Transfer,Current,2025-05-30 11:33:03,2025-05-30 11:33:03,To Instant Access Savings,-4.05,0.00,EUR,COMPLETED,282.27
Card Payment,Current,2025-05-29 14:47:31,2025-05-30 12:12:10,Daybreak,-9.00,0.00,EUR,COMPLETED,273.27
Card Payment,Current,2025-05-29 21:44:56,2025-05-30 14:26:08,Amazon,-73.28,0.00,EUR,COMPLETED,199.99
Transfer,Current,2025-05-30 20:09:19,2025-05-30 20:09:20,To Instant Access Savings,-3.00,0.00,EUR,COMPLETED,196.99
Transfer,Current,2025-05-30 21:38:04,2025-05-30 21:38:04,To Instant Access Savings,-4.00,0.00,EUR,COMPLETED,192.99
Transfer,Current,2025-05-30 22:49:48,2025-05-30 22:49:48,To Instant Access Savings,-2.50,0.00,EUR,COMPLETED,190.49
Transfer,Current,2025-05-30 22:57:50,2025-05-30 22:57:50,To Instant Access Savings,-2.50,0.00,EUR,COMPLETED,187.99
Transfer,Current,2025-05-30 23:54:39,2025-05-30 23:54:39,From Instant Access Savings,100.00,0.00,EUR,COMPLETED,287.99
Transfer,Current,2025-05-30 23:54:56,2025-05-30 23:54:56,To Instant Access Savings,-2.00,0.00,EUR,COMPLETED,285.99
Transfer,Current,2025-05-31 00:26:12,2025-05-31 00:26:12,To Instant Access Savings,-2.50,0.00,EUR,COMPLETED,283.49
Transfer,Current,2025-05-31 00:45:39,2025-05-31 00:45:39,To Instant Access Savings,-1.00,0.00,EUR,COMPLETED,282.49
Transfer,Current,2025-05-31 02:35:04,2025-05-31 02:35:04,To Instant Access Savings,-2.50,0.00,EUR,COMPLETED,279.99
Transfer,Current,2025-05-31 10:13:19,2025-05-31 10:13:19,To Instant Access Savings,-5.00,0.00,EUR,COMPLETED,274.99
Transfer,Current,2025-05-31 10:32:27,2025-05-31 10:32:28,Transfer from EMMA SADBH MURPHY,17.00,0.00,EUR,COMPLETED,291.99
Transfer,Current,2025-05-31 14:54:59,2025-05-31 14:54:59,To Instant Access Savings,-3.00,0.00,EUR,COMPLETED,288.99
Card Payment,Current,2025-05-30 09:04:15,2025-05-31 16:02:31,Lidl,-35.78,0.00,EUR,COMPLETED,253.21
Card Payment,Current,2025-05-30 11:33:02,2025-05-31 16:12:46,SuperValu,-5.19,0.00,EUR,COMPLETED,248.02
Card Payment,Current,2025-05-30 09:13:37,2025-05-31 16:14:28,Starbucks,-5.05,0.00,EUR,COMPLETED,242.97
Card Payment,Current,2025-05-30 21:38:03,2025-05-31 16:26:58,The Vending Company,-10.20,0.00,EUR,COMPLETED,232.77
Transfer,Current,2025-05-31 17:03:19,2025-05-31 17:03:19,To Instant Access Savings,-2.00,0.00,EUR,COMPLETED,230.77
Transfer,Current,2025-05-31 17:55:09,2025-05-31 17:55:09,From Instant Access Savings,150.00,0.00,EUR,COMPLETED,380.77
Transfer,Current,2025-05-31 17:55:36,2025-05-31 17:55:36,To Instant Access Savings,-2.50,0.00,EUR,COMPLETED,378.27
Transfer,Current,2025-05-31 21:18:55,2025-05-31 21:18:56,Transfer to LUKE GAVIGAN,-100.00,0.00,EUR,COMPLETED,278.27
Transfer,Current,2025-06-01 01:31:11,2025-06-01 01:31:11,To Instant Access Savings,-0.60,0.00,EUR,COMPLETED,277.67
Card Payment,Current,2025-05-30 10:01:00,2025-06-01 10:49:18,Ticketmaster,-81.00,0.00,EUR,COMPLETED,196.67
Card Payment,Current,2025-05-31 02:35:03,2025-06-01 10:49:25,FREE NOW,-36.50,0.00,EUR,COMPLETED,160.17
Card Payment,Current,2025-05-31 00:26:11,2025-06-01 10:50:57,Whelan's,-3.50,0.00,EUR,COMPLETED,156.67
Card Payment,Current,2025-05-30 22:57:49,2025-06-01 10:50:58,Whelan's,-3.50,0.00,EUR,COMPLETED,153.17
Card Payment,Current,2025-05-31 14:54:59,2025-06-01 10:51:33,Parking Payments,-4.40,0.00,EUR,COMPLETED,148.77
Card Payment,Current,2025-05-30 22:49:47,2025-06-01 10:52:01,Whelan's,-3.50,0.00,EUR,COMPLETED,145.27
Card Payment,Current,2025-05-30 20:09:19,2025-06-01 10:52:01,Whelan's,-27.40,0.00,EUR,COMPLETED,117.87
Card Payment,Current,2025-05-30 23:54:55,2025-06-01 10:52:02,Whelan's,-27.60,0.00,EUR,COMPLETED,90.27
Card Payment,Current,2025-05-31 17:03:19,2025-06-01 10:52:45,Parking Payments,-1.60,0.00,EUR,COMPLETED,88.67
Card Payment,Current,2025-05-31 10:13:18,2025-06-01 10:53:31,Mint,-14.00,0.00,EUR,COMPLETED,74.67
Card Payment,Current,2025-06-01 01:31:11,2025-06-01 11:02:25,geoguessr.com,-35.88,0.00,EUR,COMPLETED,38.79
Card Payment,Current,2025-05-31 00:45:39,2025-06-01 11:25:04,Yeeros,-15.80,0.00,EUR,COMPLETED,22.99
Card Payment,Current,2025-05-31 17:55:35,2025-06-01 12:02:11,Maxol,-8.50,0.00,EUR,COMPLETED,14.49
Transfer,Current,2025-06-02 10:56:43,2025-06-02 10:56:44,From Instant Access Savings,200.00,0.00,EUR,COMPLETED,214.49
Transfer,Current,2025-06-02 10:56:55,2025-06-02 10:56:55,To Instant Access Savings,-3.60,0.00,EUR,COMPLETED,210.89
Transfer,Current,2025-06-02 11:36:13,2025-06-02 11:36:13,To Instant Access Savings,-0.25,0.00,EUR,COMPLETED,210.64
Transfer,Current,2025-06-02 12:34:32,2025-06-02 12:34:32,To Instant Access Savings,-3.50,0.00,EUR,COMPLETED,207.14
Topup,Current,2025-06-02 18:55:05,2025-06-02 18:55:05,Payment from PATRICIA        QUISH,100.00,0.00,EUR,COMPLETED,307.14
Transfer,Current,2025-06-02 22:27:51,2025-06-02 22:27:51,To Instant Access Savings,-4.90,0.00,EUR,COMPLETED,302.24
Transfer,Current,2025-06-03 03:36:24,2025-06-03 03:36:25,To Instant Access Savings,-0.05,0.00,EUR,COMPLETED,302.19
Transfer,Current,2025-06-03 08:50:59,2025-06-03 08:50:59,To pocket EUR Subscriptions from EUR,-40.00,0.00,EUR,COMPLETED,262.19
Transfer,Current,2025-06-03 08:53:52,2025-06-03 08:53:52,To Instant Access Savings,-4.35,0.00,EUR,COMPLETED,257.84
Card Payment,Current,2025-06-02 11:36:13,2025-06-03 10:19:10,Cinnamon,-81.95,0.00,EUR,COMPLETED,175.89
Card Payment,Current,2025-06-02 12:34:31,2025-06-03 10:28:29,Spar,-3.30,0.00,EUR,COMPLETED,172.59
Card Payment,Current,2025-06-03 03:36:24,2025-06-03 10:54:30,Netflix,-10.99,0.00,EUR,COMPLETED,161.60
Card Payment,Current,2025-06-02 22:27:51,2025-06-03 12:16:29,Amazon,-13.02,0.00,EUR,COMPLETED,148.58
Transfer,Current,2025-06-03 13:53:28,2025-06-03 13:53:28,To Instant Access Savings,-1.55,0.00,EUR,COMPLETED,147.03
Transfer,Current,2025-06-03 14:09:04,2025-06-03 14:09:04,Transfer from MARA DI RAIMONDO,22.00,0.00,EUR,COMPLETED,169.03
Exchange,Current,2025-06-03 15:25:18,2025-06-03 15:25:18,Exchanged to EUR,8415.48,0.00,EUR,COMPLETED,8584.51
Transfer,Current,2025-06-03 20:17:13,2025-06-03 20:17:13,To Instant Access Savings,-5.00,0.00,EUR,COMPLETED,8579.51
Card Payment,Current,2025-06-03 13:53:28,2025-06-04 10:26:33,Deliveroo,-21.69,0.00,EUR,COMPLETED,8557.82
Transfer,Current,2025-06-04 11:39:28,2025-06-04 11:39:28,To Instant Access Savings,-1.35,0.00,EUR,COMPLETED,8556.47
Card Payment,Current,2025-06-03 08:53:52,2025-06-04 11:41:19,Lidl,-21.13,0.00,EUR,COMPLETED,8535.34
Transfer,Current,2025-06-04 11:58:41,2025-06-04 11:58:41,Transfer to MARA DI RAIMONDO,-22.50,0.00,EUR,COMPLETED,8512.84
Card Payment,Current,2025-06-02 10:56:54,2025-06-04 13:40:48,Amazon,-79.28,0.00,EUR,COMPLETED,8433.56
Card Payment,Current,2025-06-04 11:39:27,2025-06-05 14:34:41,Amazon,-10.73,0.00,EUR,COMPLETED,8422.83
Card Payment,Current,2025-06-03 20:17:13,2025-06-05 14:40:07,Amazon,-10.00,0.00,EUR,COMPLETED,8412.83
Transfer,Current,2025-06-05 17:57:22,2025-06-05 17:57:22,To Instant Access Savings,-5.00,0.00,EUR,COMPLETED,8407.83
Transfer,Current,2025-06-06 05:55:50,2025-06-06 05:55:50,To Instant Access Savings,-1.05,0.00,EUR,COMPLETED,8406.78
Transfer,Current,2025-06-06 08:18:39,2025-06-06 08:18:39,To Instant Access Savings,-5.00,0.00,EUR,COMPLETED,8401.78
Transfer,Current,2025-06-06 08:32:40,2025-06-06 08:32:40,To Instant Access Savings,-0.50,0.00,EUR,COMPLETED,8401.28
Transfer,Current,2025-06-06 10:34:47,2025-06-06 10:34:48,To Instant Access Savings,-2.55,0.00,EUR,COMPLETED,8398.73
Transfer,Current,2025-06-06 10:42:06,2025-06-06 10:42:09,To Colm Quish,-50.00,0.00,EUR,COMPLETED,8348.73
Transfer,Current,2025-06-06 11:28:26,2025-06-06 11:28:26,To Instant Access Savings,-5.00,0.00,EUR,COMPLETED,8343.73
Transfer,Current,2025-06-06 11:33:48,2025-06-06 11:33:48,To Instant Access Savings,-0.05,0.00,EUR,COMPLETED,8343.68
Card Payment,Current,2025-06-05 17:57:21,2025-06-06 12:18:46,RealDebrid,-16.00,0.00,EUR,COMPLETED,8327.68
Transfer,Current,2025-06-06 18:12:47,2025-06-06 18:12:48,To Instant Access Savings,-5.00,0.00,EUR,COMPLETED,8322.68
Transfer,Current,2025-06-06 18:24:09,2025-06-06 18:24:09,To Instant Access Savings,-5.00,0.00,EUR,COMPLETED,8317.68
Transfer,Current,2025-06-06 19:21:16,2025-06-06 19:21:16,To Instant Access Savings,-5.00,0.00,EUR,COMPLETED,8312.68
Transfer,Current,2025-06-06 19:36:04,2025-06-06 19:36:04,To Instant Access Savings,-4.00,0.00,EUR,COMPLETED,8308.68
Transfer,Current,2025-06-06 19:49:43,2025-06-06 19:49:43,Transfer to MARA DI RAIMONDO,-15.83,0.00,EUR,COMPLETED,8292.85
Transfer,Current,2025-06-06 20:03:01,2025-06-06 20:03:01,To Instant Access Savings,-4.05,0.00,EUR,COMPLETED,8288.80
Transfer,Current,2025-06-06 20:11:07,2025-06-06 20:11:08,To Instant Access Savings,-5.00,0.00,EUR,COMPLETED,8283.80
Transfer,Current,2025-06-06 21:34:24,2025-06-06 21:34:24,To Instant Access Savings,-0.15,0.00,EUR,COMPLETED,8283.65
Transfer,Current,2025-06-07 09:02:32,2025-06-07 09:02:33,To Instant Access Savings,-0.05,0.00,EUR,COMPLETED,8283.60
Card Payment,Current,2025-06-06 18:24:08,2025-06-07 09:42:14,Marks & Spencer,-24.00,0.00,EUR,COMPLETED,8259.60
Card Payment,Current,2025-06-06 11:28:26,2025-06-07 11:05:06,Eddie Doyle,-50.00,0.00,EUR,COMPLETED,8209.60
Card Payment,Current,2025-06-06 20:03:01,2025-06-07 11:11:25,Tesco,-3.19,0.00,EUR,COMPLETED,8206.41
Card Payment,Current,2025-06-06 19:21:16,2025-06-07 11:11:45,Brown Thomas,-55.00,0.00,EUR,COMPLETED,8151.41
Card Payment,Current,2025-06-06 11:33:48,2025-06-07 12:19:23,SuperValu,-13.99,0.00,EUR,COMPLETED,8137.42
Card Payment,Current,2025-06-06 18:12:47,2025-06-07 12:20:09,Dunnes Stores,-45.00,0.00,EUR,COMPLETED,8092.42
Card Payment,Current,2025-06-06 10:34:47,2025-06-07 12:22:15,Holland & Barrett,-10.49,0.00,EUR,COMPLETED,8081.93
Card Payment,Current,2025-06-06 05:55:50,2025-06-07 12:27:09,HP,-1.79,0.00,EUR,COMPLETED,8080.14
Card Payment,Current,2025-06-06 08:32:40,2025-06-07 12:36:55,Applegreen,-3.90,0.00,EUR,COMPLETED,8076.24
Card Payment,Current,2025-06-06 08:18:39,2025-06-07 12:37:10,Stillorgan Plaza Car Park,-2.00,0.00,EUR,COMPLETED,8074.24
Transfer,Current,2025-06-07 15:22:58,2025-06-07 15:22:58,To Instant Access Savings,-5.00,0.00,EUR,COMPLETED,8069.24
Transfer,Current,2025-06-07 16:06:41,2025-06-07 16:06:41,To Instant Access Savings,-2.60,0.00,EUR,COMPLETED,8066.64
Transfer,Current,2025-06-07 16:28:47,2025-06-07 16:28:47,To Instant Access Savings,-4.05,0.00,EUR,COMPLETED,8062.59
Transfer,Current,2025-06-08 10:48:35,2025-06-08 10:48:35,To Instant Access Savings,-3.30,0.00,EUR,COMPLETED,8059.29
Transfer,Current,2025-06-08 10:55:23,2025-06-08 10:55:23,To Instant Access Savings,-0.05,0.00,EUR,COMPLETED,8059.24
Card Payment,Current,2025-06-07 15:22:58,2025-06-08 11:15:00,Harvey Norman,-369.00,0.00,EUR,COMPLETED,7690.24
Card Payment,Current,2025-06-07 09:02:32,2025-06-08 11:24:17,PlayStation,-79.99,0.00,EUR,COMPLETED,7610.25
Card Payment,Current,2025-06-07 16:28:47,2025-06-08 11:51:46,Amazon,-4.19,0.00,EUR,COMPLETED,7606.06
Card Payment,Current,2025-06-07 16:06:41,2025-06-08 11:59:34,SuperValu,-10.48,0.00,EUR,COMPLETED,7595.58
Card Payment,Current,2025-06-06 19:36:04,2025-06-08 13:22:07,Amazon,-12.20,0.00,EUR,COMPLETED,7583.38
Transfer,Current,2025-06-08 15:02:04,2025-06-08 15:02:04,To Instant Access Savings,-4.70,0.00,EUR,COMPLETED,7578.68
Transfer,Current,2025-06-09 09:09:12,2025-06-09 10:07:14,To Trading 212 UK Limited,-3000.00,0.00,EUR,COMPLETED,4578.68
Card Payment,Current,2025-06-08 15:02:02,2025-06-09 10:44:40,Maxi Zoo,-121.06,0.00,EUR,COMPLETED,4457.62
Transfer,Current,2025-06-09 12:41:01,2025-06-09 12:41:01,To Instant Access Savings,-5.00,0.00,EUR,COMPLETED,4452.62
Card Payment,Current,2025-06-06 20:11:07,2025-06-09 13:35:17,Easytrip,-10.00,0.00,EUR,COMPLETED,4442.62
Card Payment,Current,2025-06-08 10:48:35,2025-06-09 13:52:12,Lidl,-42.34,0.00,EUR,COMPLETED,4400.28
Card Payment,Current,2025-06-06 21:34:23,2025-06-09 14:18:31,Amazon,-174.97,0.00,EUR,COMPLETED,4225.31
Transfer,Current,2025-06-09 15:10:51,2025-06-09 15:10:51,To Instant Access Savings,-2.90,0.00,EUR,COMPLETED,4222.41
Transfer,Current,2025-06-09 15:20:45,2025-06-09 15:20:45,To Instant Access Savings,-3.00,0.00,EUR,COMPLETED,4219.41
Transfer,Current,2025-06-09 15:31:48,2025-06-09 15:31:48,To Instant Access Savings,-3.55,0.00,EUR,COMPLETED,4215.86
Card Payment,Current,2025-06-08 10:55:22,2025-06-09 16:14:01,The Washington Post,-0.99,0.00,EUR,COMPLETED,4214.87
Transfer,Current,2025-06-09 17:41:43,2025-06-09 17:41:43,To Instant Access Savings,-3.80,0.00,EUR,COMPLETED,4211.07
Transfer,Current,2025-06-09 18:10:57,2025-06-09 18:10:57,Credit card repayment,-165.62,0.00,EUR,COMPLETED,4045.45
Transfer,Current,2025-06-09 18:16:23,2025-06-09 18:16:24,Transfer to ANASTASSIA TUMANINA,-80.00,0.00,EUR,COMPLETED,3965.45
Transfer,Current,2025-06-09 21:14:19,2025-06-09 21:14:19,To Instant Access Savings,-2.15,0.00,EUR,COMPLETED,3963.30
Transfer,Current,2025-06-09 22:06:47,2025-06-09 22:06:47,To Instant Access Savings,-0.75,0.00,EUR,COMPLETED,3962.55
Card Payment,Current,2025-06-09 22:06:46,2025-06-10 08:35:56,Fressnapf,-81.85,0.00,EUR,COMPLETED,3880.70
Card Payment,Current,2025-06-09 17:41:43,2025-06-10 09:13:23,Tesco,-10.24,0.00,EUR,COMPLETED,3870.46
Transfer,Current,2025-06-10 09:18:37,2025-06-10 09:18:37,To Instant Access Savings,-3.05,0.00,EUR,COMPLETED,3867.41
Transfer,Current,2025-06-10 09:42:09,2025-06-10 09:42:09,Transfer from MARA DI RAIMONDO,39.95,0.00,EUR,COMPLETED,3907.36
Transfer,Current,2025-06-10 09:42:14,2025-06-10 09:42:14,Transfer from MARA DI RAIMONDO,40.00,0.00,EUR,COMPLETED,3947.36
Card Refund,Current,2025-06-10 01:00:00,2025-06-10 10:06:34,Apple,99.99,0.00,EUR,COMPLETED,4047.35
Transfer,Current,2025-06-10 10:11:40,2025-06-10 10:11:40,To pocket EUR Subscriptions from EUR,-1649.00,0.00,EUR,COMPLETED,2398.35
Transfer,Current,2025-06-10 10:11:56,2025-06-10 10:11:57,To Instant Access Savings,-1000.00,0.00,EUR,COMPLETED,1398.35
Transfer,Current,2025-06-10 10:12:13,2025-06-10 10:12:14,To Instant Access Savings,-500.00,0.00,EUR,COMPLETED,898.35
Card Payment,Current,2025-06-09 12:41:00,2025-06-10 10:12:15,OpenAI,-23.00,0.00,EUR,COMPLETED,875.35
Transfer,Current,2025-06-10 10:22:32,2025-06-10 10:22:32,To Instant Access Savings,-1.85,0.00,EUR,COMPLETED,873.50
Card Payment,Current,2025-06-09 15:31:47,2025-06-10 13:19:07,Trakt.tv,-5.29,0.00,EUR,COMPLETED,868.21
Transfer,Current,2025-06-10 19:47:26,2025-06-10 19:47:26,To Instant Access Savings,-4.00,0.00,EUR,COMPLETED,864.21
Card Payment,Current,2025-06-10 10:22:32,2025-06-11 12:42:03,idonate,-50.63,0.00,EUR,COMPLETED,813.58
Card Payment,Current,2025-06-10 19:47:26,2025-06-11 13:54:08,Doyles,-15.20,0.00,EUR,COMPLETED,798.38
Card Payment,Current,2025-06-09 15:20:45,2025-06-11 14:33:06,Amazon,-79.40,0.00,EUR,COMPLETED,718.98
Card Payment,Current,2025-06-09 15:10:51,2025-06-11 14:33:06,Amazon,-35.42,0.00,EUR,COMPLETED,683.56
Card Payment,Current,2025-06-10 09:18:36,2025-06-11 14:33:08,Amazon,-103.39,0.00,EUR,COMPLETED,580.17
Card Payment,Current,2025-06-09 21:14:19,2025-06-11 15:05:13,Amazon,-17.57,0.00,EUR,COMPLETED,562.60
Transfer,Current,2025-06-11 22:04:51,2025-06-11 22:04:51,Transfer to ADAM JOHN FREE,-50.00,0.00,EUR,COMPLETED,512.60
Transfer,Current,2025-06-13 08:42:42,2025-06-13 08:42:42,To Instant Access Savings,-0.80,0.00,EUR,COMPLETED,511.80
Transfer,Current,2025-06-13 09:00:28,2025-06-13 09:00:28,To Instant Access Savings,-2.90,0.00,EUR,COMPLETED,508.90
Transfer,Current,2025-06-13 21:16:23,2025-06-13 21:16:23,Transfer from MARA DI RAIMONDO,29.00,0.00,EUR,COMPLETED,537.90
Transfer,Current,2025-06-13 21:17:38,2025-06-13 21:17:39,Transfer to PATRICK JOHN BYRNE,-80.00,0.00,EUR,COMPLETED,457.90
Transfer,Current,2025-06-13 21:19:11,2025-06-13 21:19:12,To Instant Access Savings,-5.00,0.00,EUR,COMPLETED,452.90
Transfer,Current,2025-06-13 21:34:19,2025-06-13 21:34:19,To Instant Access Savings,-4.50,0.00,EUR,COMPLETED,448.40
Transfer,Current,2025-06-13 22:35:31,2025-06-13 22:35:32,To Instant Access Savings,-2.00,0.00,EUR,COMPLETED,446.40
Transfer,Current,2025-06-13 23:22:45,2025-06-13 23:22:45,To Instant Access Savings,-4.50,0.00,EUR,COMPLETED,441.90
Transfer,Current,2025-06-14 00:43:04,2025-06-14 00:43:04,To Instant Access Savings,-3.00,0.00,EUR,COMPLETED,438.90
Card Refund,Current,2025-06-13 18:06:04,2025-06-14 10:30:32,Fressnapf,37.98,0.00,EUR,COMPLETED,476.88
Card Payment,Current,2025-06-13 21:19:11,2025-06-14 10:45:51,Centra,-10.00,0.00,EUR,COMPLETED,466.88
Card Payment,Current,2025-06-13 09:00:28,2025-06-14 13:07:40,SuperValu,-32.42,0.00,EUR,COMPLETED,434.46
Card Payment,Current,2025-06-13 08:42:41,2025-06-14 13:24:26,Applegreen,-53.84,0.00,EUR,COMPLETED,380.62
Transfer,Current,2025-06-14 15:03:44,2025-06-14 15:03:44,To Instant Access Savings,-0.35,0.00,EUR,COMPLETED,380.27
Transfer,Current,2025-06-14 18:59:13,2025-06-14 18:59:13,To Instant Access Savings,-2.70,0.00,EUR,COMPLETED,377.57
Card Payment,Current,2025-06-14 00:43:04,2025-06-15 11:14:14,Asif Chaudry Taxi,-28.40,0.00,EUR,COMPLETED,349.17
Card Payment,Current,2025-06-13 21:34:18,2025-06-15 11:52:54,Mulligan and Haines,-11.10,0.00,EUR,COMPLETED,338.07
Card Payment,Current,2025-06-13 22:35:31,2025-06-15 11:53:14,Mulligan And Haines 06,-7.60,0.00,EUR,COMPLETED,330.47
Card Payment,Current,2025-06-13 23:22:45,2025-06-15 11:53:30,Mulligan and Haines,-11.10,0.00,EUR,COMPLETED,319.37
Transfer,Current,2025-06-15 11:55:36,2025-06-15 11:55:36,To Instant Access Savings,-0.25,0.00,EUR,COMPLETED,319.12
Transfer,Current,2025-06-15 12:09:00,2025-06-15 12:09:00,To Instant Access Savings,-0.80,0.00,EUR,COMPLETED,318.32
Transfer,Current,2025-06-15 12:19:23,2025-06-15 12:19:24,To Instant Access Savings,-5.00,0.00,EUR,COMPLETED,313.32
Card Payment,Current,2025-06-14 15:03:43,2025-06-15 12:39:28,Lidl,-19.93,0.00,EUR,COMPLETED,293.39
Card Payment,Current,2025-06-14 18:59:13,2025-06-15 14:08:47,Amazon,-31.46,0.00,EUR,COMPLETED,261.93
Transfer,Current,2025-06-16 09:11:07,2025-06-16 09:11:08,To Instant Access Savings,-2.75,0.00,EUR,COMPLETED,259.18
Transfer,Current,2025-06-16 09:11:52,2025-06-16 09:11:52,To Instant Access Savings,-5.00,0.00,EUR,COMPLETED,254.18
Transfer,Current,2025-06-16 09:51:45,2025-06-16 09:51:45,To Instant Access Savings,-0.75,0.00,EUR,COMPLETED,253.43
Card Payment,Current,2025-06-15 12:09:00,2025-06-16 10:55:20,SuperValu,-27.84,0.00,EUR,COMPLETED,225.59
Transfer,Current,2025-06-16 11:34:49,2025-06-16 11:34:49,To Instant Access Savings,-4.50,0.00,EUR,COMPLETED,221.09
Card Payment,Current,2025-06-15 12:19:23,2025-06-16 13:01:00,Killiney Home Care Cent,-20.00,0.00,EUR,COMPLETED,201.09
Card Payment,Current,2025-06-15 11:55:36,2025-06-16 13:32:33,Petstop,-39.95,0.00,EUR,COMPLETED,161.14
Transfer,Current,2025-06-16 15:04:54,2025-06-16 15:04:54,Transfer to MARA DI RAIMONDO,-61.37,0.00,EUR,COMPLETED,99.77
Transfer,Current,2025-06-16 15:05:02,2025-06-16 15:05:02,Transfer to MARA DI RAIMONDO,-61.37,0.00,EUR,COMPLETED,38.40
Transfer,Current,2025-06-16 15:05:21,2025-06-16 15:05:22,From Instant Access Savings,200.00,0.00,EUR,COMPLETED,238.40
Transfer,Current,2025-06-16 19:26:34,2025-06-16 19:26:35,To Instant Access Savings,-4.05,0.00,EUR,COMPLETED,234.35
Card Payment,Current,2025-06-16 09:11:52,2025-06-17 09:54:21,Xl,-9.00,0.00,EUR,COMPLETED,225.35
Card Payment,Current,2025-06-16 11:34:49,2025-06-17 10:41:51,WHSmith,-4.10,0.00,EUR,COMPLETED,221.25
Card Payment,Current,2025-06-16 19:26:34,2025-06-17 14:14:47,Flower Factory,-63.19,0.00,EUR,COMPLETED,158.06
Card Payment,Current,2025-06-16 09:11:07,2025-06-17 14:19:15,The Rise Pharmacy,-6.45,0.00,EUR,COMPLETED,151.61
Card Payment,Current,2025-06-16 09:51:44,2025-06-17 14:57:30,Amazon,-14.85,0.00,EUR,COMPLETED,136.76
Transfer,Current,2025-06-18 20:34:11,2025-06-18 20:34:11,To Instant Access Savings,-3.95,0.00,EUR,COMPLETED,132.81
Transfer,Current,2025-06-18 20:47:24,2025-06-18 20:47:24,To Instant Access Savings,-1.60,0.00,EUR,COMPLETED,131.21
Transfer,Current,2025-06-19 11:05:53,2025-06-19 11:05:53,To Instant Access Savings,-3.00,0.00,EUR,COMPLETED,128.21
Transfer,Current,2025-06-19 12:16:11,2025-06-19 12:16:11,To Instant Access Savings,-5.00,0.00,EUR,COMPLETED,123.21
Transfer,Current,2025-06-19 13:14:57,2025-06-19 13:14:58,To Instant Access Savings,-2.60,0.00,EUR,COMPLETED,120.61
Card Payment,Current,2025-06-18 20:34:11,2025-06-19 13:21:38,Deliveroo,-22.21,0.00,EUR,COMPLETED,98.40
Transfer,Current,2025-06-19 19:15:12,2025-06-19 19:15:12,From Instant Access Savings,100.00,0.00,EUR,COMPLETED,198.40
Transfer,Current,2025-06-19 19:16:22,2025-06-19 19:16:22,To Instant Access Savings,-5.00,0.00,EUR,COMPLETED,193.40
Transfer,Current,2025-06-19 19:34:26,2025-06-19 19:34:27,To Instant Access Savings,-4.35,0.00,EUR,COMPLETED,189.05
Card Payment,Current,2025-06-19 19:16:22,2025-06-20 09:55:25,Applegreen,-8.00,0.00,EUR,COMPLETED,181.05
Card Payment,Current,2025-06-19 11:05:53,2025-06-20 10:09:35,Hatch Coffee,-22.40,0.00,EUR,COMPLETED,158.65
Card Payment,Current,2025-06-19 12:16:11,2025-06-20 10:16:42,Payzone,-10.00,0.00,EUR,COMPLETED,148.65
Card Payment,Current,2025-06-19 19:34:26,2025-06-20 10:30:54,SuperValu,-31.13,0.00,EUR,COMPLETED,117.52
Card Payment,Current,2025-06-19 13:14:57,2025-06-20 13:53:08,Cinnamon,-18.48,0.00,EUR,COMPLETED,99.04
Card Payment,Current,2025-06-18 20:47:24,2025-06-20 15:30:06,Amazon,-33.68,0.00,EUR,COMPLETED,65.36
Transfer,Current,2025-06-20 16:43:07,2025-06-20 16:43:07,To Instant Access Savings,-5.00,0.00,EUR,COMPLETED,60.36
Transfer,Current,2025-06-21 12:14:53,2025-06-21 12:14:53,To Instant Access Savings,-5.00,0.00,EUR,COMPLETED,55.36
Card Payment,Current,2025-06-20 16:43:06,2025-06-21 12:51:54,Parking Payments,-6.00,0.00,EUR,COMPLETED,49.36
Transfer,Current,2025-06-21 12:57:05,2025-06-21 12:57:05,To Instant Access Savings,-2.00,0.00,EUR,COMPLETED,47.36
Transfer,Current,2025-06-21 16:13:16,2025-06-21 16:13:16,Transfer to BRYAN DALTON,-15.00,0.00,EUR,COMPLETED,32.36
Transfer,Current,2025-06-21 18:59:02,2025-06-21 18:59:02,Transfer from MARA DI RAIMONDO,20.00,0.00,EUR,COMPLETED,52.36
Transfer,Current,2025-06-21 20:09:14,2025-06-21 20:09:14,Transfer from MARA DI RAIMONDO,3.90,0.00,EUR,COMPLETED,56.26
Transfer,Current,2025-06-22 09:43:52,2025-06-22 09:43:52,To Instant Access Savings,-5.00,0.00,EUR,COMPLETED,51.26
Card Payment,Current,2025-06-21 12:57:04,2025-06-22 09:57:21,Roots,-8.60,0.00,EUR,COMPLETED,42.66
Card Payment,Current,2025-06-21 12:14:52,2025-06-22 10:09:13,Dublin Waste to Energy Facility,-15.00,0.00,EUR,COMPLETED,27.66
Transfer,Current,2025-06-22 17:35:29,2025-06-22 17:35:30,Transfer from MARA DI RAIMONDO,20.00,0.00,EUR,COMPLETED,47.66
Transfer,Current,2025-06-23 08:53:19,2025-06-23 08:53:19,To Instant Access Savings,-2.75,0.00,EUR,COMPLETED,44.91
Transfer,Current,2025-06-23 10:05:13,2025-06-23 10:05:13,Transfer to Edward Muldrew,-5.00,0.00,EUR,COMPLETED,39.91
Card Payment,Current,2025-06-22 09:43:52,2025-06-23 13:44:42,Applegreen,-10.00,0.00,EUR,COMPLETED,29.91
Transfer,Current,2025-06-23 17:29:29,2025-06-23 17:29:29,To Instant Access Savings,-5.00,0.00,EUR,COMPLETED,24.91
Card Refund,Current,2025-06-24 01:00:00,2025-06-24 10:42:15,Adidas,300.00,0.00,EUR,COMPLETED,324.91
Card Payment,Current,2025-06-23 17:29:29,2025-06-24 11:48:13,Reynolds Logistics,-10.00,0.00,EUR,COMPLETED,314.91
Transfer,Current,2025-06-24 11:53:57,2025-06-24 11:53:57,Credit card repayment,-300.00,0.00,EUR,COMPLETED,14.91
Card Payment,Current,2025-06-23 08:53:19,2025-06-24 12:10:02,OXMANTOWN,-4.45,0.00,EUR,COMPLETED,10.46
Transfer,Current,2025-06-24 19:28:13,2025-06-24 19:28:13,Transfer from MARA DI RAIMONDO,550.00,0.00,EUR,COMPLETED,560.46
Transfer,Current,2025-06-25 03:00:52,2025-06-25 03:00:52,To Instant Access Savings,-5.00,0.00,EUR,COMPLETED,555.46
Transfer,Current,2025-06-25 06:24:20,2025-06-25 06:24:21,Transfer to MARA DI RAIMONDO,-250.00,0.00,EUR,COMPLETED,305.46
Topup,Current,2025-06-25 06:36:39,2025-06-25 06:36:40,Payment from WORKDAY LIMITED,2362.41,0.00,EUR,COMPLETED,2667.87
Transfer,Current,2025-06-25 08:01:53,2025-06-25 08:01:53,Credit card repayment,-122.36,0.00,EUR,COMPLETED,2545.51
Transfer,Current,2025-06-25 08:40:38,2025-06-25 08:40:38,To Instant Access Savings,-0.25,0.00,EUR,COMPLETED,2545.26
Transfer,Current,2025-06-25 09:46:27,2025-06-25 09:46:27,To pocket EUR Subscriptions from EUR,-250.00,0.00,EUR,COMPLETED,2295.26
Transfer,Current,2025-06-25 09:46:28,2025-06-25 09:46:28,To pocket EUR Subscriptions from EUR,-780.42,0.00,EUR,COMPLETED,1514.84
Transfer,Current,2025-06-25 11:55:23,2025-06-25 11:55:23,To Instant Access Savings,-3.75,0.00,EUR,COMPLETED,1511.09
Transfer,Current,2025-06-25 12:17:35,2025-06-25 12:17:39,Transfer to MARA DI RAIMONDO,-800.00,0.00,EUR,COMPLETED,711.09
Card Payment,Current,2025-06-25 03:00:52,2025-06-25 13:49:34,DSPCA,-15.00,0.00,EUR,COMPLETED,696.09
Transfer,Current,2025-06-25 18:04:29,2025-06-25 18:04:29,To Instant Access Savings,-3.75,0.00,EUR,COMPLETED,692.34
Card Payment,Current,2025-06-25 11:55:22,2025-06-26 14:16:30,Boojum,-14.25,0.00,EUR,COMPLETED,678.09
Card Payment,Current,2025-06-25 08:40:37,2025-06-26 14:23:14,Starbucks,-6.95,0.00,EUR,COMPLETED,671.14
Card Payment,Current,2025-06-25 18:04:28,2025-06-26 14:27:02,SPAR Food & Fuel,-4.25,0.00,EUR,COMPLETED,666.89
Transfer,Current,2025-06-26 18:43:19,2025-06-26 18:43:19,To Instant Access Savings,-0.35,0.00,EUR,COMPLETED,666.54
Transfer,Current,2025-06-26 20:19:02,2025-06-26 20:19:02,To Instant Access Savings,-5.00,0.00,EUR,COMPLETED,661.54
Transfer,Current,2025-06-26 21:29:57,2025-06-26 21:29:57,To Instant Access Savings,-1.55,0.00,EUR,COMPLETED,659.99
Transfer,Current,2025-06-27 08:48:56,2025-06-27 08:48:56,To Instant Access Savings,-1.00,0.00,EUR,COMPLETED,658.99
Card Payment,Current,2025-06-26 18:43:19,2025-06-27 09:16:13,YUNO,-76.93,0.00,EUR,COMPLETED,582.06
Transfer,Current,2025-06-27 09:20:11,2025-06-27 09:20:11,To Instant Access Savings,-1.80,0.00,EUR,COMPLETED,580.26
Transfer,Current,2025-06-27 17:15:49,2025-06-27 17:15:55,Transfer from MARA DI RAIMONDO,25.00,0.00,EUR,COMPLETED,605.26
Transfer,Current,2025-06-27 17:16:43,2025-06-27 17:16:43,Transfer to MARA DI RAIMONDO,-67.50,0.00,EUR,COMPLETED,537.76
Transfer,Current,2025-06-27 18:57:25,2025-06-27 18:57:25,To Instant Access Savings,-2.65,0.00,EUR,COMPLETED,535.11
Transfer,Current,2025-06-27 19:40:37,2025-06-27 19:40:37,To Instant Access Savings,-2.40,0.00,EUR,COMPLETED,532.71
Transfer,Current,2025-06-28 00:35:41,2025-06-28 00:35:41,To Instant Access Savings,-0.05,0.00,EUR,COMPLETED,532.66
Card Payment,Current,2025-06-27 18:57:25,2025-06-28 10:07:52,Camile Thai,-23.47,0.00,EUR,COMPLETED,509.19
Transfer,Current,2025-06-28 10:25:03,2025-06-28 10:25:03,To Instant Access Savings,-4.50,0.00,EUR,COMPLETED,504.69
Card Payment,Current,2025-06-28 00:35:41,2025-06-28 13:38:43,Apple,-9.99,0.00,EUR,COMPLETED,494.70
Card Payment,Current,2025-06-26 20:19:01,2025-06-28 13:41:09,The Merry Cobbler,-70.00,0.00,EUR,COMPLETED,424.70
Transfer,Current,2025-06-28 13:53:32,2025-06-28 13:53:32,To Instant Access Savings,-3.60,0.00,EUR,COMPLETED,421.10
Card Payment,Current,2025-06-27 08:48:55,2025-06-28 14:03:08,Mint,-12.80,0.00,EUR,COMPLETED,408.30
Card Payment,Current,2025-06-27 09:20:11,2025-06-28 14:12:04,SuperValu,-30.64,0.00,EUR,COMPLETED,377.66
Card Payment,Current,2025-06-26 21:29:57,2025-06-28 14:22:30,Steam,-17.69,0.00,EUR,COMPLETED,359.97
Card Payment,Current,2025-06-27 19:40:36,2025-06-28 14:30:12,YUNO,-66.52,0.00,EUR,COMPLETED,293.45
Card Payment,Current,2025-06-28 10:25:02,2025-06-29 09:06:47,Applegreen,-13.10,0.00,EUR,COMPLETED,280.35
Card Payment,Current,2025-06-28 13:53:31,2025-06-29 12:04:21,Tst Parlour Restaurant,-32.28,0.00,EUR,COMPLETED,248.07
Transfer,Current,2025-06-29 12:55:19,2025-06-29 12:55:19,To Instant Access Savings,-2.80,0.00,EUR,COMPLETED,245.27
Transfer,Current,2025-06-29 15:35:09,2025-06-29 15:35:09,Transfer from ANASTASSIA TUMANINA,80.00,0.00,EUR,COMPLETED,325.27
Transfer,Current,2025-06-29 16:53:19,2025-06-29 16:53:19,To Instant Access Savings,-5.00,0.00,EUR,COMPLETED,320.27
Transfer,Current,2025-06-29 18:26:00,2025-06-29 18:26:03,Transfer from MARA DI RAIMONDO,25.00,0.00,EUR,COMPLETED,345.27
Transfer,Current,2025-06-29 18:52:43,2025-06-29 18:52:44,Transfer to MARA DI RAIMONDO,-20.98,0.00,EUR,COMPLETED,324.29
Transfer,Current,2025-06-30 12:06:30,2025-06-30 12:06:30,From Instant Access Savings,1590.00,0.00,EUR,COMPLETED,1914.29
Transfer,Current,2025-06-30 12:06:36,2025-06-30 12:06:36,Credit card repayment,-1590.29,0.00,EUR,COMPLETED,324.00
Card Payment,Current,2025-06-29 16:53:19,2025-06-30 12:08:09,Dunnes Stores,-39.00,0.00,EUR,COMPLETED,285.00
Card Payment,Current,2025-06-29 12:55:18,2025-06-30 14:28:41,Amazon,-154.44,0.00,EUR,COMPLETED,130.56
Transfer,Current,2025-07-01 01:23:58,2025-07-01 01:23:58,Credit card excess funds transfer,1.64,0.00,EUR,COMPLETED,132.20
Transfer,Current,2025-07-01 13:04:50,2025-07-01 13:04:50,Pocket Withdrawal,380.00,0.00,EUR,COMPLETED,512.20
Transfer,Current,2025-07-01 13:05:03,2025-07-01 13:05:09,Transfer to MARA DI RAIMONDO,-380.00,0.00,EUR,COMPLETED,132.20
Transfer,Current,2025-07-01 18:50:32,2025-07-01 18:50:32,Transfer from TANMAY SANTOSH BANE,250.00,0.00,EUR,COMPLETED,382.20
Transfer,Current,2025-07-02 09:11:51,2025-07-02 09:11:51,Transfer from MARA DI RAIMONDO,37.46,0.00,EUR,COMPLETED,419.66
Card Refund,Current,2025-07-03 01:00:00,2025-07-03 10:25:49,Apple,9.99,0.00,EUR,COMPLETED,429.65
Transfer,Current,2025-07-03 12:43:23,2025-07-03 12:43:23,To Instant Access Savings,-4.30,0.00,EUR,COMPLETED,425.35
Transfer,Current,2025-07-03 17:04:31,2025-07-03 17:04:31,To Instant Access Savings,-5.00,0.00,EUR,COMPLETED,420.35
Transfer,Current,2025-07-03 18:48:00,2025-07-03 18:48:00,To Instant Access Savings,-0.80,0.00,EUR,COMPLETED,419.55
Transfer,Current,2025-07-03 18:48:30,2025-07-03 18:48:31,Transfer from MARA DI RAIMONDO,35.00,0.00,EUR,COMPLETED,454.55
Transfer,Current,2025-07-04 08:18:18,2025-07-04 08:18:18,To Instant Access Savings,-0.50,0.00,EUR,COMPLETED,454.05
Transfer,Current,2025-07-04 08:32:53,2025-07-04 08:32:53,To Instant Access Savings,-1.40,0.00,EUR,COMPLETED,452.65
Card Payment,Current,2025-07-03 12:43:22,2025-07-04 09:35:23,Market Pharmacy Smithfield,-7.14,0.00,EUR,COMPLETED,445.51
Transfer,Current,2025-07-04 10:11:48,2025-07-04 10:11:49,To Instant Access Savings,-0.05,0.00,EUR,COMPLETED,445.46
Transfer,Current,2025-07-04 12:19:03,2025-07-04 12:19:03,To Instant Access Savings,-5.00,0.00,EUR,COMPLETED,440.46
Transfer,Current,2025-07-04 12:47:40,2025-07-04 12:47:40,To Instant Access Savings,-2.25,0.00,EUR,COMPLETED,438.21
Transfer,Current,2025-07-04 14:44:29,2025-07-04 14:44:29,To Instant Access Savings,-5.00,0.00,EUR,COMPLETED,433.21
Card Payment,Current,2025-07-03 18:47:59,2025-07-04 15:00:13,Zakura,-70.84,0.00,EUR,COMPLETED,362.37
Card Payment,Current,2025-07-03 17:04:30,2025-07-04 16:29:23,Transport for Ireland - TFI,-40.00,0.00,EUR,COMPLETED,322.37
Card Payment,Current,2025-07-04 12:19:02,2025-07-05 09:33:16,Payzone,-10.00,0.00,EUR,COMPLETED,312.37
Card Payment,Current,2025-07-04 14:44:28,2025-07-05 11:50:25,Eddie Doyle,-50.00,0.00,EUR,COMPLETED,262.37
Card Refund,Current,2025-07-03 14:11:35,2025-07-05 12:11:32,Amazon,109.99,0.00,EUR,COMPLETED,372.36
Card Payment,Current,2025-07-04 08:32:52,2025-07-05 12:44:07,SuperValu,-33.72,0.00,EUR,COMPLETED,338.64
Card Payment,Current,2025-07-04 08:18:18,2025-07-05 13:07:16,Applegreen,-3.90,0.00,EUR,COMPLETED,334.74
Card Payment,Current,2025-07-04 12:47:39,2025-07-05 13:26:55,Hatch Coffee,-48.55,0.00,EUR,COMPLETED,286.19
Card Payment,Current,2025-07-04 10:11:48,2025-07-05 15:28:29,YouTube,-13.99,0.00,EUR,COMPLETED,272.20
Transfer,Current,2025-07-05 16:22:12,2025-07-05 16:22:12,To Instant Access Savings,-0.05,0.00,EUR,COMPLETED,272.15
Transfer,Current,2025-07-05 17:12:31,2025-07-05 17:12:31,To Instant Access Savings,-4.85,0.00,EUR,COMPLETED,267.30
Transfer,Current,2025-07-05 21:18:12,2025-07-05 21:18:12,To Instant Access Savings,-0.05,0.00,EUR,COMPLETED,267.25
Transfer,Current,2025-07-06 09:29:20,2025-07-06 09:29:20,To Instant Access Savings,-2.00,0.00,EUR,COMPLETED,265.25
Transfer,Current,2025-07-06 10:55:18,2025-07-06 10:55:18,To Instant Access Savings,-0.05,0.00,EUR,COMPLETED,265.20
Card Payment,Current,2025-07-05 21:18:12,2025-07-06 10:55:33,Apple,-49.99,0.00,EUR,COMPLETED,215.21
Transfer,Current,2025-07-06 11:31:02,2025-07-06 11:31:02,To Instant Access Savings,-3.75,0.00,EUR,COMPLETED,211.46
Card Payment,Current,2025-07-05 17:12:30,2025-07-06 11:33:50,Athletics Ireland,-54.03,0.00,EUR,COMPLETED,157.43
Card Payment,Current,2025-07-06 09:29:20,2025-07-07 10:10:54,Happy Out,-46.60,0.00,EUR,COMPLETED,110.83
Transfer,Current,2025-07-07 10:30:06,2025-07-07 10:30:06,Transfer from MARA DI RAIMONDO,19.13,0.00,EUR,COMPLETED,129.96
Card Payment,Current,2025-07-06 11:31:01,2025-07-07 10:55:02,Lidl,-38.25,0.00,EUR,COMPLETED,91.71
Transfer,Current,2025-07-07 14:54:02,2025-07-07 14:54:02,To Instant Access Savings,-5.00,0.00,EUR,COMPLETED,86.71
Card Payment,Current,2025-07-05 16:22:11,2025-07-07 15:18:41,Clark’s Newsagent,-8.99,0.00,EUR,COMPLETED,77.72
Card Payment,Current,2025-07-06 10:55:17,2025-07-07 16:33:04,The Washington Post,-0.99,0.00,EUR,COMPLETED,76.73
Transfer,Current,2025-07-07 18:25:33,2025-07-07 18:25:33,To Instant Access Savings,-1.75,0.00,EUR,COMPLETED,74.98
Transfer,Current,2025-07-08 08:50:18,2025-07-08 08:50:18,To Instant Access Savings,-2.75,0.00,EUR,COMPLETED,72.23
Card Refund,Current,2025-07-08 01:00:00,2025-07-08 10:50:57,Apple,49.99,0.00,EUR,COMPLETED,122.22
Card Payment,Current,2025-07-07 14:54:01,2025-07-08 11:18:42,Xl,-9.00,0.00,EUR,COMPLETED,113.22
Card Payment,Current,2025-07-07 18:25:33,2025-07-08 11:57:35,Lidl,-26.65,0.00,EUR,COMPLETED,86.57
Exchange,Current,2025-07-08 15:23:43,2025-07-08 15:23:43,Exchanged to EUR,7414.13,0.00,EUR,COMPLETED,7500.70
Transfer,Current,2025-07-08 15:23:55,2025-07-08 15:23:55,To EUR,-526.20,0.00,EUR,COMPLETED,6974.50
Transfer,Current,2025-07-09 08:21:57,2025-07-09 08:21:57,To Instant Access Savings,-3.45,0.00,EUR,COMPLETED,6971.05
Card Payment,Current,2025-07-08 08:50:17,2025-07-09 11:29:01,OXMANTOWN,-4.45,0.00,EUR,COMPLETED,6966.60
Transfer,Current,2025-07-09 12:49:27,2025-07-09 12:49:27,To Instant Access Savings,-3.75,0.00,EUR,COMPLETED,6962.85
Transfer,Current,2025-07-09 13:41:25,2025-07-09 13:41:26,To Instant Access Savings,-5.00,0.00,EUR,COMPLETED,6957.85
Transfer,Current,2025-07-09 16:56:15,2025-07-10 01:55:44,To Trading 212 UK Limited,-5500.00,0.00,EUR,COMPLETED,1457.85
Transfer,Current,2025-07-10 08:37:34,2025-07-10 08:37:35,To Instant Access Savings,-4.00,0.00,EUR,COMPLETED,1453.85
Card Payment,Current,2025-07-09 13:41:25,2025-07-10 10:38:04,OpenAI,-23.00,0.00,EUR,COMPLETED,1430.85
Card Payment,Current,2025-07-09 12:49:27,2025-07-10 10:45:54,Boojum,-14.25,0.00,EUR,COMPLETED,1416.60
Transfer,Current,2025-07-10 12:32:12,2025-07-10 12:32:12,To Instant Access Savings,-5.00,0.00,EUR,COMPLETED,1411.60
Transfer,Current,2025-07-10 12:38:41,2025-07-10 12:38:41,To Instant Access Savings,-1.25,0.00,EUR,COMPLETED,1410.35
Card Payment,Current,2025-07-09 08:21:57,2025-07-10 13:29:10,Amazon,-62.31,0.00,EUR,COMPLETED,1348.04
Transfer,Current,2025-07-10 18:43:15,2025-07-10 18:43:15,To Instant Access Savings,-0.05,0.00,EUR,COMPLETED,1347.99
Transfer,Current,2025-07-11 09:13:26,2025-07-11 09:13:26,To Instant Access Savings,-4.10,0.00,EUR,COMPLETED,1343.89
Card Payment,Current,2025-07-10 12:38:41,2025-07-11 11:38:41,Fresh The Good Food Market,-6.75,0.00,EUR,COMPLETED,1337.14
Card Payment,Current,2025-07-10 18:43:15,2025-07-11 11:57:54,GoMo,-9.99,0.00,EUR,COMPLETED,1327.15
Card Payment,Current,2025-07-10 12:32:11,2025-07-11 12:06:38,Daybreak,-8.00,0.00,EUR,COMPLETED,1319.15
Card Payment,Current,2025-07-10 08:37:34,2025-07-11 12:43:01,McDonald's,-8.20,0.00,EUR,COMPLETED,1310.95
Transfer,Current,2025-07-11 20:33:10,2025-07-11 20:33:10,To Instant Access Savings,-5.00,0.00,EUR,COMPLETED,1305.95
Transfer,Current,2025-07-11 21:28:08,2025-07-11 21:28:08,Transfer from MARA DI RAIMONDO,19.50,0.00,EUR,COMPLETED,1325.45
Card Payment,Current,2025-07-11 20:33:09,2025-07-12 11:39:58,Sushida,-65.00,0.00,EUR,COMPLETED,1260.45
Transfer,Current,2025-07-12 11:46:29,2025-07-12 11:46:29,To Instant Access Savings,-5.00,0.00,EUR,COMPLETED,1255.45
Transfer,Current,2025-07-12 11:59:27,2025-07-12 11:59:27,To Instant Access Savings,-5.00,0.00,EUR,COMPLETED,1250.45
Transfer,Current,2025-07-12 12:12:51,2025-07-12 12:12:52,To Instant Access Savings,-0.50,0.00,EUR,COMPLETED,1249.95
Transfer,Current,2025-07-12 12:28:53,2025-07-12 12:28:53,To Instant Access Savings,-0.50,0.00,EUR,COMPLETED,1249.45
Transfer,Current,2025-07-12 12:45:25,2025-07-12 12:45:26,To Instant Access Savings,-0.75,0.00,EUR,COMPLETED,1248.70
Card Payment,Current,2025-07-11 09:12:55,2025-07-12 13:19:18,SuperValu,-30.18,0.00,EUR,COMPLETED,1218.52
Transfer,Current,2025-07-12 13:28:11,2025-07-12 13:28:11,To Instant Access Savings,-5.00,0.00,EUR,COMPLETED,1213.52
Transfer,Current,2025-07-12 13:35:33,2025-07-12 13:35:33,To Instant Access Savings,-3.55,0.00,EUR,COMPLETED,1209.97
Transfer,Current,2025-07-12 13:42:55,2025-07-12 13:42:55,To Instant Access Savings,-5.00,0.00,EUR,COMPLETED,1204.97
Transfer,Current,2025-07-12 13:44:03,2025-07-12 13:44:03,To Instant Access Savings,-5.00,0.00,EUR,COMPLETED,1199.97
Transfer,Current,2025-07-12 19:33:54,2025-07-12 19:33:54,To Instant Access Savings,-3.00,0.00,EUR,COMPLETED,1196.97
Transfer,Current,2025-07-13 09:08:12,2025-07-13 09:08:13,To Instant Access Savings,-5.00,0.00,EUR,COMPLETED,1191.97
Card Payment,Current,2025-07-12 11:59:26,2025-07-13 09:51:51,Office Shoes,-165.00,0.00,EUR,COMPLETED,1026.97
Card Payment,Current,2025-07-12 13:35:33,2025-07-13 09:53:30,Boots,-21.29,0.00,EUR,COMPLETED,1005.68
Transfer,Current,2025-07-13 10:10:46,2025-07-13 10:10:46,To Instant Access Savings,-0.25,0.00,EUR,COMPLETED,1005.43
Card Payment,Current,2025-07-12 12:28:53,2025-07-13 10:14:29,Butlers Chocolates,-4.90,0.00,EUR,COMPLETED,1000.53
Card Payment,Current,2025-07-12 19:33:53,2025-07-13 10:30:24,Gleesons,-3.40,0.00,EUR,COMPLETED,997.13
Card Payment,Current,2025-07-12 12:45:25,2025-07-13 10:30:28,ZARA,-82.85,0.00,EUR,COMPLETED,914.28
Card Payment,Current,2025-07-12 13:28:10,2025-07-13 10:32:34,JD Sports,-73.00,0.00,EUR,COMPLETED,841.28
Transfer,Current,2025-07-13 10:37:20,2025-07-13 10:37:21,To Instant Access Savings,-4.50,0.00,EUR,COMPLETED,836.78
Transfer,Current,2025-07-13 10:42:09,2025-07-13 10:42:09,To Instant Access Savings,-3.50,0.00,EUR,COMPLETED,833.28
Card Payment,Current,2025-07-12 13:44:03,2025-07-13 11:15:16,Circle K Gas Station,-8.00,0.00,EUR,COMPLETED,825.28
Card Payment,Current,2025-07-12 12:12:51,2025-07-13 11:34:58,Massimo Dutti,-99.90,0.00,EUR,COMPLETED,725.38
Card Payment,Current,2025-07-12 11:46:29,2025-07-13 13:50:23,Marks & Spencer,-87.00,0.00,EUR,COMPLETED,638.38
Transfer,Current,2025-07-13 14:58:33,2025-07-13 14:58:33,To Instant Access Savings,-0.55,0.00,EUR,COMPLETED,637.83
Transfer,Current,2025-07-13 17:42:21,2025-07-13 17:42:21,To Instant Access Savings,-1.25,0.00,EUR,COMPLETED,636.58
Card Payment,Current,2025-07-13 09:08:12,2025-07-14 08:56:26,Uber,-58.00,0.00,EUR,COMPLETED,578.58
Card Payment,Current,2025-07-13 17:42:21,2025-07-14 11:20:00,Pestana Hotels & Resorts,-46.75,0.00,EUR,COMPLETED,531.83
Card Payment,Current,2025-07-12 13:42:55,2025-07-14 11:41:05,Easytrip,-10.00,0.00,EUR,COMPLETED,521.83
Card Payment,Current,2025-07-13 10:42:08,2025-07-14 12:12:19,WHSmith,-4.30,0.00,EUR,COMPLETED,517.53
Card Payment,Current,2025-07-13 10:10:46,2025-07-14 12:22:31,The Slaney,-11.95,0.00,EUR,COMPLETED,505.58
Card Payment,Current,2025-07-13 14:58:32,2025-07-14 12:32:34,Bolt,-46.96,0.00,EUR,COMPLETED,458.62
Card Payment,Current,2025-07-13 10:37:18,2025-07-14 12:44:09,Butlers Chocolates,-5.10,0.00,EUR,COMPLETED,453.52
Transfer,Current,2025-07-14 14:12:36,2025-07-14 14:12:36,To Instant Access Savings,-4.50,0.00,EUR,COMPLETED,449.02
Transfer,Current,2025-07-14 20:06:02,2025-07-14 20:06:03,To Instant Access Savings,-0.05,0.00,EUR,COMPLETED,448.97
Transfer,Current,2025-07-14 21:01:43,2025-07-14 21:01:44,To Instant Access Savings,-3.35,0.00,EUR,COMPLETED,445.62
Card Payment,Current,2025-07-14 14:12:35,2025-07-15 09:22:13,Pestana Hotels & Resorts,-12.10,0.00,EUR,COMPLETED,433.52
Card Payment,Current,2025-07-14 21:01:42,2025-07-15 09:39:56,Bolt,-5.33,0.00,EUR,COMPLETED,428.19
Transfer,Current,2025-07-15 12:29:46,2025-07-15 12:29:46,To Instant Access Savings,-2.10,0.00,EUR,COMPLETED,426.09
Transfer,Current,2025-07-15 13:43:56,2025-07-15 13:43:57,Transfer from PATRICIA QUISH,22.00,0.00,EUR,COMPLETED,448.09
Card Refund,Current,2025-07-14 13:00:42,2025-07-16 09:13:02,Amazon,59.98,0.00,EUR,COMPLETED,508.07
Card Payment,Current,2025-07-14 20:06:02,2025-07-16 09:41:38,Forca Portugal Alv,-69.99,0.00,EUR,COMPLETED,438.08
Card Payment,Current,2025-07-15 12:29:46,2025-07-16 12:28:33,Uber Eats,-22.58,0.00,EUR,COMPLETED,415.50
Transfer,Current,2025-07-16 13:12:02,2025-07-16 13:12:03,Transfer to MARA DI RAIMONDO,-22.50,0.00,EUR,COMPLETED,393.00
Transfer,Current,2025-07-16 14:38:45,2025-07-16 14:38:45,To Instant Access Savings,-2.50,0.00,EUR,COMPLETED,390.50
Transfer,Current,2025-07-16 14:42:18,2025-07-16 14:42:19,Transfer from DAVID KEVIN SMYTH,28.00,0.00,EUR,COMPLETED,418.50
Transfer,Current,2025-07-16 14:46:24,2025-07-16 14:46:24,Transfer from PATRICIA QUISH,30.00,0.00,EUR,COMPLETED,448.50
Transfer,Current,2025-07-16 16:43:09,2025-07-16 16:43:10,To Instant Access Savings,-0.75,0.00,EUR,COMPLETED,447.75
Transfer,Current,2025-07-16 18:24:55,2025-07-16 18:24:55,To Instant Access Savings,-0.05,0.00,EUR,COMPLETED,447.70
Transfer,Current,2025-07-16 20:16:31,2025-07-16 20:16:31,To Instant Access Savings,-4.50,0.00,EUR,COMPLETED,443.20
Transfer,Current,2025-07-16 20:19:44,2025-07-16 20:19:44,To Instant Access Savings,-0.50,0.00,EUR,COMPLETED,442.70
Transfer,Current,2025-07-16 21:47:53,2025-07-16 21:47:53,To Instant Access Savings,-4.10,0.00,EUR,COMPLETED,438.60
Transfer,Current,2025-07-16 22:40:48,2025-07-16 22:40:49,Transfer from MARA DI RAIMONDO,8.00,0.00,EUR,COMPLETED,446.60
Card Payment,Current,2025-07-16 14:38:45,2025-07-17 08:43:24,Pestana Hotels & Resorts,-85.50,0.00,EUR,COMPLETED,361.10
Card Payment,Current,2025-07-16 16:43:09,2025-07-17 08:43:30,Pestana Hotels & Resorts,-14.85,0.00,EUR,COMPLETED,346.25
Card Payment,Current,2025-07-16 18:24:54,2025-07-17 09:16:44,Uber,-7.99,0.00,EUR,COMPLETED,338.26
Card Payment,Current,2025-07-16 21:47:53,2025-07-17 09:31:29,Uber,-4.18,0.00,EUR,COMPLETED,334.08
Transfer,Current,2025-07-17 11:12:19,2025-07-17 11:12:19,Transfer to PATRICIA QUISH,-29.00,0.00,EUR,COMPLETED,305.08
Transfer,Current,2025-07-17 19:09:25,2025-07-17 19:09:26,Transfer to PATRICIA QUISH,-20.00,0.00,EUR,COMPLETED,285.08
Transfer,Current,2025-07-17 19:10:18,2025-07-17 19:10:19,Transfer to DAVID KEVIN SMYTH,-40.00,0.00,EUR,COMPLETED,245.08
Card Payment,Current,2025-07-16 20:19:43,2025-07-18 09:16:57,Dewdrop,-16.90,0.00,EUR,COMPLETED,228.18
Card Payment,Current,2025-07-16 20:16:30,2025-07-18 09:17:00,Pharma Mais,-8.10,0.00,EUR,COMPLETED,220.08
Transfer,Current,2025-07-18 13:28:21,2025-07-18 13:28:22,To Instant Access Savings,-4.75,0.00,EUR,COMPLETED,215.33
Transfer,Current,2025-07-18 15:01:39,2025-07-18 15:01:39,To Instant Access Savings,-1.50,0.00,EUR,COMPLETED,213.83
Transfer,Current,2025-07-18 15:04:23,2025-07-18 15:04:24,Transfer from MARA DI RAIMONDO,8.10,0.00,EUR,COMPLETED,221.93
Transfer,Current,2025-07-18 15:20:39,2025-07-18 15:20:39,To Instant Access Savings,-1.00,0.00,EUR,COMPLETED,220.93
Transfer,Current,2025-07-18 16:07:15,2025-07-18 16:07:15,To Instant Access Savings,-1.50,0.00,EUR,COMPLETED,219.43
Transfer,Current,2025-07-18 18:02:42,2025-07-18 18:02:42,To Instant Access Savings,-2.10,0.00,EUR,COMPLETED,217.33
Transfer,Current,2025-07-18 20:09:31,2025-07-18 20:09:31,Transfer from MARA DI RAIMONDO,22.80,0.00,EUR,COMPLETED,240.13
Transfer,Current,2025-07-18 20:09:58,2025-07-18 20:09:58,Transfer to DAVID KEVIN SMYTH,-80.00,0.00,EUR,COMPLETED,160.13
Transfer,Current,2025-07-18 20:24:13,2025-07-18 20:24:13,To Instant Access Savings,-2.50,0.00,EUR,COMPLETED,157.63
Transfer,Current,2025-07-18 20:30:42,2025-07-18 20:30:43,To Instant Access Savings,-2.00,0.00,EUR,COMPLETED,155.63
Card Payment,Current,2025-07-18 15:01:38,2025-07-19 09:29:33,Pestana Hotels & Resorts,-47.70,0.00,EUR,COMPLETED,107.93
Card Payment,Current,2025-07-18 15:20:38,2025-07-19 09:29:33,Pestana Hotels & Resorts,-8.80,0.00,EUR,COMPLETED,99.13
Card Payment,Current,2025-07-18 13:28:21,2025-07-19 09:29:35,Pestana Hotels & Resorts,-6.05,0.00,EUR,COMPLETED,93.08
Card Payment,Current,2025-07-18 16:07:14,2025-07-19 09:52:26,Atlântida,-14.70,0.00,EUR,COMPLETED,78.38
Card Payment,Current,2025-07-18 18:02:42,2025-07-19 14:11:22,Uber,-6.58,0.00,EUR,COMPLETED,71.80
Transfer,Current,2025-07-19 15:01:41,2025-07-19 15:01:42,Transfer to PATRICIA QUISH,-35.00,0.00,EUR,COMPLETED,36.80
Transfer,Current,2025-07-19 18:20:32,2025-07-19 18:20:32,To Instant Access Savings,-5.00,0.00,EUR,COMPLETED,31.80
Transfer,Current,2025-07-19 18:35:37,2025-07-19 18:35:37,From Instant Access Savings,250.00,0.00,EUR,COMPLETED,281.80
Transfer,Current,2025-07-19 18:35:51,2025-07-19 18:35:51,To Instant Access Savings,-4.70,0.00,EUR,COMPLETED,277.10
Transfer,Current,2025-07-19 18:39:08,2025-07-19 18:39:08,Transfer from MARA DI RAIMONDO,17.00,0.00,EUR,COMPLETED,294.10
Transfer,Current,2025-07-19 20:49:25,2025-07-19 20:49:26,Transfer to PATRICIA QUISH,-70.00,0.00,EUR,COMPLETED,224.10
Transfer,Current,2025-07-19 20:50:01,2025-07-19 20:50:01,Transfer from MARA DI RAIMONDO,25.00,0.00,EUR,COMPLETED,249.10
Transfer,Current,2025-07-19 21:20:27,2025-07-19 21:20:28,To Instant Access Savings,-4.55,0.00,EUR,COMPLETED,244.55
Transfer,Current,2025-07-19 22:57:49,2025-07-19 22:57:50,Transfer from PATRICIA QUISH,50.00,0.00,EUR,COMPLETED,294.55
Card Payment,Current,2025-07-19 18:20:31,2025-07-20 10:52:53,Pestana Hotels & Resorts,-15.00,0.00,EUR,COMPLETED,279.55
Card Payment,Current,2025-07-19 18:35:51,2025-07-20 10:57:41,Uber,-5.06,0.00,EUR,COMPLETED,274.49
Card Payment,Current,2025-07-19 21:20:27,2025-07-20 11:04:03,Uber,-4.09,0.00,EUR,COMPLETED,270.40
Card Payment,Current,2025-07-18 20:30:42,2025-07-20 11:06:26,Gelataria,-8.60,0.00,EUR,COMPLETED,261.80
Card Payment,Current,2025-07-18 20:24:13,2025-07-20 11:54:14,Forever Portugal,-7.50,0.00,EUR,COMPLETED,254.30
Transfer,Current,2025-07-20 12:22:40,2025-07-20 12:22:40,To Instant Access Savings,-0.10,0.00,EUR,COMPLETED,254.20
Transfer,Current,2025-07-20 14:12:26,2025-07-20 14:12:26,To Instant Access Savings,-0.25,0.00,EUR,COMPLETED,253.95
Transfer,Current,2025-07-20 14:41:15,2025-07-20 14:41:15,To Instant Access Savings,-4.00,0.00,EUR,COMPLETED,249.95
Transfer,Current,2025-07-20 19:06:28,2025-07-20 19:06:28,To Instant Access Savings,-3.00,0.00,EUR,COMPLETED,246.95
Transfer,Current,2025-07-20 22:00:39,2025-07-20 22:00:39,To Instant Access Savings,-2.55,0.00,EUR,COMPLETED,244.40
Transfer,Current,2025-07-21 08:07:06,2025-07-21 08:07:06,To Instant Access Savings,-3.50,0.00,EUR,COMPLETED,240.90
Card Payment,Current,2025-07-20 12:22:39,2025-07-21 09:46:31,Uber,-47.98,0.00,EUR,COMPLETED,192.92
Transfer,Current,2025-07-21 09:51:04,2025-07-21 09:51:05,To Instant Access Savings,-3.75,0.00,EUR,COMPLETED,189.17
Card Payment,Current,2025-07-20 19:06:27,2025-07-21 10:10:28,Eddie Byrne Taxi,-51.40,0.00,EUR,COMPLETED,137.77
Card Payment,Current,2025-07-20 14:41:14,2025-07-21 10:37:54,Fao 8588,-2.20,0.00,EUR,COMPLETED,135.57
Card Payment,Current,2025-07-20 14:12:26,2025-07-21 10:42:54,areas,-9.95,0.00,EUR,COMPLETED,125.62
Transfer,Current,2025-07-21 12:37:16,2025-07-21 12:37:16,To Instant Access Savings,-5.00,0.00,EUR,COMPLETED,120.62
Card Payment,Current,2025-07-20 22:00:38,2025-07-21 14:31:19,Amazon,-4.49,0.00,EUR,COMPLETED,116.13
Transfer,Current,2025-07-21 22:34:11,2025-07-21 22:34:12,Transfer to MARA DI RAIMONDO,-10.99,0.00,EUR,COMPLETED,105.14
Card Payment,Current,2025-07-21 12:37:15,2025-07-22 11:09:06,Xl,-9.00,0.00,EUR,COMPLETED,96.14
Transfer,Current,2025-07-22 11:28:42,2025-07-22 11:28:42,To Instant Access Savings,-0.05,0.00,EUR,COMPLETED,96.09
Card Payment,Current,2025-07-21 08:07:06,2025-07-22 12:35:41,Lidl,-35.30,0.00,EUR,COMPLETED,60.79
Card Payment,Current,2025-07-21 09:51:03,2025-07-22 12:50:05,Retail inMotion,-6.25,0.00,EUR,COMPLETED,54.54
Transfer,Current,2025-07-22 15:26:38,2025-07-22 15:26:38,Transfer to MARA DI RAIMONDO,-19.49,0.00,EUR,COMPLETED,35.05
Card Payment,Current,2025-07-22 11:28:42,2025-07-23 10:09:22,Apple,-6.99,0.00,EUR,COMPLETED,28.06
Transfer,Current,2025-07-23 12:38:11,2025-07-23 12:38:11,To Instant Access Savings,-3.75,0.00,EUR,COMPLETED,24.31
Transfer,Current,2025-07-23 15:17:45,2025-07-23 15:17:45,From Instant Access Savings,50.00,0.00,EUR,COMPLETED,74.31
Transfer,Current,2025-07-23 15:18:03,2025-07-23 15:18:03,To Instant Access Savings,-0.50,0.00,EUR,COMPLETED,73.81
Transfer,Current,2025-07-23 17:29:03,2025-07-23 17:29:03,To Instant Access Savings,-5.00,0.00,EUR,COMPLETED,68.81
Transfer,Current,2025-07-23 20:31:59,2025-07-23 20:31:59,To Instant Access Savings,-0.50,0.00,EUR,COMPLETED,68.31
Transfer,Current,2025-07-24 00:02:06,2025-07-24 00:02:06,To Instant Access Savings,-4.75,0.00,EUR,COMPLETED,63.56
Transfer,Current,2025-07-24 08:53:06,2025-07-24 08:53:06,From Instant Access Savings,50.00,0.00,EUR,COMPLETED,113.56
Card Payment,Current,2025-07-23 15:18:03,2025-07-24 11:24:44,ODEON,-11.90,0.00,EUR,COMPLETED,101.66
Card Payment,Current,2025-07-23 12:38:11,2025-07-24 11:38:57,Boojum,-14.25,0.00,EUR,COMPLETED,87.41
Card Payment,Current,2025-07-23 17:29:02,2025-07-24 11:49:13,Reynolds Logistics,-10.00,0.00,EUR,COMPLETED,77.41
Card Payment,Current,2025-07-23 20:31:59,2025-07-24 12:17:52,ODEON,-15.90,0.00,EUR,COMPLETED,61.51
Transfer,Current,2025-07-24 12:47:46,2025-07-24 12:47:46,To Instant Access Savings,-2.00,0.00,EUR,COMPLETED,59.51
Card Payment,Current,2025-07-24 00:02:05,2025-07-24 13:55:09,Amazon,-11.05,0.00,EUR,COMPLETED,48.46
Transfer,Current,2025-07-25 03:00:18,2025-07-25 03:00:19,To Instant Access Savings,-5.00,0.00,EUR,COMPLETED,43.46
Topup,Current,2025-07-25 08:11:07,2025-07-25 08:11:07,Payment from WORKDAY LIMITED,3240.33,0.00,EUR,COMPLETED,3283.79
Transfer,Current,2025-07-25 08:34:34,2025-07-25 09:23:32,To Trading 212 UK Limited,-750.00,0.00,EUR,COMPLETED,2533.79
Transfer,Current,2025-07-25 08:34:35,2025-07-25 09:24:19,To Payward Ireland Ltd.,-125.00,0.00,EUR,COMPLETED,2408.79
Transfer,Current,2025-07-25 09:37:53,2025-07-25 09:37:53,To pocket EUR Subscriptions from EUR,-250.00,0.00,EUR,COMPLETED,2158.79
Transfer,Current,2025-07-25 09:37:53,2025-07-25 09:37:53,To pocket EUR Subscriptions from EUR,-780.42,0.00,EUR,COMPLETED,1378.37
Card Payment,Current,2025-07-24 12:47:46,2025-07-25 12:31:54,Fresh The Good Food Market,-10.60,0.00,EUR,COMPLETED,1367.77
Card Payment,Current,2025-07-25 03:00:18,2025-07-25 12:35:48,DSPCA,-15.00,0.00,EUR,COMPLETED,1352.77
Transfer,Current,2025-07-25 13:08:13,2025-07-25 13:08:13,To Instant Access Savings,-2.75,0.00,EUR,COMPLETED,1350.02
Transfer,Current,2025-07-25 13:27:08,2025-07-25 13:27:08,To Instant Access Savings,-4.25,0.00,EUR,COMPLETED,1345.77
Transfer,Current,2025-07-25 15:15:04,2025-07-25 15:15:04,Transfer to MARA DI RAIMONDO,-51.28,0.00,EUR,COMPLETED,1294.49
Transfer,Current,2025-07-25 15:15:18,2025-07-25 15:15:18,To pocket EUR Subscriptions from EUR,-700.00,0.00,EUR,COMPLETED,594.49
Transfer,Current,2025-07-25 15:15:35,2025-07-25 15:15:35,To EUR,-4.45,0.00,EUR,COMPLETED,590.04
Transfer,Current,2025-07-25 18:26:06,2025-07-25 18:26:07,Transfer to JOHN DANIEL KIELY,-22.50,0.00,EUR,COMPLETED,567.54
Transfer,Current,2025-07-25 18:57:50,2025-07-25 18:57:50,To Instant Access Savings,-1.00,0.00,EUR,COMPLETED,566.54
Transfer,Current,2025-07-25 21:25:37,2025-07-25 21:25:37,To Instant Access Savings,-3.00,0.00,EUR,COMPLETED,563.54
Transfer,Current,2025-07-25 22:58:10,2025-07-25 22:58:10,To Instant Access Savings,-5.00,0.00,EUR,COMPLETED,558.54
Transfer,Current,2025-07-26 00:26:43,2025-07-26 00:26:44,To Instant Access Savings,-5.00,0.00,EUR,COMPLETED,553.54
Transfer,Current,2025-07-26 01:02:15,2025-07-26 01:02:15,To Instant Access Savings,-2.00,0.00,EUR,COMPLETED,551.54
Transfer,Current,2025-07-26 10:34:23,2025-07-26 10:34:23,To Instant Access Savings,-4.25,0.00,EUR,COMPLETED,547.29
Card Payment,Current,2025-07-26 00:26:43,2025-07-26 11:45:44,Opium Dublin,-12.00,0.00,EUR,COMPLETED,535.29
Card Payment,Current,2025-07-25 13:27:08,2025-07-26 12:05:59,Centra,-2.15,0.00,EUR,COMPLETED,533.14
Card Payment,Current,2025-07-25 22:58:10,2025-07-26 12:07:27,Opium Dublin,-12.00,0.00,EUR,COMPLETED,521.14
Card Payment,Current,2025-07-25 18:57:50,2025-07-26 12:20:05,Yeeros,-12.80,0.00,EUR,COMPLETED,508.34
Card Payment,Current,2025-07-25 13:08:12,2025-07-26 12:23:26,Bullet Restaurant,-16.45,0.00,EUR,COMPLETED,491.89
Transfer,Current,2025-07-26 15:29:51,2025-07-26 15:29:51,To Instant Access Savings,-0.45,0.00,EUR,COMPLETED,491.44
Transfer,Current,2025-07-26 19:46:02,2025-07-26 19:46:02,To Instant Access Savings,-4.45,0.00,EUR,COMPLETED,486.99
Card Payment,Current,2025-07-26 01:02:15,2025-07-27 09:31:58,Haji Taxi,-19.60,0.00,EUR,COMPLETED,467.39
Card Payment,Current,2025-07-25 21:25:37,2025-07-27 09:56:55,Anseo,-21.40,0.00,EUR,COMPLETED,445.99
Card Payment,Current,2025-07-26 15:29:51,2025-07-27 10:03:45,SuperValu,-46.91,0.00,EUR,COMPLETED,399.08
Card Payment,Current,2025-07-26 10:34:22,2025-07-27 11:00:40,Applegreen,-11.15,0.00,EUR,COMPLETED,387.93
Transfer,Current,2025-07-27 12:21:20,2025-07-27 12:21:21,Transfer from MARA DI RAIMONDO,26.21,0.00,EUR,COMPLETED,414.14
Transfer,Current,2025-07-27 13:19:55,2025-07-27 13:19:56,Transfer from JOHN DANIEL KIELY,22.50,0.00,EUR,COMPLETED,436.64
Transfer,Current,2025-07-27 13:20:28,2025-07-27 13:20:29,Transfer to RORY BOYLE,-22.50,0.00,EUR,COMPLETED,414.14
Card Payment,Current,2025-07-26 19:46:01,2025-07-27 14:22:24,Cognition Labs (devin),-17.11,0.00,EUR,COMPLETED,397.03
Transfer,Current,2025-07-27 15:32:34,2025-07-27 15:32:34,To Instant Access Savings,-4.00,0.00,EUR,COMPLETED,393.03
Transfer,Current,2025-07-28 00:35:25,2025-07-28 00:35:25,To Instant Access Savings,-0.05,0.00,EUR,COMPLETED,392.98
Card Payment,Current,2025-07-27 15:32:33,2025-07-28 09:28:26,Lidl,-57.20,0.00,EUR,COMPLETED,335.78
Card Payment,Current,2025-07-28 00:35:25,2025-07-28 12:17:35,Apple,-9.99,0.00,EUR,COMPLETED,325.79
Transfer,Current,2025-07-28 18:43:00,2025-07-28 18:43:00,To Instant Access Savings,-4.75,0.00,EUR,COMPLETED,321.04
Transfer,Current,2025-07-28 19:44:16,2025-07-28 19:44:16,To Instant Access Savings,-2.05,0.00,EUR,COMPLETED,318.99
Transfer,Current,2025-07-29 08:27:51,2025-07-29 08:27:51,To Instant Access Savings,-5.00,0.00,EUR,COMPLETED,313.99
Transfer,Current,2025-07-29 11:47:30,2025-07-29 11:47:31,To Instant Access Savings,-1.25,0.00,EUR,COMPLETED,312.74
Transfer,Current,2025-07-29 16:25:31,2025-07-29 16:25:31,To Instant Access Savings,-5.00,0.00,EUR,COMPLETED,307.74
Transfer,Current,2025-07-29 16:32:22,2025-07-29 16:32:22,Pocket Withdrawal,40.00,0.00,EUR,COMPLETED,347.74
Transfer,Current,2025-07-29 16:33:04,2025-07-29 16:33:04,To Instant Access Savings,-5.00,0.00,EUR,COMPLETED,342.74
Transfer,Current,2025-07-30 08:31:52,2025-07-30 08:31:53,To Instant Access Savings,-2.75,0.00,EUR,COMPLETED,339.99
Transfer,Current,2025-07-30 10:26:54,2025-07-30 10:26:55,From Instant Access Savings,50.00,0.00,EUR,COMPLETED,389.99
Transfer,Current,2025-07-30 10:27:01,2025-07-30 10:27:01,Transfer to BRYAN DALTON,-35.00,0.00,EUR,COMPLETED,354.99
Card Payment,Current,2025-07-29 08:27:51,2025-07-30 10:49:18,Ann Griffin,-90.00,0.00,EUR,COMPLETED,264.99
Card Payment,Current,2025-07-28 18:43:00,2025-07-30 11:20:31,YUNO,-100.05,0.00,EUR,COMPLETED,164.94
Card Payment,Current,2025-07-28 19:44:16,2025-07-30 11:20:32,YUNO,-45.59,0.00,EUR,COMPLETED,119.35
Card Payment,Current,2025-07-29 16:25:30,2025-07-30 11:37:19,Cut and Sew,-32.00,0.00,EUR,COMPLETED,87.35
Card Payment,Current,2025-07-29 11:47:30,2025-07-30 11:59:49,Fresh The Good Food Market,-6.75,0.00,EUR,COMPLETED,80.60
Card Payment,Current,2025-07-29 16:33:04,2025-07-30 12:05:53,Transport for Ireland - TFI,-40.00,0.00,EUR,COMPLETED,40.60
Transfer,Current,2025-07-30 12:28:45,2025-07-30 12:28:45,To Instant Access Savings,-0.50,0.00,EUR,COMPLETED,40.10
Transfer,Current,2025-07-31 08:52:31,2025-07-31 08:52:32,To Instant Access Savings,-2.75,0.00,EUR,COMPLETED,37.35
Card Payment,Current,2025-07-30 08:31:52,2025-07-31 09:16:44,OXMANTOWN,-4.45,0.00,EUR,COMPLETED,32.90
Transfer,Current,2025-07-31 12:15:35,2025-07-31 12:15:35,Pocket Withdrawal,37.00,0.00,EUR,COMPLETED,69.90
Transfer,Current,2025-07-31 12:15:59,2025-07-31 12:16:00,To Instant Access Savings,-5.00,0.00,EUR,COMPLETED,64.90
Topup,Current,2025-07-31 12:22:38,2025-07-31 12:22:39,Payment from VHI CLAIMS,15.00,0.00,EUR,COMPLETED,79.90
Card Payment,Current,2025-07-30 12:28:45,2025-07-31 12:56:56,Boojum,-10.90,0.00,EUR,COMPLETED,69.00
Transfer,Current,2025-08-01 11:43:51,2025-08-01 11:43:52,From Instant Access Savings,100.00,0.00,EUR,COMPLETED,169.00
Transfer,Current,2025-08-01 11:43:54,2025-08-01 11:43:55,Transfer to MARA DI RAIMONDO,-35.59,0.00,EUR,COMPLETED,133.41
Card Payment,Current,2025-07-31 12:15:53,2025-08-01 12:26:11,FLYEfit,-37.00,0.00,EUR,COMPLETED,96.41
Transfer,Current,2025-08-01 12:26:35,2025-08-01 12:26:35,To Instant Access Savings,-5.00,0.00,EUR,COMPLETED,91.41
Card Payment,Current,2025-07-31 08:52:30,2025-08-01 12:36:11,OXMANTOWN,-4.45,0.00,EUR,COMPLETED,86.96
Transfer,Current,2025-08-01 21:36:20,2025-08-01 21:36:21,To Instant Access Savings,-1.05,0.00,EUR,COMPLETED,85.91
Card Payment,Current,2025-08-01 12:23:48,2025-08-02 10:49:15,Dublin Waste to Energy Facility,-15.00,0.00,EUR,COMPLETED,70.91
Card Payment,Current,2025-08-01 21:36:20,2025-08-02 11:52:41,HP,-1.79,0.00,EUR,COMPLETED,69.12
Transfer,Current,2025-08-02 12:43:20,2025-08-02 12:43:20,To Instant Access Savings,-0.85,0.00,EUR,COMPLETED,68.27
Transfer,Current,2025-08-02 14:47:05,2025-08-02 14:47:05,To Instant Access Savings,-5.00,0.00,EUR,COMPLETED,63.27
Transfer,Current,2025-08-02 20:59:18,2025-08-02 20:59:18,To Instant Access Savings,-0.05,0.00,EUR,COMPLETED,63.22
Card Payment,Current,2025-08-02 20:59:17,2025-08-03 10:36:31,Spotify,-19.99,0.00,EUR,COMPLETED,43.23
Card Payment,Current,2025-08-02 14:47:04,2025-08-03 10:43:56,Bella Italia,-6.00,0.00,EUR,COMPLETED,37.23
Transfer,Current,2025-08-03 10:55:18,2025-08-03 10:55:18,To Instant Access Savings,-0.05,0.00,EUR,COMPLETED,37.18
Card Payment,Current,2025-08-02 12:43:20,2025-08-03 11:28:43,Dunnes Stores,-5.83,0.00,EUR,COMPLETED,31.35
Transfer,Current,2025-08-03 13:48:49,2025-08-03 13:48:49,To Instant Access Savings,-3.50,0.00,EUR,COMPLETED,27.85
Transfer,Current,2025-08-03 14:48:16,2025-08-03 14:48:16,To Instant Access Savings,-1.50,0.00,EUR,COMPLETED,26.35
Transfer,Current,2025-08-03 18:03:52,2025-08-03 18:03:52,From Instant Access Savings,100.00,0.00,EUR,COMPLETED,126.35
Transfer,Current,2025-08-03 18:59:44,2025-08-03 18:59:44,To Instant Access Savings,-3.25,0.00,EUR,COMPLETED,123.10
Transfer,Current,2025-08-04 10:11:48,2025-08-04 10:11:49,To Instant Access Savings,-0.05,0.00,EUR,COMPLETED,123.05
Transfer,Current,2025-08-04 11:01:58,2025-08-04 11:01:58,To Instant Access Savings,-3.05,0.00,EUR,COMPLETED,120.00
Transfer,Current,2025-08-04 11:07:56,2025-08-04 11:07:56,To Instant Access Savings,-5.00,0.00,EUR,COMPLETED,115.00
Transfer,Current,2025-08-04 15:36:47,2025-08-04 15:36:47,To Instant Access Savings,-5.00,0.00,EUR,COMPLETED,110.00
Card Payment,Current,2025-08-03 13:48:49,2025-08-04 15:39:22,Bunratty Castle Hotel,-7.30,0.00,EUR,COMPLETED,102.70
Card Payment,Current,2025-08-03 14:48:15,2025-08-04 15:39:22,Bunratty Castle Hotel,-12.70,0.00,EUR,COMPLETED,90.00
Transfer,Current,2025-08-04 16:11:17,2025-08-04 16:11:17,Pocket Withdrawal,100.00,0.00,EUR,COMPLETED,190.00
Transfer,Current,2025-08-04 16:13:58,2025-08-04 16:13:58,To Instant Access Savings,-1.00,0.00,EUR,COMPLETED,189.00
Card Payment,Current,2025-08-03 10:55:17,2025-08-04 17:08:14,The Washington Post,-0.99,0.00,EUR,COMPLETED,188.01
Card Payment,Current,2025-08-04 15:36:46,2025-08-05 11:04:43,University Hospital Limerick,-2.00,0.00,EUR,COMPLETED,186.01
Card Payment,Current,2025-08-04 11:07:55,2025-08-05 11:09:24,Myrunphotos.ie,-18.00,0.00,EUR,COMPLETED,168.01
Card Payment,Current,2025-08-03 18:59:43,2025-08-05 11:17:51,PaMcGrath's,-44.35,0.00,EUR,COMPLETED,123.66
Card Payment,Current,2025-08-04 16:13:58,2025-08-05 12:18:01,Applegreen,-5.80,0.00,EUR,COMPLETED,117.86
Transfer,Current,2025-08-05 15:06:35,2025-08-05 15:06:35,To Instant Access Savings,-3.25,0.00,EUR,COMPLETED,114.61
Transfer,Current,2025-08-05 15:33:59,2025-08-05 15:34:00,Transfer to HUGH CARROLL,-0.01,0.00,EUR,COMPLETED,114.60
Transfer,Current,2025-08-05 15:38:54,2025-08-05 15:38:55,Transfer to HUGH CARROLL,-43.98,0.00,EUR,COMPLETED,70.62
Card Payment,Current,2025-08-04 11:01:58,2025-08-05 16:43:31,Amazon,-10.39,0.00,EUR,COMPLETED,60.23
Card Payment,Current,2025-08-04 10:11:48,2025-08-05 16:48:51,YouTube,-13.99,0.00,EUR,COMPLETED,46.24
Card Payment,Current,2025-08-05 15:06:34,2025-08-06 09:06:06,Dublin Marathon,-5.35,0.00,EUR,COMPLETED,40.89
Transfer,Current,2025-08-08 08:18:24,2025-08-08 08:18:24,To Instant Access Savings,-1.50,0.00,EUR,COMPLETED,39.39
Transfer,Current,2025-08-08 19:54:41,2025-08-08 19:54:42,Transfer to BRYAN DALTON,-17.00,0.00,EUR,COMPLETED,22.39
Transfer,Current,2025-08-08 23:23:39,2025-08-08 23:23:39,From Instant Access Savings,100.00,0.00,EUR,COMPLETED,122.39
Transfer,Current,2025-08-09 00:36:04,2025-08-09 00:36:04,To Instant Access Savings,-1.50,0.00,EUR,COMPLETED,120.89
Card Payment,Current,2025-08-08 08:18:24,2025-08-09 10:57:37,Insomnia Coffee Company,-4.70,0.00,EUR,COMPLETED,116.19
Transfer,Current,2025-08-09 11:52:15,2025-08-09 11:52:15,To Instant Access Savings,-0.75,0.00,EUR,COMPLETED,115.44
Transfer,Current,2025-08-09 11:57:30,2025-08-09 11:57:30,To Instant Access Savings,-5.00,0.00,EUR,COMPLETED,110.44
Transfer,Current,2025-08-09 13:41:43,2025-08-09 13:41:44,To Instant Access Savings,-5.00,0.00,EUR,COMPLETED,105.44
Transfer,Current,2025-08-09 22:01:01,2025-08-09 22:01:02,Transfer from MARA DI RAIMONDO,18.00,0.00,EUR,COMPLETED,123.44
Transfer,Current,2025-08-09 22:03:59,2025-08-09 22:03:59,Transfer to GARETH GLEESON,-15.00,0.00,EUR,COMPLETED,108.44
Card Payment,Current,2025-08-09 00:36:03,2025-08-10 10:09:17,FREE NOW,-16.70,0.00,EUR,COMPLETED,91.74
Card Payment,Current,2025-08-09 11:57:29,2025-08-10 10:16:23,The Flower Box,-45.00,0.00,EUR,COMPLETED,46.74
Card Payment,Current,2025-08-09 13:41:43,2025-08-10 10:31:48,OpenAI,-23.00,0.00,EUR,COMPLETED,23.74
Card Payment,Current,2025-08-09 11:52:14,2025-08-10 12:01:32,SuperValu,-9.85,0.00,EUR,COMPLETED,13.89
Transfer,Current,2025-08-10 12:06:08,2025-08-10 12:06:08,To Instant Access Savings,-2.00,0.00,EUR,COMPLETED,11.89
Transfer,Current,2025-08-10 12:06:52,2025-08-10 12:06:52,Pocket Withdrawal,100.00,0.00,EUR,COMPLETED,111.89
Transfer,Current,2025-08-10 19:39:07,2025-08-10 19:39:07,Pocket Withdrawal,1470.44,0.00,EUR,COMPLETED,1582.33
Transfer,Current,2025-08-10 19:39:17,2025-08-10 19:39:18,From Instant Access Savings,125.00,0.00,EUR,COMPLETED,1707.33
Transfer,Current,2025-08-10 19:58:05,2025-08-10 19:58:05,To Instant Access Savings,-4.50,0.00,EUR,COMPLETED,1702.83
Transfer,Current,2025-08-11 01:00:00,2025-08-11 11:43:58,To Bankinter SA Ireland Branch,-1649.75,0.00,EUR,COMPLETED,53.08
Card Payment,Current,2025-08-10 19:58:04,2025-08-11 12:03:45,FREE NOW,-23.10,0.00,EUR,COMPLETED,29.98
Card Payment,Current,2025-08-10 12:06:07,2025-08-11 12:53:29,Pine Cone Coffee Monks,-6.60,0.00,EUR,COMPLETED,23.38
Transfer,Current,2025-08-11 23:07:13,2025-08-11 23:07:13,To Instant Access Savings,-4.60,0.00,EUR,COMPLETED,18.78
Transfer,Current,2025-08-12 15:56:34,2025-08-12 15:56:34,From Instant Access Savings,100.00,0.00,EUR,COMPLETED,118.78
Transfer,Current,2025-08-12 15:57:26,2025-08-12 15:57:26,Transfer to Andrew James Fullen,-31.00,0.00,EUR,COMPLETED,87.78
Card Payment,Current,2025-08-11 23:07:12,2025-08-12 17:39:13,Amazon,-17.08,0.00,EUR,COMPLETED,70.70
Transfer,Current,2025-08-12 19:03:02,2025-08-12 19:03:02,To Instant Access Savings,-2.80,0.00,EUR,COMPLETED,67.90
Transfer,Current,2025-08-12 19:04:16,2025-08-12 19:04:16,Transfer to GARETH GLEESON,-18.00,0.00,EUR,COMPLETED,49.90
Transfer,Current,2025-08-12 19:04:20,2025-08-12 19:04:20,Transfer from MARA DI RAIMONDO,15.72,0.00,EUR,COMPLETED,65.62
Transfer,Current,2025-08-12 19:04:24,2025-08-12 19:04:25,Transfer from MARA DI RAIMONDO,15.50,0.00,EUR,COMPLETED,81.12
Transfer,Current,2025-08-12 19:05:58,2025-08-12 19:05:58,Transfer to MARA DI RAIMONDO,-9.50,0.00,EUR,COMPLETED,71.62
Transfer,Current,2025-08-12 19:06:20,2025-08-12 19:06:21,Transfer to MARA DI RAIMONDO,-25.00,0.00,EUR,COMPLETED,46.62
Transfer,Current,2025-08-12 19:07:04,2025-08-12 19:07:05,Transfer to MARA DI RAIMONDO,-2.09,0.00,EUR,COMPLETED,44.53
Transfer,Current,2025-08-12 19:07:07,2025-08-12 19:07:07,Transfer to MARA DI RAIMONDO,-1.88,0.00,EUR,COMPLETED,42.65
Transfer,Current,2025-08-12 19:07:10,2025-08-12 19:07:11,Transfer to MARA DI RAIMONDO,-8.00,0.00,EUR,COMPLETED,34.65
Transfer,Current,2025-08-12 19:07:34,2025-08-12 19:07:35,Transfer from MARA DI RAIMONDO,11.55,0.00,EUR,COMPLETED,46.20
Transfer,Current,2025-08-12 19:07:41,2025-08-12 19:07:41,Transfer from MARA DI RAIMONDO,22.50,0.00,EUR,COMPLETED,68.70
Transfer,Current,2025-08-12 19:08:29,2025-08-12 19:08:29,Transfer to MARA DI RAIMONDO,-22.50,0.00,EUR,COMPLETED,46.20
Transfer,Current,2025-08-12 19:08:34,2025-08-12 19:08:34,Transfer from MARA DI RAIMONDO,11.50,0.00,EUR,COMPLETED,57.70
Transfer,Current,2025-08-12 19:10:59,2025-08-12 19:10:59,Transfer from MARA DI RAIMONDO,11.00,0.00,EUR,COMPLETED,68.70
Transfer,Current,2025-08-12 19:11:26,2025-08-12 19:11:26,Transfer to MARA DI RAIMONDO,-12.05,0.00,EUR,COMPLETED,56.65
Transfer,Current,2025-08-13 08:41:02,2025-08-13 08:41:02,To Instant Access Savings,-5.00,0.00,EUR,COMPLETED,51.65
Card Payment,Current,2025-08-12 19:03:01,2025-08-13 14:09:20,Deliveroo,-31.44,0.00,EUR,COMPLETED,20.21
Transfer,Current,2025-08-13 19:10:15,2025-08-13 19:10:16,To Instant Access Savings,-0.25,0.00,EUR,COMPLETED,19.96
Transfer,Current,2025-08-14 08:06:38,2025-08-14 08:06:38,From Instant Access Savings,100.00,0.00,EUR,COMPLETED,119.96
Transfer,Current,2025-08-14 08:06:41,2025-08-14 08:06:42,Transfer to MARA DI RAIMONDO,-51.28,0.00,EUR,COMPLETED,68.68
Transfer,Current,2025-08-14 08:11:59,2025-08-14 08:11:59,To Instant Access Savings,-1.75,0.00,EUR,COMPLETED,66.93
Card Payment,Current,2025-08-13 08:41:02,2025-08-14 12:40:28,Fresh Tara Dart Station,-9.00,0.00,EUR,COMPLETED,57.93
Card Payment,Current,2025-08-13 19:10:15,2025-08-14 12:41:30,Movies@,-4.95,0.00,EUR,COMPLETED,52.98
Transfer,Current,2025-08-14 18:25:17,2025-08-14 18:25:17,To Instant Access Savings,-4.00,0.00,EUR,COMPLETED,48.98
Transfer,Current,2025-08-14 19:06:48,2025-08-14 19:06:48,To Instant Access Savings,-2.00,0.00,EUR,COMPLETED,46.98
Transfer,Current,2025-08-14 19:11:02,2025-08-14 19:11:02,To Instant Access Savings,-4.00,0.00,EUR,COMPLETED,42.98
Transfer,Current,2025-08-14 19:41:15,2025-08-14 19:41:15,To Instant Access Savings,-0.10,0.00,EUR,COMPLETED,42.88
Transfer,Current,2025-08-15 10:03:36,2025-08-15 10:03:36,From Instant Access Savings,500.00,0.00,EUR,COMPLETED,542.88
Transfer,Current,2025-08-15 10:04:02,2025-08-15 10:04:03,Transfer to BRIAN KENNEDY,-327.00,0.00,EUR,COMPLETED,215.88
Card Payment,Current,2025-08-14 19:06:47,2025-08-15 12:26:06,WHSmith,-2.60,0.00,EUR,COMPLETED,213.28
Card Payment,Current,2025-08-14 19:41:14,2025-08-15 12:26:06,WHSmith,-7.98,0.00,EUR,COMPLETED,205.30
Card Payment,Current,2025-08-14 18:25:16,2025-08-15 12:40:50,SSP Uk,-13.20,0.00,EUR,COMPLETED,192.10
Card Payment,Current,2025-08-14 08:11:58,2025-08-15 13:28:06,Donnybrook Fair,-3.65,0.00,EUR,COMPLETED,188.45
Card Payment,Current,2025-08-14 19:11:02,2025-08-15 13:29:54,Marqette,-8.20,0.00,EUR,COMPLETED,180.25
Transfer,Current,2025-08-15 15:48:24,2025-08-15 15:48:24,To Instant Access Savings,-3.90,0.00,EUR,COMPLETED,176.35
Card Payment,Current,2025-08-15 15:48:23,2025-08-16 12:17:14,GoMo,-10.22,0.00,EUR,COMPLETED,166.13
Transfer,Current,2025-08-17 11:17:04,2025-08-17 11:17:04,To Instant Access Savings,-1.65,0.00,EUR,COMPLETED,164.48
Card Payment,Current,2025-08-17 11:17:04,2025-08-18 11:57:31,Cafe Marcel,-47.67,0.00,EUR,COMPLETED,116.81
Transfer,Current,2025-08-19 18:25:04,2025-08-19 18:25:04,To Instant Access Savings,-5.00,0.00,EUR,COMPLETED,111.81
Transfer,Current,2025-08-19 18:42:54,2025-08-19 18:42:54,To Instant Access Savings,-0.60,0.00,EUR,COMPLETED,111.21
Card Payment,Current,2025-08-19 18:25:04,2025-08-20 09:45:00,FRISTO,-13.00,0.00,EUR,COMPLETED,98.21
Card Payment,Current,2025-08-19 18:42:54,2025-08-20 09:46:02,Lidl,-2.88,0.00,EUR,COMPLETED,95.33
Transfer,Current,2025-08-22 09:36:37,2025-08-22 09:36:37,To Instant Access Savings,-5.00,0.00,EUR,COMPLETED,90.33
Transfer,Current,2025-08-22 01:00:00,2025-08-22 11:47:59,To eFlow,-1.23,0.00,EUR,COMPLETED,89.10
Transfer,Current,2025-08-22 12:16:57,2025-08-22 12:16:57,To Instant Access Savings,-3.35,0.00,EUR,COMPLETED,85.75
Transfer,Current,2025-08-22 12:18:21,2025-08-22 12:18:21,To Instant Access Savings,-0.20,0.00,EUR,COMPLETED,85.55
Transfer,Current,2025-08-22 19:43:01,2025-08-22 19:43:01,From Instant Access Savings,100.00,0.00,EUR,COMPLETED,185.55
Transfer,Current,2025-08-22 19:43:53,2025-08-22 19:43:53,To Instant Access Savings,-5.00,0.00,EUR,COMPLETED,180.55
Transfer,Current,2025-08-22 19:54:41,2025-08-22 19:54:41,To Instant Access Savings,-1.00,0.00,EUR,COMPLETED,179.55
Card Payment,Current,2025-08-22 09:36:36,2025-08-23 11:10:08,Apple,-25.00,0.00,EUR,COMPLETED,154.55
Card Payment,Current,2025-08-22 19:43:52,2025-08-23 11:52:47,Wirtshaus Lautenschlager,-75.00,0.00,EUR,COMPLETED,79.55
Card Payment,Current,2025-08-22 12:16:56,2025-08-23 12:08:06,jojo.stier,-46.33,0.00,EUR,COMPLETED,33.22
Card Payment,Current,2025-08-22 12:18:20,2025-08-23 12:08:41,Gotizi,-11.96,0.00,EUR,COMPLETED,21.26
Card Payment,Current,2025-08-22 19:54:40,2025-08-23 12:12:59,Königsbau Passagen,-6.80,0.00,EUR,COMPLETED,14.46
Transfer,Current,2025-08-23 14:09:24,2025-08-23 14:09:24,From Instant Access Savings,100.00,0.00,EUR,COMPLETED,114.46
Transfer,Current,2025-08-23 14:14:44,2025-08-23 14:14:44,To Instant Access Savings,-0.25,0.00,EUR,COMPLETED,114.21
Transfer,Current,2025-08-23 20:02:23,2025-08-23 20:02:23,To Instant Access Savings,-5.00,0.00,EUR,COMPLETED,109.21
Card Refund,Current,2025-08-24 01:00:00,2025-08-24 08:26:31,Apple,25.00,0.00,EUR,COMPLETED,134.21
Card Payment,Current,2025-08-23 14:14:43,2025-08-24 08:35:13,Babbel,-19.95,0.00,EUR,COMPLETED,114.26
Transfer,Current,2025-08-24 10:38:29,2025-08-24 10:38:29,Transfer to MARA DI RAIMONDO,-50.00,0.00,EUR,COMPLETED,64.26
Card Payment,Current,2025-08-23 20:02:23,2025-08-24 11:11:03,Eiscafe La Dolce Vita,-10.00,0.00,EUR,COMPLETED,54.26
Transfer,Current,2025-08-24 14:06:38,2025-08-24 14:06:38,To Instant Access Savings,-0.05,0.00,EUR,COMPLETED,54.21
Transfer,Current,2025-08-24 19:50:41,2025-08-24 19:50:42,To Instant Access Savings,-5.00,0.00,EUR,COMPLETED,49.21
Transfer,Current,2025-08-24 21:53:33,2025-08-24 21:53:33,To Instant Access Savings,-0.50,0.00,EUR,COMPLETED,48.71
Transfer,Current,2025-08-25 03:00:32,2025-08-25 03:00:32,To Instant Access Savings,-5.00,0.00,EUR,COMPLETED,43.71
Topup,Current,2025-08-25 08:06:20,2025-08-25 08:06:21,Payment from WORKDAY LIMITED,3015.96,0.00,EUR,COMPLETED,3059.67
Transfer,Current,2025-08-25 08:08:47,2025-08-25 08:08:47,To EUR,-1477.11,0.00,EUR,COMPLETED,1582.56
Transfer,Current,2025-08-25 08:30:39,2025-08-25 09:36:26,To Payward Ireland Ltd.,-125.00,0.00,EUR,COMPLETED,1457.56
Card Payment,Current,2025-08-24 19:50:41,2025-08-25 10:12:12,Aircoach,-9.00,0.00,EUR,COMPLETED,1448.56
Card Payment,Current,2025-08-24 14:06:38,2025-08-25 11:22:31,EDEKA,-9.99,0.00,EUR,COMPLETED,1438.57
Card Payment,Current,2025-08-24 21:53:33,2025-08-25 11:23:12,Retail inMotion,-4.90,0.00,EUR,COMPLETED,1433.67
Card Payment,Current,2025-08-25 03:00:32,2025-08-25 11:52:54,DSPCA,-15.00,0.00,EUR,COMPLETED,1418.67
Transfer,Current,2025-08-25 13:17:42,2025-08-25 13:17:42,To Instant Access Savings,-1.25,0.00,EUR,COMPLETED,1417.42
Transfer,Current,2025-08-25 16:18:12,2025-08-25 16:18:13,Transfer from MARA DI RAIMONDO,550.00,0.00,EUR,COMPLETED,1967.42
Transfer,Current,2025-08-25 17:08:07,2025-08-25 17:08:07,To Instant Access Savings,-5.00,0.00,EUR,COMPLETED,1962.42
Transfer,Current,2025-08-26 07:43:26,2025-08-26 07:43:26,To Instant Access Savings,-5.00,0.00,EUR,COMPLETED,1957.42
Card Payment,Current,2025-08-25 13:17:42,2025-08-26 10:34:18,Fresh The Good Food Market,-6.75,0.00,EUR,COMPLETED,1950.67
Transfer,Current,2025-08-26 14:18:06,2025-08-26 14:18:06,To Instant Access Savings,-2.50,0.00,EUR,COMPLETED,1948.17
Card Payment,Current,2025-08-25 17:08:07,2025-08-26 17:16:44,Vape And Beyond 01,-20.00,0.00,EUR,COMPLETED,1928.17
Transfer,Current,2025-08-26 18:45:35,2025-08-26 18:45:35,To Instant Access Savings,-1.25,0.00,EUR,COMPLETED,1926.92
Transfer,Current,2025-08-26 18:59:46,2025-08-26 18:59:46,To Instant Access Savings,-2.65,0.00,EUR,COMPLETED,1924.27
Card Payment,Current,2025-08-26 18:59:46,2025-08-27 11:40:02,Camile Thai,-23.47,0.00,EUR,COMPLETED,1900.80
Transfer,Current,2025-08-27 12:06:54,2025-08-27 12:06:54,To Instant Access Savings,-1.25,0.00,EUR,COMPLETED,1899.55
Card Payment,Current,2025-08-26 14:18:05,2025-08-27 12:34:50,Fresh The Good Food Market,-10.50,0.00,EUR,COMPLETED,1889.05
Card Payment,Current,2025-08-26 07:43:26,2025-08-27 13:34:55,Stillorgan Plaza Car Park,-1.00,0.00,EUR,COMPLETED,1888.05
Card Payment,Current,2025-08-26 18:45:34,2025-08-27 13:35:17,YUNO,-36.75,0.00,EUR,COMPLETED,1851.30
Transfer,Current,2025-08-27 17:16:21,2025-08-27 17:16:21,To Instant Access Savings,-2.50,0.00,EUR,COMPLETED,1848.80
Transfer,Current,2025-08-27 19:41:56,2025-08-27 19:41:56,To Instant Access Savings,-4.55,0.00,EUR,COMPLETED,1844.25
Transfer,Current,2025-08-27 19:46:55,2025-08-27 19:46:55,To Instant Access Savings,-3.00,0.00,EUR,COMPLETED,1841.25
Transfer,Current,2025-08-27 20:43:06,2025-08-27 20:43:07,To Instant Access Savings,-3.00,0.00,EUR,COMPLETED,1838.25
Transfer,Current,2025-08-27 21:48:22,2025-08-27 21:48:22,To Instant Access Savings,-5.00,0.00,EUR,COMPLETED,1833.25
Transfer,Current,2025-08-27 21:52:03,2025-08-27 21:52:03,To Instant Access Savings,-4.50,0.00,EUR,COMPLETED,1828.75
Transfer,Current,2025-08-28 00:34:18,2025-08-28 00:34:19,To Instant Access Savings,-0.05,0.00,EUR,COMPLETED,1828.70
Transfer,Current,2025-08-28 09:24:41,2025-08-28 09:24:41,To Instant Access Savings,-2.80,0.00,EUR,COMPLETED,1825.90
Card Payment,Current,2025-08-27 19:41:56,2025-08-28 09:29:15,YUNO,-57.09,0.00,EUR,COMPLETED,1768.81
Card Payment,Current,2025-08-27 21:48:22,2025-08-28 11:50:50,Gamers World,-15.00,0.00,EUR,COMPLETED,1753.81
Card Payment,Current,2025-08-27 20:43:06,2025-08-28 13:01:14,The Grand Social Ireland,-13.40,0.00,EUR,COMPLETED,1740.41
Card Payment,Current,2025-08-27 17:16:21,2025-08-28 13:14:49,The Cobblestone,-13.50,0.00,EUR,COMPLETED,1726.91
Card Payment,Current,2025-08-27 12:06:53,2025-08-28 13:40:34,Fresh The Good Food Market,-6.75,0.00,EUR,COMPLETED,1720.16
Transfer,Current,2025-08-28 17:02:42,2025-08-28 17:02:42,To Instant Access Savings,-4.95,0.00,EUR,COMPLETED,1715.21
Transfer,Current,2025-08-28 18:54:52,2025-08-28 18:54:52,To Instant Access Savings,-1.05,0.00,EUR,COMPLETED,1714.16
Transfer,Current,2025-08-29 07:22:34,2025-08-29 07:22:34,To Instant Access Savings,-2.00,0.00,EUR,COMPLETED,1712.16
Transfer,Current,2025-08-29 07:40:17,2025-08-29 07:40:17,To Instant Access Savings,-1.55,0.00,EUR,COMPLETED,1710.61
Card Payment,Current,2025-08-28 09:24:40,2025-08-29 11:26:15,Uber Eats,-18.44,0.00,EUR,COMPLETED,1692.17
Card Payment,Current,2025-08-28 00:34:18,2025-08-29 11:36:38,Apple,-9.99,0.00,EUR,COMPLETED,1682.18
Card Payment,Current,2025-08-27 19:46:55,2025-08-29 12:12:10,The Quays Bar,-18.40,0.00,EUR,COMPLETED,1663.78
Card Payment,Current,2025-08-27 21:52:03,2025-08-29 12:13:17,The Smith Pub,-15.10,0.00,EUR,COMPLETED,1648.68
Transfer,Current,2025-08-29 12:34:11,2025-08-29 12:34:12,To Instant Access Savings,-1.00,0.00,EUR,COMPLETED,1647.68
Card Payment,Current,2025-08-28 18:54:51,2025-08-29 14:33:00,Deliveroo,-20.79,0.00,EUR,COMPLETED,1626.89
Card Payment,Current,2025-08-28 17:02:41,2025-08-29 15:57:29,Amazon,-3.01,0.00,EUR,COMPLETED,1623.88
Transfer,Current,2025-08-29 17:04:58,2025-08-29 17:04:58,To Instant Access Savings,-3.50,0.00,EUR,COMPLETED,1620.38
Transfer,Current,2025-08-29 19:15:49,2025-08-29 19:15:50,Transfer to SHANE BRIAN O'NEILL,-45.00,0.00,EUR,COMPLETED,1575.38
Transfer,Current,2025-08-29 19:26:57,2025-08-29 19:26:57,To Instant Access Savings,-1.00,0.00,EUR,COMPLETED,1574.38
Transfer,Current,2025-08-30 00:19:55,2025-08-30 00:19:56,To Instant Access Savings,-3.50,0.00,EUR,COMPLETED,1570.88
Transfer,Current,2025-08-30 07:32:46,2025-08-30 07:32:47,To Instant Access Savings,-2.50,0.00,EUR,COMPLETED,1568.38
Transfer,Current,2025-08-30 11:16:42,2025-08-30 11:16:43,Transfer to STEPHEN JAMES COSTIGAN,-20.00,0.00,EUR,COMPLETED,1548.38
Card Payment,Current,2025-08-29 07:40:17,2025-08-30 12:02:50,SuperValu,-7.69,0.00,EUR,COMPLETED,1540.69
Card Payment,Current,2025-08-29 12:34:11,2025-08-30 12:09:05,The Slaney,-7.80,0.00,EUR,COMPLETED,1532.89
Card Payment,Current,2025-08-29 07:22:34,2025-08-30 13:10:41,Aircoach,-12.60,0.00,EUR,COMPLETED,1520.29
Card Payment,Current,2025-08-29 19:26:56,2025-08-30 13:21:53,Ondarra,-8.80,0.00,EUR,COMPLETED,1511.49
Card Payment,Current,2025-08-29 17:04:57,2025-08-30 14:18:49,Aena,-11.30,0.00,EUR,COMPLETED,1500.19
Transfer,Current,2025-08-30 17:16:47,2025-08-30 17:16:47,To Instant Access Savings,-5.00,0.00,EUR,COMPLETED,1495.19
Transfer,Current,2025-08-30 21:46:24,2025-08-30 21:46:24,To Instant Access Savings,-0.75,0.00,EUR,COMPLETED,1494.44
Transfer,Current,2025-08-31 03:14:05,2025-08-31 03:14:05,To Instant Access Savings,-5.00,0.00,EUR,COMPLETED,1489.44
Transfer,Current,2025-08-31 10:16:26,2025-08-31 10:16:27,Transfer to BRIAN KENNEDY,-22.00,0.00,EUR,COMPLETED,1467.44
Transfer,Current,2025-08-31 10:55:18,2025-08-31 10:55:18,To Instant Access Savings,-0.05,0.00,EUR,COMPLETED,1467.39
Card Payment,Current,2025-08-30 00:19:55,2025-08-31 11:27:12,Picaro,-3.30,0.00,EUR,COMPLETED,1464.09
Transfer,Current,2025-08-31 12:23:54,2025-08-31 12:23:54,To Instant Access Savings,-4.00,0.00,EUR,COMPLETED,1460.09
Card Payment,Current,2025-08-30 07:32:46,2025-08-31 13:02:45,Retail inMotion,-10.50,0.00,EUR,COMPLETED,1449.59
Card Payment,Current,2025-08-30 17:16:46,2025-08-31 13:11:06,Arrantzaleen Kofradia,-2.00,0.00,EUR,COMPLETED,1447.59
Card Payment,Current,2025-08-30 21:46:24,2025-08-31 13:11:06,Betijai Berria S.l,-17.85,0.00,EUR,COMPLETED,1429.74
Transfer,Current,2025-09-01 11:46:36,2025-09-01 11:46:36,To Instant Access Savings,-1.25,0.00,EUR,COMPLETED,1428.49
Transfer,Current,2025-09-01 01:00:00,2025-09-01 11:52:16,To Royal London,-16.72,0.00,EUR,COMPLETED,1411.77
Transfer,Current,2025-09-01 12:05:02,2025-09-01 12:05:02,To Instant Access Savings,-1.05,0.00,EUR,COMPLETED,1410.72
Card Payment,Current,2025-08-31 03:14:05,2025-09-01 12:36:22,FLYEfit,-37.00,0.00,EUR,COMPLETED,1373.72
Card Payment,Current,2025-08-31 12:23:53,2025-09-01 13:48:56,Kiosko Estacion De Autobu,-3.20,0.00,EUR,COMPLETED,1370.52
Transfer,Current,2025-09-01 14:34:33,2025-09-01 14:34:34,Transfer to DAVID KEVIN SMYTH,-65.00,0.00,EUR,COMPLETED,1305.52
Transfer,Current,2025-09-01 15:14:33,2025-09-01 15:14:33,To Instant Access Savings,-0.50,0.00,EUR,COMPLETED,1305.02
Card Payment,Current,2025-08-31 10:55:17,2025-09-01 15:51:26,The Washington Post,-0.99,0.00,EUR,COMPLETED,1304.03
Card Payment,Current,2025-09-01 11:46:35,2025-09-02 09:04:44,Ni Hao Restaurante Asiati,-11.75,0.00,EUR,COMPLETED,1292.28
Card Payment,Current,2025-09-01 15:14:32,2025-09-02 09:52:17,Giraffe World Kitchen,-18.90,0.00,EUR,COMPLETED,1273.38
Card Payment,Current,2025-09-01 12:05:02,2025-09-02 10:02:39,HP,-1.79,0.00,EUR,COMPLETED,1271.59
Transfer,Current,2025-09-02 13:20:04,2025-09-02 13:20:04,To Instant Access Savings,-3.10,0.00,EUR,COMPLETED,1268.49
Transfer,Current,2025-09-02 20:59:16,2025-09-02 20:59:17,To Instant Access Savings,-0.05,0.00,EUR,COMPLETED,1268.44
Card Payment,Current,2025-09-02 20:59:16,2025-09-03 11:35:07,Spotify,-19.99,0.00,EUR,COMPLETED,1248.45
Card Payment,Current,2025-09-02 13:20:04,2025-09-03 12:16:47,Lidl,-51.38,0.00,EUR,COMPLETED,1197.07
Transfer,Current,2025-09-03 18:39:56,2025-09-03 18:39:57,To Instant Access Savings,-2.55,0.00,EUR,COMPLETED,1194.52
Transfer,Current,2025-09-04 10:11:48,2025-09-04 10:11:49,To Instant Access Savings,-0.05,0.00,EUR,COMPLETED,1194.47
Transfer,Current,2025-09-04 10:19:26,2025-09-04 10:19:26,To Instant Access Savings,-1.00,0.00,EUR,COMPLETED,1193.47
Transfer,Current,2025-09-04 11:05:35,2025-09-04 11:05:35,To Instant Access Savings,-2.85,0.00,EUR,COMPLETED,1190.62
Card Payment,Current,2025-09-03 18:39:56,2025-09-04 12:35:35,Boots,-8.49,0.00,EUR,COMPLETED,1182.13
Transfer,Current,2025-09-04 17:43:11,2025-09-04 17:43:11,To Instant Access Savings,-4.50,0.00,EUR,COMPLETED,1177.63
Transfer,Current,2025-09-04 18:33:24,2025-09-04 18:33:25,To Instant Access Savings,-1.65,0.00,EUR,COMPLETED,1175.98
Transfer,Current,2025-09-04 19:08:48,2025-09-04 19:08:49,Transfer to MARA DI RAIMONDO,-7.71,0.00,EUR,COMPLETED,1168.27
Transfer,Current,2025-09-04 19:08:54,2025-09-04 19:08:54,Transfer to MARA DI RAIMONDO,-7.73,0.00,EUR,COMPLETED,1160.54
Transfer,Current,2025-09-04 19:08:58,2025-09-04 19:08:59,Transfer to MARA DI RAIMONDO,-22.50,0.00,EUR,COMPLETED,1138.04
Transfer,Current,2025-09-04 19:19:13,2025-09-04 19:19:14,Transfer to MARA DI RAIMONDO,-40.48,0.00,EUR,COMPLETED,1097.56
Transfer,Current,2025-09-04 19:19:17,2025-09-04 19:19:19,Transfer to MARA DI RAIMONDO,-16.73,0.00,EUR,COMPLETED,1080.83
Transfer,Current,2025-09-04 19:19:27,2025-09-04 19:19:29,Transfer from MARA DI RAIMONDO,18.38,0.00,EUR,COMPLETED,1099.21
Transfer,Current,2025-09-04 19:19:32,2025-09-04 19:19:33,Transfer from MARA DI RAIMONDO,28.55,0.00,EUR,COMPLETED,1127.76
Transfer,Current,2025-09-04 19:19:40,2025-09-04 19:19:40,Transfer from MARA DI RAIMONDO,16.00,0.00,EUR,COMPLETED,1143.76
Transfer,Current,2025-09-04 19:23:34,2025-09-04 19:23:35,Transfer from MARA DI RAIMONDO,5.00,0.00,EUR,COMPLETED,1148.76
Transfer,Current,2025-09-05 08:17:36,2025-09-05 08:17:36,To Instant Access Savings,-1.75,0.00,EUR,COMPLETED,1147.01
Card Payment,Current,2025-09-04 18:33:24,2025-09-05 12:19:12,SuperValu,-32.67,0.00,EUR,COMPLETED,1114.34
Card Payment,Current,2025-09-04 10:19:26,2025-09-05 12:46:08,Zurich Insurance,-431.80,0.00,EUR,COMPLETED,682.54
Card Payment,Current,2025-09-04 17:43:10,2025-09-05 12:55:53,Xl,-4.10,0.00,EUR,COMPLETED,678.44
Card Payment,Current,2025-09-04 11:05:35,2025-09-05 16:41:08,Amazon,-10.43,0.00,EUR,COMPLETED,668.01
Card Payment,Current,2025-09-04 10:11:48,2025-09-05 16:54:54,YouTube,-13.99,0.00,EUR,COMPLETED,654.02
Transfer,Current,2025-09-05 17:11:43,2025-09-05 17:11:43,To Instant Access Savings,-3.25,0.00,EUR,COMPLETED,650.77
Card Payment,Current,2025-09-05 08:17:35,2025-09-06 10:47:49,Donnybrook Fair,-3.65,0.00,EUR,COMPLETED,647.12
Transfer,Current,2025-09-06 11:18:51,2025-09-06 11:18:51,To Instant Access Savings,-5.00,0.00,EUR,COMPLETED,642.12
Card Payment,Current,2025-09-05 17:11:42,2025-09-06 11:24:03,Applegreen,-71.35,0.00,EUR,COMPLETED,570.77
Transfer,Current,2025-09-06 15:13:34,2025-09-06 15:13:35,Transfer from DAVID KEVIN SMYTH,40.00,0.00,EUR,COMPLETED,610.77
Card Payment,Current,2025-09-06 11:18:50,2025-09-07 10:46:30,Sodalicious Castletro,-99.00,0.00,EUR,COMPLETED,511.77
Transfer,Current,2025-09-07 11:41:03,2025-09-07 11:41:03,To Instant Access Savings,-0.50,0.00,EUR,COMPLETED,511.27
Transfer,Current,2025-09-07 13:29:18,2025-09-07 13:29:18,Transfer to DAVID KEVIN SMYTH,-15.00,0.00,EUR,COMPLETED,496.27
Transfer,Current,2025-09-07 15:39:12,2025-09-07 15:39:16,Transfer to MARA DI RAIMONDO,-1.30,0.00,EUR,COMPLETED,494.97
Transfer,Current,2025-09-07 16:10:55,2025-09-07 16:10:55,To Instant Access Savings,-3.75,0.00,EUR,COMPLETED,491.22
Transfer,Current,2025-09-07 16:11:31,2025-09-07 16:11:32,Transfer from PATRICIA QUISH,75.25,0.00,EUR,COMPLETED,566.47
Transfer,Current,2025-09-08 13:08:40,2025-09-08 13:08:40,To Instant Access Savings,-5.00,0.00,EUR,COMPLETED,561.47
Transfer,Current,2025-09-08 13:25:03,2025-09-08 13:25:03,To Instant Access Savings,-2.00,0.00,EUR,COMPLETED,559.47
Card Payment,Current,2025-09-07 16:10:55,2025-09-08 13:34:39,Just Eat,-75.25,0.00,EUR,COMPLETED,484.22
Card Payment,Current,2025-09-07 11:41:03,2025-09-08 14:16:11,Centra,-15.90,0.00,EUR,COMPLETED,468.32
Transfer,Current,2025-09-09 08:47:48,2025-09-09 08:47:48,From Instant Access Savings,1600.00,0.00,EUR,COMPLETED,2068.32
Card Payment,Current,2025-09-08 13:25:02,2025-09-09 11:29:26,Lidl,-49.60,0.00,EUR,COMPLETED,2018.72
Card Payment,Current,2025-09-08 13:08:39,2025-09-09 11:37:22,Applegreen,-8.00,0.00,EUR,COMPLETED,2010.72
Transfer,Current,2025-09-09 13:42:29,2025-09-09 13:42:29,To Instant Access Savings,-5.00,0.00,EUR,COMPLETED,2005.72
Transfer,Current,2025-09-09 15:57:16,2025-09-09 15:57:16,To Instant Access Savings,-1.90,0.00,EUR,COMPLETED,2003.82
Transfer,Current,2025-09-09 16:01:24,2025-09-09 16:01:24,To Instant Access Savings,-5.00,0.00,EUR,COMPLETED,1998.82
Transfer,Current,2025-09-09 16:54:28,2025-09-09 16:54:28,To Instant Access Savings,-3.20,0.00,EUR,COMPLETED,1995.62
Transfer,Current,2025-09-09 16:54:38,2025-09-09 16:54:38,To Instant Access Savings,-5.00,0.00,EUR,COMPLETED,1990.62
Card Refund,Current,2025-09-10 01:00:00,2025-09-10 08:39:17,Ticketmaster,81.00,0.00,EUR,COMPLETED,2071.62
Card Payment,Current,2025-09-09 15:57:16,2025-09-10 08:58:44,GoMo,-11.62,0.00,EUR,COMPLETED,2060.00
Transfer,Current,2025-09-10 09:34:04,2025-09-10 09:34:04,To Instant Access Savings,-0.60,0.00,EUR,COMPLETED,2059.40
Card Payment,Current,2025-09-09 16:54:38,2025-09-10 10:52:24,Cut and Sew,-35.00,0.00,EUR,COMPLETED,2024.40
Card Payment,Current,2025-09-09 13:42:28,2025-09-10 11:27:17,OpenAI,-23.00,0.00,EUR,COMPLETED,2001.40
Card Payment,Current,2025-09-09 16:54:28,2025-09-10 11:32:00,Strike Pay,-5.36,0.00,EUR,COMPLETED,1996.04
Transfer,Current,2025-09-10 11:53:09,2025-09-10 11:53:09,Transfer from MARA DI RAIMONDO,11.44,0.00,EUR,COMPLETED,2007.48
Card Payment,Current,2025-09-09 16:01:23,2025-09-10 11:56:58,Onlinedonation,-10.00,0.00,EUR,COMPLETED,1997.48
Transfer,Current,2025-09-10 12:22:08,2025-09-10 12:22:09,Transfer from MARA DI RAIMONDO,10.00,0.00,EUR,COMPLETED,2007.48
Transfer,Current,2025-09-10 13:18:22,2025-09-10 13:18:22,Transfer to MARA DI RAIMONDO,-5.47,0.00,EUR,COMPLETED,2002.01
Transfer,Current,2025-09-10 17:22:35,2025-09-10 17:22:35,To Instant Access Savings,-3.60,0.00,EUR,COMPLETED,1998.41
Transfer,Current,2025-09-10 17:33:17,2025-09-10 17:33:17,Transfer from JOHN DANIEL KIELY,272.00,0.00,EUR,COMPLETED,2270.41
Transfer,Current,2025-09-11 07:07:17,2025-09-11 07:07:17,To EUR,-294.00,0.00,EUR,COMPLETED,1976.41
Transfer,Current,2025-09-11 07:55:06,2025-09-11 07:55:06,To Instant Access Savings,-5.00,0.00,EUR,COMPLETED,1971.41
Transfer,Current,2025-09-11 08:35:21,2025-09-11 08:35:21,To Instant Access Savings,-2.00,0.00,EUR,COMPLETED,1969.41
Card Payment,Current,2025-09-10 17:22:34,2025-09-11 10:46:58,Parking Payments,-3.28,0.00,EUR,COMPLETED,1966.13
Card Payment,Current,2025-09-10 09:34:04,2025-09-11 11:15:25,Lidl,-22.88,0.00,EUR,COMPLETED,1943.25
Transfer,Current,2025-09-11 01:00:00,2025-09-11 11:43:23,To Bankinter SA Ireland Branch,-1649.75,0.00,EUR,COMPLETED,293.50
Transfer,Current,2025-09-11 18:22:29,2025-09-11 18:22:29,To Instant Access Savings,-5.00,0.00,EUR,COMPLETED,288.50
Transfer,Current,2025-09-12 08:43:47,2025-09-12 08:43:47,To Instant Access Savings,-3.00,0.00,EUR,COMPLETED,285.50
Card Payment,Current,2025-09-11 18:22:28,2025-09-12 09:34:43,Sushida,-50.00,0.00,EUR,COMPLETED,235.50
Card Payment,Current,2025-09-11 07:55:06,2025-09-12 10:45:19,Transport for Ireland - TFI,-40.00,0.00,EUR,COMPLETED,195.50
Card Payment,Current,2025-09-11 08:35:20,2025-09-12 12:22:33,Centra,-3.60,0.00,EUR,COMPLETED,191.90
Transfer,Current,2025-09-12 19:24:54,2025-09-12 19:24:55,Transfer to Andrew James Fullen,-17.50,0.00,EUR,COMPLETED,174.40
Transfer,Current,2025-09-13 07:55:41,2025-09-13 07:55:41,To Instant Access Savings,-0.05,0.00,EUR,COMPLETED,174.35
Transfer,Current,2025-09-13 12:09:08,2025-09-13 12:09:08,To Instant Access Savings,-1.00,0.00,EUR,COMPLETED,173.35
Transfer,Current,2025-09-13 12:15:30,2025-09-13 12:15:32,To Instant Access Savings,-5.00,0.00,EUR,COMPLETED,168.35
Transfer,Current,2025-09-13 14:58:55,2025-09-13 14:58:56,To Instant Access Savings,-2.00,0.00,EUR,COMPLETED,166.35
Card Payment,Current,2025-09-12 08:43:46,2025-09-13 15:19:11,McDonald's,-8.40,0.00,EUR,COMPLETED,157.95
Transfer,Current,2025-09-13 15:54:19,2025-09-13 15:54:19,From Instant Access Savings,50.00,0.00,EUR,COMPLETED,207.95
Transfer,Current,2025-09-13 15:54:36,2025-09-13 15:54:36,To Instant Access Savings,-1.00,0.00,EUR,COMPLETED,206.95
Card Payment,Current,2025-09-13 07:55:41,2025-09-14 09:15:26,Apple,-119.99,0.00,EUR,COMPLETED,86.96
Transfer,Current,2025-09-14 10:27:24,2025-09-14 10:27:24,To Instant Access Savings,-4.25,0.00,EUR,COMPLETED,82.71
Transfer,Current,2025-09-14 10:52:32,2025-09-14 10:52:32,From Instant Access Savings,70.00,0.00,EUR,COMPLETED,152.71
Transfer,Current,2025-09-14 10:54:26,2025-09-14 10:54:26,To Instant Access Savings,-3.60,0.00,EUR,COMPLETED,149.11
Card Payment,Current,2025-09-13 12:15:30,2025-09-14 14:54:06,Herberton Leisure,-30.00,0.00,EUR,COMPLETED,119.11
Card Payment,Current,2025-09-13 14:58:55,2025-09-14 15:05:49,Parking Payments,-1.60,0.00,EUR,COMPLETED,117.51
Card Payment,Current,2025-09-13 12:09:07,2025-09-14 15:07:27,Parking Payments,-2.80,0.00,EUR,COMPLETED,114.71
Card Payment,Current,2025-09-13 15:54:36,2025-09-14 15:07:29,Parking Payments,-1.80,0.00,EUR,COMPLETED,112.91
Card Payment,Current,2025-09-13 13:43:10,2025-09-14 15:20:52,The Hot Box Sauna,-3.00,0.00,EUR,COMPLETED,109.91
Card Payment,Current,2025-09-14 10:27:24,2025-09-15 09:42:03,Tesco,-12.15,0.00,EUR,COMPLETED,97.76
Card Payment,Current,2025-09-14 10:54:25,2025-09-15 10:39:05,Lidl,-54.28,0.00,EUR,COMPLETED,43.48
Transfer,Current,2025-09-15 13:17:06,2025-09-15 13:17:06,To Instant Access Savings,-2.45,0.00,EUR,COMPLETED,41.03
Card Payment,Current,2025-09-15 13:17:05,2025-09-16 16:42:43,Amazon,-4.51,0.00,EUR,COMPLETED,36.52
Transfer,Current,2025-09-16 21:38:42,2025-09-16 21:38:42,From Instant Access Savings,100.00,0.00,EUR,COMPLETED,136.52
Transfer,Current,2025-09-16 21:38:55,2025-09-16 21:38:56,To Instant Access Savings,-5.00,0.00,EUR,COMPLETED,131.52
Transfer,Current,2025-09-16 21:58:08,2025-09-16 21:58:09,Transfer from CONOR NAYLOR,50.00,0.00,EUR,COMPLETED,181.52
Transfer,Current,2025-09-16 22:16:54,2025-09-16 22:16:55,To Instant Access Savings,-4.30,0.00,EUR,COMPLETED,177.22
Transfer,Current,2025-09-16 22:18:42,2025-09-16 22:18:42,Transfer from MARA DI RAIMONDO,12.00,0.00,EUR,COMPLETED,189.22
Transfer,Current,2025-09-16 22:19:00,2025-09-16 22:19:00,Transfer from MARA DI RAIMONDO,25.14,0.00,EUR,COMPLETED,214.36
Transfer,Current,2025-09-16 23:00:06,2025-09-16 23:00:06,To Instant Access Savings,-4.00,0.00,EUR,COMPLETED,210.36
Card Payment,Current,2025-09-16 21:38:55,2025-09-17 13:51:16,Yoi Ramen,-90.00,0.00,EUR,COMPLETED,120.36
Card Payment,Current,2025-09-16 23:00:06,2025-09-17 14:14:31,FREE NOW,-17.20,0.00,EUR,COMPLETED,103.16
Transfer,Current,2025-09-17 18:46:10,2025-09-17 18:46:10,Transfer to Revolut user,-16.00,0.00,EUR,COMPLETED,87.16
Transfer,Current,2025-09-17 18:46:15,2025-09-17 18:46:16,Transfer to Revolut user,-16.00,0.00,EUR,COMPLETED,71.16
Transfer,Current,2025-09-18 08:28:14,2025-09-18 08:28:14,To Instant Access Savings,-2.50,0.00,EUR,COMPLETED,68.66
Card Payment,Current,2025-09-16 22:16:54,2025-09-18 14:00:30,Amazon,-25.14,0.00,EUR,COMPLETED,43.52
Transfer,Current,2025-09-18 14:34:09,2025-09-18 14:34:09,Transfer from MARA DI RAIMONDO,26.00,0.00,EUR,COMPLETED,69.52
Transfer,Current,2025-09-18 14:34:20,2025-09-18 14:34:20,Transfer from MARA DI RAIMONDO,16.00,0.00,EUR,COMPLETED,85.52
Transfer,Current,2025-09-18 14:34:59,2025-09-18 14:35:00,Transfer from MARA DI RAIMONDO,10.78,0.00,EUR,COMPLETED,96.30
Transfer,Current,2025-09-18 18:26:13,2025-09-18 18:26:13,Transfer from CONOR NAYLOR,64.56,0.00,EUR,COMPLETED,160.86
Transfer,Current,2025-09-18 19:18:11,2025-09-18 19:18:11,Transfer to MARA DI RAIMONDO,-7.60,0.00,EUR,COMPLETED,153.26
Transfer,Current,2025-09-18 19:19:34,2025-09-18 19:19:35,To Instant Access Savings,-5.00,0.00,EUR,COMPLETED,148.26
Transfer,Current,2025-09-19 08:56:38,2025-09-19 08:56:38,To Instant Access Savings,-2.00,0.00,EUR,COMPLETED,146.26
Card Payment,Current,2025-09-18 08:28:13,2025-09-19 10:11:36,Copper + Straw,-9.50,0.00,EUR,COMPLETED,136.76
Card Payment,Current,2025-09-18 19:19:34,2025-09-20 09:22:37,The Merry Cobbler,-55.00,0.00,EUR,COMPLETED,81.76
Transfer,Current,2025-09-20 11:05:34,2025-09-20 11:05:34,To Instant Access Savings,-4.50,0.00,EUR,COMPLETED,77.26
Card Payment,Current,2025-09-19 08:56:38,2025-09-20 15:51:54,Centra,-3.60,0.00,EUR,COMPLETED,73.66
Transfer,Current,2025-09-20 20:52:45,2025-09-20 20:52:46,From Instant Access Savings,71.00,0.00,EUR,COMPLETED,144.66
Transfer,Current,2025-09-20 20:52:45,2025-09-20 20:52:46,Transfer to EMMA SADBH MURPHY,-71.00,0.00,EUR,COMPLETED,73.66
Transfer,Current,2025-09-20 21:27:52,2025-09-20 21:27:52,To Instant Access Savings,-5.00,0.00,EUR,COMPLETED,68.66
Transfer,Current,2025-09-20 22:45:36,2025-09-20 22:45:36,To Instant Access Savings,-2.00,0.00,EUR,COMPLETED,66.66
Card Payment,Current,2025-09-20 11:05:33,2025-09-21 08:54:57,Gleesons,-3.10,0.00,EUR,COMPLETED,63.56
Transfer,Current,2025-09-21 10:47:52,2025-09-21 10:47:52,To Instant Access Savings,-1.00,0.00,EUR,COMPLETED,62.56
Transfer,Current,2025-09-21 11:11:10,2025-09-21 11:11:11,To Instant Access Savings,-1.85,0.00,EUR,COMPLETED,60.71
Transfer,Current,2025-09-21 13:06:10,2025-09-21 13:06:10,From Instant Access Savings,100.00,0.00,EUR,COMPLETED,160.71
Transfer,Current,2025-09-21 13:06:21,2025-09-21 13:06:21,To Instant Access Savings,-5.00,0.00,EUR,COMPLETED,155.71
Card Payment,Current,2025-09-20 21:27:51,2025-09-21 14:11:49,International Bar,-11.00,0.00,EUR,COMPLETED,144.71
Card Payment,Current,2025-09-20 22:45:35,2025-09-21 14:12:02,International Bar,-11.60,0.00,EUR,COMPLETED,133.11
Exchange,Current,2025-09-21 14:48:44,2025-09-21 14:48:44,Exchanged to GBP,-58.64,0.00,EUR,COMPLETED,74.47
Transfer,Current,2025-09-21 15:44:41,2025-09-21 15:44:41,To Instant Access Savings,-5.00,0.00,EUR,COMPLETED,69.47
Transfer,Current,2025-09-21 21:58:34,2025-09-21 21:58:34,From Instant Access Savings,88.00,0.00,EUR,COMPLETED,157.47
Transfer,Current,2025-09-21 21:58:47,2025-09-21 21:58:47,To Instant Access Savings,-2.40,0.00,EUR,COMPLETED,155.07
Transfer,Current,2025-09-22 09:09:08,2025-09-22 09:09:08,To Instant Access Savings,-2.00,0.00,EUR,COMPLETED,153.07
Card Payment,Current,2025-09-21 13:06:21,2025-09-22 10:31:24,Ballyogan Recycling Park,-30.00,0.00,EUR,COMPLETED,123.07
Card Payment,Current,2025-09-21 10:47:51,2025-09-22 11:03:29,Mint,-12.80,0.00,EUR,COMPLETED,110.27
Card Payment,Current,2025-09-21 15:44:41,2025-09-22 11:31:15,Payzone,-10.00,0.00,EUR,COMPLETED,100.27
Card Payment,Current,2025-09-21 11:11:10,2025-09-22 11:32:41,SuperValu,-11.63,0.00,EUR,COMPLETED,88.64
Card Payment,Current,2025-09-21 21:58:46,2025-09-22 14:09:01,Amazon,-5.52,0.00,EUR,COMPLETED,83.12
Transfer,Current,2025-09-23 08:12:41,2025-09-23 08:12:41,To Instant Access Savings,-2.00,0.00,EUR,COMPLETED,81.12
Card Payment,Current,2025-09-22 09:09:07,2025-09-23 18:10:29,Centra,-3.60,0.00,EUR,COMPLETED,77.52
Transfer,Current,2025-09-24 01:00:00,2025-09-24 11:44:39,eFlow,-5.83,0.00,EUR,COMPLETED,71.69
Card Payment,Current,2025-09-23 08:12:41,2025-09-24 15:18:05,WHSmith,-14.60,0.00,EUR,COMPLETED,57.09
Transfer,Current,2025-09-24 20:08:45,2025-09-24 20:08:45,To Instant Access Savings,-0.10,0.00,EUR,COMPLETED,56.99
Transfer,Current,2025-09-25 03:00:46,2025-09-25 03:00:46,To Instant Access Savings,-5.00,0.00,EUR,COMPLETED,51.99
Topup,Current,2025-09-25 07:49:35,2025-09-25 07:49:35,Payment from WORKDAY LIMITED,3015.98,0.00,EUR,COMPLETED,3067.97
Transfer,Current,2025-09-25 07:50:05,2025-09-25 07:50:05,To EUR,-1686.22,0.00,EUR,COMPLETED,1381.75
Transfer,Current,2025-09-25 08:28:35,2025-09-25 08:50:50,To Payward Ireland Ltd.,-125.00,0.00,EUR,COMPLETED,1256.75
Transfer,Current,2025-09-25 08:28:34,2025-09-25 08:50:50,To Trading 212 UK Limited,-750.00,0.00,EUR,COMPLETED,506.75
Card Payment,Current,2025-09-25 03:00:45,2025-09-25 10:11:21,DSPCA,-15.00,0.00,EUR,COMPLETED,491.75
Transfer,Current,2025-09-25 01:00:00,2025-09-25 14:13:36,Royal London,-16.72,0.00,EUR,COMPLETED,475.03
Transfer,Current,2025-09-25 19:53:23,2025-09-25 19:53:23,To Instant Access Savings,-1.75,0.00,EUR,COMPLETED,473.28
Card Payment,Current,2025-09-24 20:08:44,2025-09-25 20:15:34,7-Eleven,-4.98,0.00,EUR,COMPLETED,468.30
Transfer,Current,2025-09-26 18:43:14,2025-09-26 18:43:14,To Instant Access Savings,-0.80,0.00,EUR,COMPLETED,467.50
Transfer,Current,2025-09-26 19:06:03,2025-09-26 19:06:04,Transfer from MARA DI RAIMONDO,53.42,0.00,EUR,COMPLETED,520.92
Card Payment,Current,2025-09-25 19:53:22,2025-09-26 20:05:19,Do Hospitality Concept,-41.65,0.00,EUR,COMPLETED,479.27
Transfer,Current,2025-09-27 10:46:25,2025-09-27 10:46:25,To Instant Access Savings,-5.00,0.00,EUR,COMPLETED,474.27
Transfer,Current,2025-09-27 12:11:23,2025-09-27 12:11:24,Transfer from MARA DI RAIMONDO,550.00,0.00,EUR,COMPLETED,1024.27
Transfer,Current,2025-09-27 12:12:09,2025-09-27 12:12:09,Transfer from MARA DI RAIMONDO,13.00,0.00,EUR,COMPLETED,1037.27
Transfer,Current,2025-09-27 12:12:31,2025-09-27 12:12:32,To Instant Access Savings,-0.25,0.00,EUR,COMPLETED,1037.02
Transfer,Current,2025-09-27 16:07:01,2025-09-27 16:07:01,To Instant Access Savings,-0.10,0.00,EUR,COMPLETED,1036.92
Transfer,Current,2025-09-27 19:55:42,2025-09-27 19:55:42,To Instant Access Savings,-2.50,0.00,EUR,COMPLETED,1034.42
Transfer,Current,2025-09-28 00:34:17,2025-09-28 00:34:17,To Instant Access Savings,-0.05,0.00,EUR,COMPLETED,1034.37
Card Payment,Current,2025-09-27 16:07:00,2025-09-28 10:14:22,Eurowings,-263.98,0.00,EUR,COMPLETED,770.39
Transfer,Current,2025-09-28 10:16:56,2025-09-28 10:16:56,To Instant Access Savings,-1.05,0.00,EUR,COMPLETED,769.34
Card Payment,Current,2025-09-28 00:34:17,2025-09-28 10:54:18,Apple,-9.99,0.00,EUR,COMPLETED,759.35
Transfer,Current,2025-09-28 13:19:33,2025-09-28 13:19:33,To Instant Access Savings,-1.75,0.00,EUR,COMPLETED,757.60
Transfer,Current,2025-09-28 15:55:15,2025-09-28 15:55:16,To Instant Access Savings,-1.25,0.00,EUR,COMPLETED,756.35
Transfer,Current,2025-09-28 15:58:39,2025-09-28 15:58:40,Transfer from MARA DI RAIMONDO,87.75,0.00,EUR,COMPLETED,844.10
Transfer,Current,2025-09-28 15:58:54,2025-09-28 15:58:54,Transfer from MARA DI RAIMONDO,16.95,0.00,EUR,COMPLETED,861.05
Transfer,Current,2025-09-28 15:58:58,2025-09-28 15:58:59,Transfer from MARA DI RAIMONDO,10.00,0.00,EUR,COMPLETED,871.05
Card Payment,Current,2025-09-26 18:43:14,2025-09-28 18:46:56,YUNO,-106.84,0.00,EUR,COMPLETED,764.21
Card Payment,Current,2025-09-27 19:55:41,2025-09-28 19:30:39,Movies@,-4.50,0.00,EUR,COMPLETED,759.71
Card Payment,Current,2025-09-27 10:46:25,2025-09-28 19:38:37,Lidl,-46.00,0.00,EUR,COMPLETED,713.71
Transfer,Current,2025-09-29 08:55:14,2025-09-29 08:55:14,Transfer to MARA DI RAIMONDO,-4.24,0.00,EUR,COMPLETED,709.47
Card Payment,Current,2025-09-27 12:12:31,2025-09-29 10:34:22,Movies@,-28.95,0.00,EUR,COMPLETED,680.52
Card Payment,Current,2025-09-28 13:19:33,2025-09-29 12:16:40,Hatch Coffee,-17.65,0.00,EUR,COMPLETED,662.87
Card Payment,Current,2025-09-28 10:16:56,2025-09-29 14:28:49,Amazon,-36.79,0.00,EUR,COMPLETED,626.08
Transfer,Current,2025-09-29 19:41:44,2025-09-29 19:41:44,To Instant Access Savings,-0.15,0.00,EUR,COMPLETED,625.93
Transfer,Current,2025-09-29 20:20:19,2025-09-29 20:20:19,To Instant Access Savings,-4.70,0.00,EUR,COMPLETED,621.23
Transfer,Current,2025-09-29 20:22:17,2025-09-29 20:22:17,To Instant Access Savings,-5.00,0.00,EUR,COMPLETED,616.23
Transfer,Current,2025-09-30 03:13:25,2025-09-30 03:13:25,To Instant Access Savings,-5.00,0.00,EUR,COMPLETED,611.23
Transfer,Current,2025-09-30 08:31:34,2025-09-30 08:31:34,To Instant Access Savings,-5.00,0.00,EUR,COMPLETED,606.23
Transfer,Current,2025-09-30 09:10:26,2025-09-30 09:10:26,To Instant Access Savings,-0.65,0.00,EUR,COMPLETED,605.58
Card Payment,Current,2025-09-29 20:22:17,2025-09-30 09:46:50,IKEA,-99.00,0.00,EUR,COMPLETED,506.58
Transfer,Current,2025-09-30 10:47:50,2025-09-30 10:47:51,Transfer from MARA DI RAIMONDO,38.99,0.00,EUR,COMPLETED,545.57
Card Payment,Current,2025-09-29 20:20:18,2025-09-30 18:42:59,Amazon,-94.06,0.00,EUR,COMPLETED,451.51
Transfer,Current,2025-09-30 23:19:10,2025-09-30 23:19:10,From Instant Access Savings,550.00,0.00,EUR,COMPLETED,1001.51
Transfer,Current,2025-09-30 23:19:19,2025-09-30 23:19:20,Transfer to MARA DI RAIMONDO,-550.00,0.00,EUR,COMPLETED,451.51
Transfer,Current,2025-10-01 08:53:44,2025-10-01 08:53:44,To Instant Access Savings,-0.05,0.00,EUR,COMPLETED,451.46
Transfer,Current,2025-10-01 09:01:00,2025-10-01 09:01:00,To Instant Access Savings,-2.00,0.00,EUR,COMPLETED,449.46
Card Payment,Current,2025-09-30 03:13:25,2025-10-01 10:04:42,FLYEfit,-37.00,0.00,EUR,COMPLETED,412.46
Card Payment,Current,2025-09-30 08:31:33,2025-10-01 10:10:01,Applegreen,-12.00,0.00,EUR,COMPLETED,400.46
Card Payment,Current,2025-09-29 19:41:43,2025-10-01 13:42:06,YUNO,-77.97,0.00,EUR,COMPLETED,322.49
Card Payment,Current,2025-09-30 09:10:25,2025-10-01 14:12:40,Lidl,-40.87,0.00,EUR,COMPLETED,281.62
Card Payment,Current,2025-09-28 15:55:15,2025-10-01 15:13:47,Amazon,-87.75,0.00,EUR,COMPLETED,193.87
Transfer,Current,2025-10-01 22:19:47,2025-10-01 22:19:47,Transfer from MARA DI RAIMONDO,70.00,0.00,EUR,COMPLETED,263.87
Transfer,Current,2025-10-02 08:36:53,2025-10-02 08:36:53,To Instant Access Savings,-2.00,0.00,EUR,COMPLETED,261.87
Card Payment,Current,2025-10-01 08:53:44,2025-10-02 10:41:37,Holland & Barrett,-8.99,0.00,EUR,COMPLETED,252.88
Card Payment,Current,2025-10-01 09:00:59,2025-10-02 11:41:32,Centra,-3.60,0.00,EUR,COMPLETED,249.28
Transfer,Current,2025-10-02 11:48:25,2025-10-02 11:48:25,To Instant Access Savings,-1.05,0.00,EUR,COMPLETED,248.23
Transfer,Current,2025-10-02 17:54:09,2025-10-02 17:54:10,To Instant Access Savings,-2.50,0.00,EUR,COMPLETED,245.73
Transfer,Current,2025-10-02 18:01:27,2025-10-02 18:01:27,To Instant Access Savings,-5.00,0.00,EUR,COMPLETED,240.73
Transfer,Current,2025-10-02 20:37:49,2025-10-02 20:37:49,To Instant Access Savings,-0.75,0.00,EUR,COMPLETED,239.98
Transfer,Current,2025-10-02 20:59:10,2025-10-02 20:59:10,To Instant Access Savings,-0.05,0.00,EUR,COMPLETED,239.93
Transfer,Current,2025-10-03 08:35:08,2025-10-03 08:35:08,To Instant Access Savings,-0.25,0.00,EUR,COMPLETED,239.68
Card Payment,Current,2025-10-02 20:37:49,2025-10-03 09:12:08,Gleesons,-41.85,0.00,EUR,COMPLETED,197.83
Card Payment,Current,2025-10-02 20:59:10,2025-10-03 09:51:08,Spotify,-19.99,0.00,EUR,COMPLETED,177.84
Card Payment,Current,2025-10-02 17:54:09,2025-10-03 09:52:08,Centra,-8.50,0.00,EUR,COMPLETED,169.34
Card Payment,Current,2025-10-02 08:36:52,2025-10-03 09:52:12,Centra,-3.60,0.00,EUR,COMPLETED,165.74
Card Payment,Current,2025-10-02 11:48:25,2025-10-03 10:06:04,HP,-1.79,0.00,EUR,COMPLETED,163.95
Card Payment,Current,2025-10-02 18:01:27,2025-10-03 14:11:23,Arnotts,-70.00,0.00,EUR,COMPLETED,93.95
Transfer,Current,2025-10-03 16:58:03,2025-10-03 16:58:03,To Instant Access Savings,-0.05,0.00,EUR,COMPLETED,93.90
Transfer,Current,2025-10-03 19:12:46,2025-10-03 19:12:46,To Instant Access Savings,-2.80,0.00,EUR,COMPLETED,91.10
Transfer,Current,2025-10-04 10:11:48,2025-10-04 10:11:49,To Instant Access Savings,-0.05,0.00,EUR,COMPLETED,91.05
Card Payment,Current,2025-10-03 19:12:46,2025-10-04 10:30:43,Lidl,-16.44,0.00,EUR,COMPLETED,74.61
Card Payment,Current,2025-10-03 16:58:02,2025-10-04 10:32:42,Apple,-9.99,0.00,EUR,COMPLETED,64.62
Card Payment,Current,2025-10-03 08:35:08,2025-10-04 10:44:52,Applegreen,-6.95,0.00,EUR,COMPLETED,57.67
Transfer,Current,2025-10-04 10:53:52,2025-10-04 10:53:52,To Instant Access Savings,-3.15,0.00,EUR,COMPLETED,54.52
Transfer,Current,2025-10-04 13:58:54,2025-10-04 13:58:54,From Instant Access Savings,100.00,0.00,EUR,COMPLETED,154.52
Transfer,Current,2025-10-04 14:01:47,2025-10-04 14:01:47,To Instant Access Savings,-3.25,0.00,EUR,COMPLETED,151.27
Transfer,Current,2025-10-04 19:13:39,2025-10-04 19:13:39,To Instant Access Savings,-3.70,0.00,EUR,COMPLETED,147.57
Transfer,Current,2025-10-04 22:08:47,2025-10-04 22:08:47,Transfer from MARA DI RAIMONDO,20.00,0.00,EUR,COMPLETED,167.57
Transfer,Current,2025-10-05 10:15:12,2025-10-05 10:15:12,To Instant Access Savings,-5.00,0.00,EUR,COMPLETED,162.57
Transfer,Current,2025-10-05 12:04:30,2025-10-05 12:04:30,To Instant Access Savings,-0.80,0.00,EUR,COMPLETED,161.77
Card Payment,Current,2025-10-04 14:01:46,2025-10-05 12:05:41,Cinnamon,-42.35,0.00,EUR,COMPLETED,119.42
Transfer,Current,2025-10-05 12:14:06,2025-10-05 12:14:06,To Instant Access Savings,-1.50,0.00,EUR,COMPLETED,117.92
Card Payment,Current,2025-10-04 19:13:38,2025-10-05 12:48:08,Lidl,-21.26,0.00,EUR,COMPLETED,96.66
Card Payment,Current,2025-10-04 10:53:52,2025-10-05 13:26:21,Amazon,-10.37,0.00,EUR,COMPLETED,86.29
Card Payment,Current,2025-10-04 10:11:48,2025-10-05 13:31:02,YouTube,-13.99,0.00,EUR,COMPLETED,72.30
Transfer,Current,2025-10-05 13:52:14,2025-10-05 13:52:14,To Instant Access Savings,-2.80,0.00,EUR,COMPLETED,69.50
Transfer,Current,2025-10-05 18:33:21,2025-10-05 18:33:21,From Instant Access Savings,100.00,0.00,EUR,COMPLETED,169.50
Transfer,Current,2025-10-05 18:34:09,2025-10-05 18:34:09,To Instant Access Savings,-0.05,0.00,EUR,COMPLETED,169.45
Card Payment,Current,2025-10-05 12:04:29,2025-10-06 10:32:58,Lidl,-26.84,0.00,EUR,COMPLETED,142.61
Transfer,Current,2025-10-06 11:21:53,2025-10-06 11:21:53,Transfer from MARA DI RAIMONDO,9.44,0.00,EUR,COMPLETED,152.05
Transfer,Current,2025-10-06 11:21:54,2025-10-06 11:21:54,Transfer to MARA DI RAIMONDO,-22.49,0.00,EUR,COMPLETED,129.56
Card Payment,Current,2025-10-05 10:15:11,2025-10-06 11:32:48,FLYEfit,-14.00,0.00,EUR,COMPLETED,115.56
Card Payment,Current,2025-10-05 12:14:05,2025-10-06 11:53:58,Circle K Gas Station,-3.70,0.00,EUR,COMPLETED,111.86
Card Payment,Current,2025-10-05 18:34:09,2025-10-07 11:48:58,Steam,-28.99,0.00,EUR,COMPLETED,82.87
Card Payment,Current,2025-10-05 13:52:14,2025-10-07 13:38:17,Amazon,-9.44,0.00,EUR,COMPLETED,73.43
Exchange,Current,2025-10-07 16:54:52,2025-10-07 16:54:52,Exchanged to EUR,6243.82,0.00,EUR,COMPLETED,6317.25
Transfer,Current,2025-10-07 16:54:58,2025-10-07 16:54:58,To EUR,-487.18,0.00,EUR,COMPLETED,5830.07
Transfer,Current,2025-10-07 16:55:11,2025-10-07 16:55:11,To Instant Access Savings,-5530.00,0.00,EUR,COMPLETED,300.07
Transfer,Current,2025-10-07 19:04:44,2025-10-07 19:04:44,Transfer to MARA DI RAIMONDO,-14.87,0.00,EUR,COMPLETED,285.20
Transfer,Current,2025-10-07 19:04:49,2025-10-07 19:04:50,Transfer to MARA DI RAIMONDO,-5.99,0.00,EUR,COMPLETED,279.21
Transfer,Current,2025-10-07 19:05:06,2025-10-07 19:05:06,Transfer to MARA DI RAIMONDO,-57.50,0.00,EUR,COMPLETED,221.71
Transfer,Current,2025-10-07 20:05:25,2025-10-07 20:05:25,Transfer from MARA DI RAIMONDO,90.00,0.00,EUR,COMPLETED,311.71
Card Payment,Current,2025-10-07 20:17:30,,Amazon,-145.17,0.00,EUR,PENDING,
Transfer,Current,2025-10-07 20:17:31,2025-10-07 20:17:31,To Instant Access Savings,-4.15,0.00,EUR,COMPLETED,307.56
Transfer,Current,2025-10-08 07:52:21,2025-10-08 07:52:21,To Instant Access Savings,-5.00,0.00,EUR,COMPLETED,302.56
Transfer,Current,2025-10-08 08:39:47,2025-10-08 08:39:47,To Instant Access Savings,-2.00,0.00,EUR,COMPLETED,300.56
Transfer,Current,2025-10-08 18:01:55,2025-10-08 18:01:55,To Instant Access Savings,-2.50,0.00,EUR,COMPLETED,298.06
Transfer,Current,2025-10-08 20:33:27,2025-10-08 20:33:27,From Instant Access Savings,100.00,0.00,EUR,COMPLETED,398.06
Transfer,Current,2025-10-08 20:35:09,2025-10-08 20:35:09,To Instant Access Savings,-1.35,0.00,EUR,COMPLETED,396.71
Transfer,Current,2025-10-08 20:35:17,2025-10-08 20:35:18,Transfer from MARA DI RAIMONDO,50.00,0.00,EUR,COMPLETED,446.71
Card Payment,Current,2025-10-09 08:33:54,,Applegreen,-12.00,0.00,EUR,PENDING,
Transfer,Current,2025-10-09 08:33:55,2025-10-09 08:33:55,To Instant Access Savings,-5.00,0.00,EUR,COMPLETED,441.71
Card Payment,Current,2025-10-08 18:01:55,2025-10-09 11:45:23,Kehoes Pub,-10.50,0.00,EUR,COMPLETED,431.21
Card Payment,Current,2025-10-08 07:52:20,2025-10-09 12:55:45,Transport for Ireland - TFI,-45.00,0.00,EUR,COMPLETED,386.21
Card Payment,Current,2025-10-08 20:35:08,2025-10-09 13:37:19,Tst Isabelle,-106.73,0.00,EUR,COMPLETED,279.48
Card Payment,Current,2025-10-09 13:44:38,,OpenAI,-23.00,0.00,EUR,PENDING,
Transfer,Current,2025-10-09 13:44:39,2025-10-09 13:44:39,To Instant Access Savings,-5.00,0.00,EUR,COMPLETED,274.48
Card Payment,Current,2025-10-08 08:39:47,2025-10-09 13:55:03,Centra,-3.60,0.00,EUR,COMPLETED,270.88
Card Payment,Current,2025-10-09 16:02:26,,GoMo,-13.50,0.00,EUR,PENDING,
Transfer,Current,2025-10-09 16:02:27,2025-10-09 16:02:27,To Instant Access Savings,-2.50,0.00,EUR,COMPLETED,268.38
Transfer,Pocket,2024-01-26 10:13:00,2024-01-26 10:13:00,To pocket EUR Subscriptions from EUR,500.00,0.00,EUR,COMPLETED,500.50
Transfer,Pocket,2024-01-26 18:10:44,2024-01-26 18:10:44,Pocket Withdrawal,-230.00,0.00,EUR,COMPLETED,270.50
Card Payment,Pocket,2024-01-28 07:28:57,2024-01-29 10:18:13,HP,-0.99,0.00,EUR,COMPLETED,269.51
Transfer,Pocket,2024-01-31 00:00:00,2024-01-31 11:44:57,To Flogas,-90.00,0.00,EUR,COMPLETED,179.51
Transfer,Pocket,2024-02-02 00:00:00,2024-02-02 11:47:07,To Flogas Natural Gas,-115.00,0.00,EUR,COMPLETED,64.51
Card Payment,Pocket,2024-02-02 19:59:13,2024-02-03 10:51:32,Spotify,-17.99,0.00,EUR,COMPLETED,46.52
Card Payment,Pocket,2024-02-07 02:22:44,2024-02-08 11:01:23,FLYEfit,-38.00,0.00,EUR,COMPLETED,8.52
Transfer,Pocket,2024-02-26 14:36:48,2024-02-26 14:36:48,To pocket EUR Subscriptions from EUR,400.00,0.00,EUR,COMPLETED,408.52
Transfer,Pocket,2024-02-29 00:00:00,2024-02-29 11:52:37,To Flogas,-90.00,0.00,EUR,COMPLETED,318.52
Transfer,Pocket,2024-03-01 00:00:00,2024-03-01 11:55:21,To Flogas Natural Gas,-115.00,0.00,EUR,COMPLETED,203.52
Card Payment,Pocket,2024-03-02 19:59:11,2024-03-03 12:12:52,Spotify,-17.99,0.00,EUR,COMPLETED,185.53
Card Payment,Pocket,2024-03-07 02:20:32,2024-03-08 12:41:52,FLYEfit,-38.00,0.00,EUR,COMPLETED,147.53
Transfer,Pocket,2024-03-12 21:46:06,2024-03-12 21:46:06,Pocket Withdrawal,-100.00,0.00,EUR,COMPLETED,47.53
Transfer,Pocket,2024-03-15 06:10:07,2024-03-15 06:10:07,Pocket Withdrawal,-30.00,0.00,EUR,COMPLETED,17.53
Transfer,Pocket,2024-03-25 10:13:19,2024-03-25 10:13:19,To pocket EUR Subscriptions from EUR,350.00,0.00,EUR,COMPLETED,367.53
Transfer,Pocket,2024-03-25 00:00:00,2024-03-25 11:44:14,To Royal London,-16.72,0.00,EUR,COMPLETED,350.81
Transfer,Pocket,2024-04-02 01:00:00,2024-04-02 12:35:00,To Flogas,-90.00,0.00,EUR,COMPLETED,260.81
Card Payment,Pocket,2024-04-02 20:59:09,2024-04-03 11:02:57,Spotify,-17.99,0.00,EUR,COMPLETED,242.82
Transfer,Pocket,2024-04-03 01:00:00,2024-04-03 11:57:48,To Flogas Natural Gas,-115.00,0.00,EUR,COMPLETED,127.82
Card Payment,Pocket,2024-04-07 02:27:36,2024-04-08 12:00:05,FLYEfit,-38.00,0.00,EUR,COMPLETED,89.82
Transfer,Pocket,2024-04-11 01:00:00,2024-04-11 11:43:55,To Virgin Media Ireland Limited,-60.00,0.00,EUR,COMPLETED,29.82
Card Payment,Pocket,2024-04-13 15:37:04,2024-04-14 11:42:40,GoMo,-9.99,0.00,EUR,COMPLETED,19.83
Transfer,Pocket,2024-04-25 01:00:00,2024-04-25 11:45:19,To Royal London,-16.72,0.00,EUR,COMPLETED,3.11
Transfer,Pocket,2024-04-26 12:10:45,2024-04-26 12:10:45,To pocket EUR Subscriptions from EUR,400.00,0.00,EUR,COMPLETED,403.11
Transfer,Pocket,2024-05-02 01:00:00,2024-05-02 11:51:16,To Flogas,-83.82,0.00,EUR,COMPLETED,319.29
Card Payment,Pocket,2024-05-02 20:59:15,2024-05-03 09:39:17,Spotify,-17.99,0.00,EUR,COMPLETED,301.30
Transfer,Pocket,2024-05-03 01:00:00,2024-05-03 11:44:39,To Flogas Natural Gas,-89.51,0.00,EUR,COMPLETED,211.79
Card Payment,Pocket,2024-05-07 02:27:52,2024-05-08 12:29:23,FLYEfit,-38.00,0.00,EUR,COMPLETED,173.79
Transfer,Pocket,2024-05-13 01:00:00,2024-05-13 11:41:06,To Virgin Media Ireland Limited,-60.00,0.00,EUR,COMPLETED,113.79
Transfer,Pocket,2024-05-22 22:09:01,2024-05-22 22:09:01,Pocket Withdrawal,-80.00,0.00,EUR,COMPLETED,33.79
Transfer,Pocket,2024-05-27 09:52:26,2024-05-27 09:52:26,To pocket EUR Subscriptions from EUR,250.00,0.00,EUR,COMPLETED,283.79
Transfer,Pocket,2024-05-27 01:00:00,2024-05-27 11:44:22,To Royal London,-16.72,0.00,EUR,COMPLETED,267.07
Card Payment,Pocket,2024-06-02 20:59:16,2024-06-03 12:04:46,Spotify,-17.99,0.00,EUR,COMPLETED,249.08
Transfer,Pocket,2024-06-04 01:00:00,2024-06-04 11:45:25,To Flogas Natural Gas,-89.51,0.00,EUR,COMPLETED,159.57
Transfer,Pocket,2024-06-04 01:00:00,2024-06-04 11:45:27,To Flogas,-83.82,0.00,EUR,COMPLETED,75.75
Transfer,Pocket,2024-06-06 15:22:09,2024-06-06 15:22:09,To pocket EUR Subscriptions from EUR,50.00,0.00,EUR,COMPLETED,125.75
Card Payment,Pocket,2024-06-07 02:27:08,2024-06-08 17:39:45,FLYEfit,-38.00,0.00,EUR,COMPLETED,87.75
Transfer,Pocket,2024-06-10 01:00:00,2024-06-10 11:47:13,To Flogas,-83.82,0.00,EUR,COMPLETED,3.93
Refund,Pocket,2024-06-17 11:44:48,2024-06-17 11:44:48,Refund To Flogas,83.82,0.00,EUR,COMPLETED,87.75
Transfer,Pocket,2024-06-18 18:31:02,2024-06-18 18:31:02,Pocket Withdrawal,-80.00,0.00,EUR,COMPLETED,7.75
Transfer,Pocket,2024-06-25 11:09:36,2024-06-25 11:09:36,To pocket EUR Subscriptions from EUR,2096.50,0.00,EUR,COMPLETED,2104.25
Transfer,Pocket,2024-06-27 01:05:27,2024-06-27 01:05:27,Pocket Withdrawal,-100.00,0.00,EUR,COMPLETED,2004.25
Card Payment,Pocket,2024-06-26 16:53:26,2024-06-27 10:08:21,Transport for Ireland - TFI,-40.00,0.00,EUR,COMPLETED,1964.25
Transfer,Pocket,2024-06-29 19:56:20,2024-06-29 19:56:20,Pocket Withdrawal,-300.00,0.00,EUR,COMPLETED,1664.25
Transfer,Pocket,2024-06-29 20:01:18,2024-06-29 20:01:18,Pocket Withdrawal,-100.00,0.00,EUR,COMPLETED,1564.25
Transfer,Pocket,2024-06-29 22:08:55,2024-06-29 22:08:55,Pocket Withdrawal,-100.00,0.00,EUR,COMPLETED,1464.25
Transfer,Pocket,2024-06-30 14:14:43,2024-06-30 14:14:43,Pocket Withdrawal,-100.00,0.00,EUR,COMPLETED,1364.25
Transfer,Pocket,2024-07-02 01:00:00,2024-07-02 11:44:07,To Flogas Natural Gas,-89.51,0.00,EUR,COMPLETED,1274.74
Transfer,Pocket,2024-07-02 01:00:00,2024-07-02 11:46:37,To Flogas,-83.82,0.00,EUR,COMPLETED,1190.92
Card Payment,Pocket,2024-07-02 20:59:16,2024-07-03 11:47:01,Spotify,-17.99,0.00,EUR,COMPLETED,1172.93
Card Payment,Pocket,2024-07-03 03:24:58,2024-07-03 16:06:31,Netflix,-14.99,0.00,EUR,COMPLETED,1157.94
Transfer,Pocket,2024-07-05 14:09:32,2024-07-05 14:09:32,Pocket Withdrawal,-100.00,0.00,EUR,COMPLETED,1057.94
Transfer,Pocket,2024-07-06 19:08:39,2024-07-06 19:08:40,Transfer to MARGARET MARY BRENNAN,-40.00,0.00,EUR,COMPLETED,1017.94
Card Payment,Pocket,2024-07-07 01:09:17,2024-07-07 11:39:29,Apple,-29.99,0.00,EUR,COMPLETED,987.95
Transfer,Pocket,2024-07-07 15:16:32,2024-07-07 15:16:32,Pocket Withdrawal,-100.00,0.00,EUR,COMPLETED,887.95
Card Payment,Pocket,2024-07-07 02:27:58,2024-07-08 20:29:35,FLYEfit,-38.00,0.00,EUR,COMPLETED,849.95
Transfer,Pocket,2024-07-09 20:52:16,2024-07-09 20:52:16,Pocket Withdrawal,-100.00,0.00,EUR,COMPLETED,749.95
Transfer,Pocket,2024-07-11 15:53:10,2024-07-11 15:53:10,Pocket Withdrawal,-100.00,0.00,EUR,COMPLETED,649.95
Transfer,Pocket,2024-07-12 01:00:00,2024-07-12 11:45:12,To Virgin Media Ireland Limited,-70.00,0.00,EUR,COMPLETED,579.95
Transfer,Pocket,2024-07-13 08:58:26,2024-07-13 08:58:26,Pocket Withdrawal,-100.00,0.00,EUR,COMPLETED,479.95
Transfer,Pocket,2024-07-13 21:08:57,2024-07-13 21:08:57,Pocket Withdrawal,-100.00,0.00,EUR,COMPLETED,379.95
Transfer,Pocket,2024-07-14 13:18:27,2024-07-14 13:18:27,Pocket Withdrawal,-50.00,0.00,EUR,COMPLETED,329.95
Transfer,Pocket,2024-07-14 14:38:31,2024-07-14 14:38:31,Pocket Withdrawal,-100.00,0.00,EUR,COMPLETED,229.95
Transfer,Pocket,2024-07-16 19:24:17,2024-07-16 19:24:17,Pocket Withdrawal,-100.00,0.00,EUR,COMPLETED,129.95
Transfer,Pocket,2024-07-17 10:56:44,2024-07-17 10:56:44,Pocket Withdrawal,-50.00,0.00,EUR,COMPLETED,79.95
Transfer,Pocket,2024-07-19 08:21:25,2024-07-19 08:21:25,Pocket Withdrawal,-50.00,0.00,EUR,COMPLETED,29.95
Transfer,Pocket,2024-07-19 19:58:11,2024-07-19 19:58:11,Pocket Withdrawal,-29.00,0.00,EUR,COMPLETED,0.95
Transfer,Pocket,2024-07-25 11:12:09,2024-07-25 11:12:09,To pocket EUR Subscriptions from EUR,700.00,0.00,EUR,COMPLETED,700.95
Transfer,Pocket,2024-07-27 18:41:35,2024-07-27 18:41:35,Pocket Withdrawal,-80.00,0.00,EUR,COMPLETED,620.95
Transfer,Pocket,2024-07-27 22:11:56,2024-07-27 22:11:56,Pocket Withdrawal,-80.00,0.00,EUR,COMPLETED,540.95
Transfer,Pocket,2024-07-29 20:03:52,2024-07-29 20:03:52,Pocket Withdrawal,-40.00,0.00,EUR,COMPLETED,500.95
Transfer,Pocket,2024-07-31 13:17:41,2024-07-31 13:17:41,Pocket Withdrawal,-10.00,0.00,EUR,COMPLETED,490.95
Transfer,Pocket,2024-08-01 01:00:00,2024-08-01 11:51:32,To Flogas,-83.82,0.00,EUR,COMPLETED,407.13
Transfer,Pocket,2024-08-02 01:00:00,2024-08-02 11:43:32,To Flogas Natural Gas,-89.51,0.00,EUR,COMPLETED,317.62
Card Payment,Pocket,2024-08-02 20:59:14,2024-08-03 12:00:17,Spotify,-17.99,0.00,EUR,COMPLETED,299.63
Card Payment,Pocket,2024-08-03 03:22:32,2024-08-03 15:11:52,Netflix,-14.99,0.00,EUR,COMPLETED,284.64
Transfer,Pocket,2024-08-03 20:53:51,2024-08-03 20:53:51,Pocket Withdrawal,-84.00,0.00,EUR,COMPLETED,200.64
Transfer,Pocket,2024-08-03 20:58:17,2024-08-03 20:58:17,Pocket Withdrawal,-50.00,0.00,EUR,COMPLETED,150.64
Transfer,Pocket,2024-08-03 23:58:24,2024-08-03 23:58:24,Pocket Withdrawal,-50.00,0.00,EUR,COMPLETED,100.64
Transfer,Pocket,2024-08-07 15:15:34,2024-08-07 15:15:34,To pocket EUR Subscriptions from EUR,40.00,0.00,EUR,COMPLETED,140.64
Card Payment,Pocket,2024-08-07 02:26:52,2024-08-08 11:00:41,FLYEfit,-38.00,0.00,EUR,COMPLETED,102.64
Transfer,Pocket,2024-08-12 01:00:00,2024-08-12 11:45:22,To Virgin Media Ireland Limited,-70.00,0.00,EUR,COMPLETED,32.64
Card Payment,Pocket,2024-08-12 19:23:24,2024-08-13 11:10:10,GoMo,-9.99,0.00,EUR,COMPLETED,22.65
Transfer,Pocket,2024-08-22 18:26:01,2024-08-22 18:26:01,Pocket Withdrawal,-22.65,0.00,EUR,COMPLETED,0.00
Transfer,Pocket,2024-08-25 11:07:16,2024-08-25 11:07:16,To pocket EUR Subscriptions from EUR,700.00,0.00,EUR,COMPLETED,700.00
Transfer,Pocket,2024-08-26 01:00:00,2024-08-26 11:44:44,To Royal London,-16.72,0.00,EUR,COMPLETED,683.28
Transfer,Pocket,2024-08-27 20:52:07,2024-08-27 20:52:07,Pocket Withdrawal,-30.00,0.00,EUR,COMPLETED,653.28
Transfer,Pocket,2024-08-27 20:57:19,2024-08-27 20:57:19,Pocket Withdrawal,-50.00,0.00,EUR,COMPLETED,603.28
Transfer,Pocket,2024-08-28 21:12:55,2024-08-28 21:12:55,Pocket Withdrawal,-150.00,0.00,EUR,COMPLETED,453.28
Transfer,Pocket,2024-08-29 18:55:16,2024-08-29 18:55:16,Pocket Withdrawal,-50.00,0.00,EUR,COMPLETED,403.28
Transfer,Pocket,2024-09-02 01:00:00,2024-09-02 12:24:16,To Flogas,-83.82,0.00,EUR,COMPLETED,319.46
Transfer,Pocket,2024-09-02 01:00:00,2024-09-02 12:24:27,To Flogas Natural Gas,-89.51,0.00,EUR,COMPLETED,229.95
Card Payment,Pocket,2024-09-03 02:37:27,2024-09-03 09:00:19,Netflix,-14.99,0.00,EUR,COMPLETED,214.96
Card Payment,Pocket,2024-09-02 20:59:14,2024-09-03 11:03:46,Spotify,-17.99,0.00,EUR,COMPLETED,196.97
Transfer,Pocket,2024-09-03 11:39:33,2024-09-03 11:39:33,Pocket Withdrawal,-50.00,0.00,EUR,COMPLETED,146.97
Transfer,Pocket,2024-09-08 10:29:18,2024-09-08 10:29:18,Pocket Withdrawal,-50.00,0.00,EUR,COMPLETED,96.97
Card Payment,Pocket,2024-09-07 03:04:19,2024-09-08 11:13:24,FLYEfit,-5.00,0.00,EUR,COMPLETED,91.97
Card Payment,Pocket,2024-09-10 17:19:17,2024-09-11 10:56:40,GoMo,-9.99,0.00,EUR,COMPLETED,81.98
Transfer,Pocket,2024-09-11 01:00:00,2024-09-11 11:43:52,To Virgin Media Ireland Limited,-70.00,0.00,EUR,COMPLETED,11.98
Transfer,Pocket,2024-09-25 11:07:50,2024-09-25 11:07:50,To pocket EUR Subscriptions from EUR,700.00,0.00,EUR,COMPLETED,711.98
Transfer,Pocket,2024-10-01 01:00:00,2024-10-01 12:34:43,To Flogas Natural Gas,-89.51,0.00,EUR,COMPLETED,622.47
Transfer,Pocket,2024-10-01 01:00:00,2024-10-01 12:34:55,To Flogas,-83.82,0.00,EUR,COMPLETED,538.65
Transfer,Pocket,2024-10-02 01:00:00,2024-10-02 11:45:24,To Royal London,-16.72,0.00,EUR,COMPLETED,521.93
Card Payment,Pocket,2024-10-02 20:59:16,2024-10-03 10:38:58,Spotify,-17.99,0.00,EUR,COMPLETED,503.94
Card Payment,Pocket,2024-10-03 02:08:26,2024-10-03 11:32:35,Netflix,-14.99,0.00,EUR,COMPLETED,488.95
Card Payment,Pocket,2024-10-07 03:01:02,2024-10-08 10:36:06,FLYEfit,-5.00,0.00,EUR,COMPLETED,483.95
Transfer,Pocket,2024-10-09 17:50:06,2024-10-09 17:50:06,Pocket Withdrawal,-350.00,0.00,EUR,COMPLETED,133.95
Card Payment,Pocket,2024-10-09 14:54:18,2024-10-10 11:47:05,GoMo,-9.99,0.00,EUR,COMPLETED,123.96
Transfer,Pocket,2024-10-14 01:00:00,2024-10-14 11:43:56,To Virgin Media Ireland Limited,-70.00,0.00,EUR,COMPLETED,53.96
Card Payment,Pocket,2024-10-23 07:30:38,2024-10-24 09:59:49,Transport for Ireland - TFI,-40.00,0.00,EUR,COMPLETED,13.96
Transfer,Pocket,2024-10-25 11:30:00,2024-10-25 11:30:00,To pocket EUR Subscriptions from EUR,400.00,0.00,EUR,COMPLETED,413.96
Transfer,Pocket,2024-11-01 00:00:00,2024-11-01 11:50:55,To Flogas,-83.82,0.00,EUR,COMPLETED,330.14
Transfer,Pocket,2024-11-01 00:00:00,2024-11-01 11:58:43,To Flogas Natural Gas,-89.51,0.00,EUR,COMPLETED,240.63
Card Payment,Pocket,2024-11-03 02:04:12,2024-11-03 10:55:53,Netflix,-14.99,0.00,EUR,COMPLETED,225.64
Card Payment,Pocket,2024-11-02 19:59:15,2024-11-03 11:14:54,Spotify,-19.99,0.00,EUR,COMPLETED,205.65
Transfer,Pocket,2024-11-04 00:00:00,2024-11-04 11:47:04,To Royal London,-16.72,0.00,EUR,COMPLETED,188.93
Card Payment,Pocket,2024-11-07 03:04:04,2024-11-08 11:45:03,FLYEfit,-5.00,0.00,EUR,COMPLETED,183.93
Card Payment,Pocket,2024-11-11 14:10:27,2024-11-12 10:58:58,GoMo,-9.99,0.00,EUR,COMPLETED,173.94
Transfer,Pocket,2024-11-16 15:43:21,2024-11-16 15:43:21,Pocket Withdrawal,-100.00,0.00,EUR,COMPLETED,73.94
Card Payment,Pocket,2024-11-19 19:45:17,2024-11-20 11:35:52,Transport for Ireland - TFI,-40.00,0.00,EUR,COMPLETED,33.94
Transfer,Pocket,2024-11-25 10:20:34,2024-11-25 10:20:34,To pocket EUR Subscriptions from EUR,400.00,0.00,EUR,COMPLETED,433.94
Transfer,Pocket,2024-11-25 00:00:00,2024-11-25 11:45:56,To Royal London,-16.72,0.00,EUR,COMPLETED,417.22
Transfer,Pocket,2024-12-02 00:00:00,2024-12-02 12:09:10,To Flogas,-83.82,0.00,EUR,COMPLETED,333.40
Transfer,Pocket,2024-12-02 00:00:00,2024-12-02 12:09:12,To Flogas Natural Gas,-89.51,0.00,EUR,COMPLETED,243.89
Card Payment,Pocket,2024-12-02 19:59:17,2024-12-03 13:12:54,Spotify,-19.99,0.00,EUR,COMPLETED,223.90
Card Payment,Pocket,2024-12-03 02:02:34,2024-12-03 13:38:07,Netflix,-14.99,0.00,EUR,COMPLETED,208.91
Transfer,Pocket,2024-12-05 00:00:00,2024-12-05 11:50:49,To Virgin Media Ireland Limited,-74.66,0.00,EUR,COMPLETED,134.25
Card Payment,Pocket,2024-12-07 02:34:06,2024-12-08 11:40:02,FLYEfit,-5.00,0.00,EUR,COMPLETED,129.25
Card Payment,Pocket,2024-12-10 17:35:39,2024-12-11 13:19:22,GoMo,-9.99,0.00,EUR,COMPLETED,119.26
Transfer,Pocket,2024-12-20 10:16:18,2024-12-20 10:16:18,Pocket Withdrawal,-100.00,0.00,EUR,COMPLETED,19.26
Transfer,Pocket,2024-12-23 08:08:17,2024-12-23 08:08:17,To pocket EUR Subscriptions from EUR,400.00,0.00,EUR,COMPLETED,419.26
Transfer,Pocket,2024-12-30 00:00:00,2024-12-30 11:41:44,To Royal London,-16.72,0.00,EUR,COMPLETED,402.54
Transfer,Pocket,2024-12-30 11:45:47,2024-12-30 11:45:47,Pocket Withdrawal,-50.00,0.00,EUR,COMPLETED,352.54
Transfer,Pocket,2025-01-02 00:00:00,2025-01-02 11:46:16,To Flogas,-32.06,0.00,EUR,COMPLETED,320.48
Transfer,Pocket,2025-01-02 00:00:00,2025-01-02 11:55:53,To Flogas Natural Gas,-74.00,0.00,EUR,COMPLETED,246.48
Card Payment,Pocket,2025-01-02 19:59:13,2025-01-03 11:14:29,Spotify,-19.99,0.00,EUR,COMPLETED,226.49
Card Payment,Pocket,2025-01-03 02:50:16,2025-01-03 12:04:43,Netflix,-14.99,0.00,EUR,COMPLETED,211.50
Transfer,Pocket,2025-01-06 11:33:32,2025-01-06 12:33:58,To Ireland: Workday Limited,-6.75,0.00,EUR,COMPLETED,204.75
Card Payment,Pocket,2025-01-10 21:34:05,2025-01-11 12:42:12,GoMo,-9.99,0.00,EUR,COMPLETED,194.76
Transfer,Pocket,2025-01-16 18:38:12,2025-01-16 18:38:12,Pocket Withdrawal,-140.00,0.00,EUR,COMPLETED,54.76
Transfer,Pocket,2025-01-16 18:38:37,2025-01-16 18:38:37,Pocket Withdrawal,-25.00,0.00,EUR,COMPLETED,29.76
Transfer,Pocket,2025-01-25 10:16:09,2025-01-25 10:16:09,To pocket EUR Subscriptions from EUR,400.00,0.00,EUR,COMPLETED,429.76
Transfer,Pocket,2025-01-27 00:00:00,2025-01-27 12:58:36,To Royal London,-16.72,0.00,EUR,COMPLETED,413.04
Transfer,Pocket,2025-01-28 13:31:20,2025-01-28 13:31:20,Pocket Withdrawal,-100.00,0.00,EUR,COMPLETED,313.04
Card Payment,Pocket,2025-02-03 02:31:51,2025-02-03 09:50:16,Netflix,-14.99,0.00,EUR,COMPLETED,298.05
Card Payment,Pocket,2025-02-02 19:59:12,2025-02-03 13:00:33,Spotify,-19.99,0.00,EUR,COMPLETED,278.06
Transfer,Pocket,2025-02-04 00:00:00,2025-02-04 11:48:52,To Flogas,-32.06,0.00,EUR,COMPLETED,246.00
Card Payment,Pocket,2025-02-04 10:11:48,2025-02-05 15:07:21,YouTube,-13.99,0.00,EUR,COMPLETED,232.01
Transfer,Pocket,2025-02-06 00:00:00,2025-02-06 11:52:02,To Flogas Natural Gas,-74.00,0.00,EUR,COMPLETED,158.01
Transfer,Pocket,2025-02-22 15:27:13,2025-02-22 15:27:13,Pocket Withdrawal,-150.00,0.00,EUR,COMPLETED,8.01
Transfer,Pocket,2025-02-25 01:05:50,2025-02-25 01:05:50,To pocket EUR Subscriptions from EUR,400.00,0.00,EUR,COMPLETED,408.01
Transfer,Pocket,2025-02-25 08:32:17,2025-02-25 08:32:17,To pocket EUR Subscriptions from EUR,400.00,0.00,EUR,COMPLETED,808.01
Transfer,Pocket,2025-02-25 00:00:00,2025-02-25 11:43:19,To Royal London,-16.72,0.00,EUR,COMPLETED,791.29
Transfer,Pocket,2025-02-25 11:47:50,2025-02-25 11:47:50,To Instant Access Savings,-500.00,0.00,EUR,COMPLETED,291.29
Card Payment,Pocket,2025-02-28 00:35:14,2025-02-28 13:10:49,Apple,-9.99,0.00,EUR,COMPLETED,281.30
Card Payment,Pocket,2025-03-02 19:59:15,2025-03-03 11:08:22,Spotify,-19.99,0.00,EUR,COMPLETED,261.31
Transfer,Pocket,2025-03-03 00:00:00,2025-03-03 12:01:27,To Flogas Natural Gas,-74.00,0.00,EUR,COMPLETED,187.31
Transfer,Pocket,2025-03-03 00:00:00,2025-03-03 12:01:28,To Flogas,-32.06,0.00,EUR,COMPLETED,155.25
Card Payment,Pocket,2025-03-03 02:48:06,2025-03-03 12:26:51,Netflix,-14.99,0.00,EUR,COMPLETED,140.26
Card Payment,Pocket,2025-02-28 03:40:49,2025-03-04 13:09:41,FLYEfit,-37.00,0.00,EUR,COMPLETED,103.26
Card Payment,Pocket,2025-03-04 10:11:48,2025-03-05 15:14:37,YouTube,-13.99,0.00,EUR,COMPLETED,89.27
Card Payment,Pocket,2025-03-08 13:24:09,2025-03-09 12:36:47,Apple,-59.99,0.00,EUR,COMPLETED,29.28
Card Payment,Pocket,2025-03-10 22:04:45,2025-03-11 09:56:22,GoMo,-9.99,0.00,EUR,COMPLETED,19.29
Card Payment,Pocket,2025-03-23 20:48:30,2025-03-24 11:03:33,Apple,-1.99,0.00,EUR,COMPLETED,17.30
Transfer,Pocket,2025-03-25 08:37:16,2025-03-25 08:37:16,To pocket EUR Subscriptions from EUR,250.00,0.00,EUR,COMPLETED,267.30
Card Payment,Pocket,2025-03-24 15:00:13,2025-03-25 10:47:33,Apple,-14.99,0.00,EUR,COMPLETED,252.31
Card Payment,Pocket,2025-03-31 03:04:13,2025-04-02 14:36:50,FLYEfit,-37.00,0.00,EUR,COMPLETED,215.31
Card Payment,Pocket,2025-04-02 20:59:17,2025-04-03 10:27:54,Spotify,-19.99,0.00,EUR,COMPLETED,195.32
Card Payment,Pocket,2025-04-04 10:11:48,2025-04-05 17:00:59,YouTube,-13.99,0.00,EUR,COMPLETED,181.33
Card Payment,Pocket,2025-04-09 20:36:23,2025-04-10 10:40:00,GoMo,-9.99,0.00,EUR,COMPLETED,171.34
Card Payment,Pocket,2025-04-15 08:06:20,2025-04-16 10:16:35,Transport for Ireland - TFI,-40.00,0.00,EUR,COMPLETED,131.34
Transfer,Pocket,2025-04-25 09:48:33,2025-04-25 09:48:33,To pocket EUR Subscriptions from EUR,250.00,0.00,EUR,COMPLETED,381.34
Transfer,Pocket,2025-04-25 09:48:33,2025-04-25 09:48:33,To pocket EUR Subscriptions from EUR,780.42,0.00,EUR,COMPLETED,1161.76
Transfer,Pocket,2025-04-25 01:00:00,2025-04-25 11:43:49,To Royal London,-16.72,0.00,EUR,COMPLETED,1145.04
Transfer,Pocket,2025-04-25 16:07:02,2025-04-25 16:07:02,To pocket EUR Subscriptions from EUR,855.00,0.00,EUR,COMPLETED,2000.04
Card Payment,Pocket,2025-04-27 10:42:48,2025-04-28 11:56:23,Apple,-75.99,0.00,EUR,COMPLETED,1924.05
Card Payment,Pocket,2025-04-30 03:06:15,2025-05-02 10:38:49,FLYEfit,-37.00,0.00,EUR,COMPLETED,1887.05
Card Payment,Pocket,2025-05-02 20:59:12,2025-05-03 11:15:10,Spotify,-19.99,0.00,EUR,COMPLETED,1867.06
Card Payment,Pocket,2025-05-04 10:11:48,2025-05-05 14:34:05,YouTube,-13.99,0.00,EUR,COMPLETED,1853.07
Transfer,Pocket,2025-05-12 01:00:00,2025-05-12 11:49:45,To Bankinter SA Ireland Branch,-1649.75,0.00,EUR,COMPLETED,203.32
Transfer,Pocket,2025-05-25 09:43:58,2025-05-25 09:43:58,To pocket EUR Subscriptions from EUR,250.00,0.00,EUR,COMPLETED,453.32
Transfer,Pocket,2025-05-25 09:43:58,2025-05-25 09:43:58,To pocket EUR Subscriptions from EUR,780.42,0.00,EUR,COMPLETED,1233.74
Transfer,Pocket,2025-05-26 01:00:00,2025-05-26 11:47:54,To Royal London,-16.72,0.00,EUR,COMPLETED,1217.02
Transfer,Pocket,2025-05-28 17:23:49,2025-05-28 17:23:49,To pocket EUR Subscriptions from EUR,500.00,0.00,EUR,COMPLETED,1717.02
Card Payment,Pocket,2025-05-31 03:43:10,2025-06-01 12:02:15,FLYEfit,-37.00,0.00,EUR,COMPLETED,1680.02
Transfer,Pocket,2025-06-03 08:50:59,2025-06-03 08:50:59,To pocket EUR Subscriptions from EUR,40.00,0.00,EUR,COMPLETED,1720.02
Card Payment,Pocket,2025-06-02 20:59:13,2025-06-03 09:33:44,Spotify,-19.99,0.00,EUR,COMPLETED,1700.03
Card Payment,Pocket,2025-06-04 10:11:48,2025-06-05 14:41:25,YouTube,-13.99,0.00,EUR,COMPLETED,1686.04
Card Payment,Pocket,2025-06-08 01:17:09,2025-06-08 11:04:58,Apple,-99.99,0.00,EUR,COMPLETED,1586.05
Transfer,Pocket,2025-06-10 10:11:40,2025-06-10 10:11:40,To pocket EUR Subscriptions from EUR,1649.00,0.00,EUR,COMPLETED,3235.05
Transfer,Pocket,2025-06-11 01:00:00,2025-06-11 11:46:18,To Bankinter SA Ireland Branch,-1649.75,0.00,EUR,COMPLETED,1585.30
Card Payment,Pocket,2025-06-11 21:07:31,2025-06-12 10:15:13,GoMo,-9.99,0.00,EUR,COMPLETED,1575.31
Transfer,Pocket,2025-06-23 01:00:00,2025-06-23 11:45:27,To eFlow,-5.83,0.00,EUR,COMPLETED,1569.48
Transfer,Pocket,2025-06-25 08:24:48,2025-06-25 08:50:20,To Payward Ireland Ltd.,-125.00,0.00,EUR,COMPLETED,1444.48
Transfer,Pocket,2025-06-25 08:24:48,2025-06-25 08:50:21,To Trading 212 UK Limited,-750.00,0.00,EUR,COMPLETED,694.48
Transfer,Pocket,2025-06-25 09:46:27,2025-06-25 09:46:27,To pocket EUR Subscriptions from EUR,250.00,0.00,EUR,COMPLETED,944.48
Transfer,Pocket,2025-06-25 09:46:28,2025-06-25 09:46:28,To pocket EUR Subscriptions from EUR,780.42,0.00,EUR,COMPLETED,1724.90
Transfer,Pocket,2025-06-25 01:00:00,2025-06-25 11:50:29,To Royal London,-16.72,0.00,EUR,COMPLETED,1708.18
Transfer,Pocket,2025-06-30 14:31:49,2025-06-30 14:31:49,To Instant Access Savings,-0.05,0.00,EUR,COMPLETED,1708.13
Card Payment,Pocket,2025-06-30 14:31:48,2025-07-01 09:55:01,DoneDeal,-1.99,0.00,EUR,COMPLETED,1706.14
Transfer,Pocket,2025-07-01 13:04:39,2025-07-01 13:04:39,From Instant Access Savings,380.00,0.00,EUR,COMPLETED,2086.14
Transfer,Pocket,2025-07-01 13:04:50,2025-07-01 13:04:50,Pocket Withdrawal,-380.00,0.00,EUR,COMPLETED,1706.14
Transfer,Pocket,2025-07-01 16:37:59,2025-07-01 16:38:00,To Instant Access Savings,-0.05,0.00,EUR,COMPLETED,1706.09
Transfer,Pocket,2025-07-01 17:56:34,2025-07-01 17:56:34,To Instant Access Savings,-0.60,0.00,EUR,COMPLETED,1705.49
Transfer,Pocket,2025-07-01 20:52:29,2025-07-01 20:52:29,To Instant Access Savings,-5.00,0.00,EUR,COMPLETED,1700.49
Transfer,Pocket,2025-07-02 09:07:34,2025-07-02 09:07:34,To Instant Access Savings,-2.70,0.00,EUR,COMPLETED,1697.79
Card Payment,Pocket,2025-06-30 03:37:03,2025-07-02 11:27:11,FLYEfit,-37.00,0.00,EUR,COMPLETED,1660.79
Card Payment,Pocket,2025-07-01 16:37:59,2025-07-02 11:38:16,Apple,-9.99,0.00,EUR,COMPLETED,1650.80
Card Payment,Pocket,2025-07-01 20:52:28,2025-07-02 11:54:28,Rugs Ireland,-309.00,0.00,EUR,COMPLETED,1341.80
Transfer,Pocket,2025-07-02 12:06:26,2025-07-02 12:06:26,To Instant Access Savings,-1.05,0.00,EUR,COMPLETED,1340.75
Transfer,Pocket,2025-07-02 13:37:17,2025-07-02 13:37:17,To Instant Access Savings,-1.45,0.00,EUR,COMPLETED,1339.30
Transfer,Pocket,2025-07-02 20:59:19,2025-07-02 20:59:19,To Instant Access Savings,-0.05,0.00,EUR,COMPLETED,1339.25
Transfer,Pocket,2025-07-03 08:54:41,2025-07-03 08:54:41,To Instant Access Savings,-1.50,0.00,EUR,COMPLETED,1337.75
Card Payment,Pocket,2025-07-02 20:59:18,2025-07-03 09:59:26,Spotify,-19.99,0.00,EUR,COMPLETED,1317.76
Transfer,Pocket,2025-07-03 10:28:37,2025-07-03 10:28:37,From Instant Access Savings,500.00,0.00,EUR,COMPLETED,1817.76
Card Payment,Pocket,2025-07-02 12:06:18,2025-07-03 11:53:16,HP,-1.79,0.00,EUR,COMPLETED,1815.97
Card Payment,Pocket,2025-07-01 17:56:34,2025-07-03 12:43:55,Amazon,-17.88,0.00,EUR,COMPLETED,1798.09
Card Payment,Pocket,2025-07-02 09:07:33,2025-07-03 13:29:46,Amazon,-37.46,0.00,EUR,COMPLETED,1760.63
Card Payment,Pocket,2025-07-03 08:54:40,2025-07-04 10:11:12,McDonald's,-5.70,0.00,EUR,COMPLETED,1754.93
Card Payment,Pocket,2025-07-02 13:37:12,2025-07-04 18:40:27,Amazon,-41.71,0.00,EUR,COMPLETED,1713.22
Transfer,Pocket,2025-07-11 01:00:00,2025-07-11 11:51:45,To Bankinter SA Ireland Branch,-1649.75,0.00,EUR,COMPLETED,63.47
Transfer,Pocket,2025-07-23 01:00:00,2025-07-23 11:46:55,To eFlow,-29.73,0.00,EUR,COMPLETED,33.74
Transfer,Pocket,2025-07-25 09:37:53,2025-07-25 09:37:53,To pocket EUR Subscriptions from EUR,250.00,0.00,EUR,COMPLETED,283.74
Transfer,Pocket,2025-07-25 09:37:53,2025-07-25 09:37:53,To pocket EUR Subscriptions from EUR,780.42,0.00,EUR,COMPLETED,1064.16
Transfer,Pocket,2025-07-25 01:00:00,2025-07-25 11:46:41,To Royal London,-16.72,0.00,EUR,COMPLETED,1047.44
Transfer,Pocket,2025-07-25 15:15:18,2025-07-25 15:15:18,To pocket EUR Subscriptions from EUR,700.00,0.00,EUR,COMPLETED,1747.44
Transfer,Pocket,2025-07-29 16:32:22,2025-07-29 16:32:22,Pocket Withdrawal,-40.00,0.00,EUR,COMPLETED,1707.44
Transfer,Pocket,2025-07-31 12:15:35,2025-07-31 12:15:35,Pocket Withdrawal,-37.00,0.00,EUR,COMPLETED,1670.44
Transfer,Pocket,2025-08-04 16:11:17,2025-08-04 16:11:17,Pocket Withdrawal,-100.00,0.00,EUR,COMPLETED,1570.44
Transfer,Pocket,2025-08-10 12:06:52,2025-08-10 12:06:52,Pocket Withdrawal,-100.00,0.00,EUR,COMPLETED,1470.44
Transfer,Pocket,2025-08-10 19:39:07,2025-08-10 19:39:07,Pocket Withdrawal,-1470.44,0.00,EUR,COMPLETED,0.00
Transfer,Savings,2024-01-12 20:35:37,2024-01-12 20:35:37,To pocket EUR Rainy day from EUR,5.00,0.00,EUR,COMPLETED,5.00
Transfer,Savings,2024-01-12 20:54:56,2024-01-12 20:54:56,To pocket EUR Rainy day from EUR,4.30,0.00,EUR,COMPLETED,9.30
Transfer,Savings,2024-01-13 10:30:53,2024-01-13 10:30:53,To pocket EUR Rainy day from EUR,0.75,0.00,EUR,COMPLETED,10.05
Transfer,Savings,2024-01-13 11:03:10,2024-01-13 11:03:10,To pocket EUR Rainy day from EUR,4.00,0.00,EUR,COMPLETED,14.05
Transfer,Savings,2024-01-13 16:10:16,2024-01-13 16:10:16,To pocket EUR Rainy day from EUR,2.75,0.00,EUR,COMPLETED,16.80
Transfer,Savings,2024-01-13 16:38:49,2024-01-13 16:38:49,To pocket EUR Rainy day from EUR,1.50,0.00,EUR,COMPLETED,18.30
Transfer,Savings,2024-01-14 11:26:48,2024-01-14 11:26:48,To pocket EUR Rainy day from EUR,0.35,0.00,EUR,COMPLETED,18.65
Transfer,Savings,2024-01-14 13:53:33,2024-01-14 13:53:33,To pocket EUR Rainy day from EUR,5.00,0.00,EUR,COMPLETED,23.65
Transfer,Savings,2024-01-14 14:18:00,2024-01-14 14:18:00,To pocket EUR Rainy day from EUR,4.30,0.00,EUR,COMPLETED,27.95
Transfer,Savings,2024-01-14 14:41:32,2024-01-14 14:41:32,To pocket EUR Rainy day from EUR,3.00,0.00,EUR,COMPLETED,30.95
Transfer,Savings,2024-01-15 10:56:03,2024-01-15 10:56:03,To pocket EUR Rainy day from EUR,2.50,0.00,EUR,COMPLETED,33.45
Transfer,Savings,2024-01-15 22:15:43,2024-01-15 22:15:43,To pocket EUR Rainy day from EUR,2.20,0.00,EUR,COMPLETED,35.65
Transfer,Savings,2024-01-19 12:45:09,2024-01-19 12:45:09,To pocket EUR Rainy day from EUR,3.00,0.00,EUR,COMPLETED,38.65
Transfer,Savings,2024-01-19 13:48:50,2024-01-19 13:48:50,To pocket EUR Rainy day from EUR,3.75,0.00,EUR,COMPLETED,42.40
Transfer,Savings,2024-01-19 18:05:44,2024-01-19 18:05:44,To pocket EUR Rainy day from EUR,2.35,0.00,EUR,COMPLETED,44.75
Transfer,Savings,2024-01-19 22:46:13,2024-01-19 22:46:13,To pocket EUR Rainy day from EUR,4.25,0.00,EUR,COMPLETED,49.00
Transfer,Savings,2024-01-20 10:55:45,2024-01-20 10:55:45,To pocket EUR Rainy day from EUR,5.00,0.00,EUR,COMPLETED,54.00
Transfer,Savings,2024-01-20 12:03:16,2024-01-20 12:03:16,To pocket EUR Rainy day from EUR,4.25,0.00,EUR,COMPLETED,58.25
Transfer,Savings,2024-01-20 12:34:31,2024-01-20 12:34:31,To pocket EUR Rainy day from EUR,1.40,0.00,EUR,COMPLETED,59.65
Transfer,Savings,2024-01-21 14:30:15,2024-01-21 14:30:15,To pocket EUR Rainy day from EUR,3.75,0.00,EUR,COMPLETED,63.40
Transfer,Savings,2024-01-21 14:49:43,2024-01-21 14:49:43,To pocket EUR Rainy day from EUR,5.00,0.00,EUR,COMPLETED,68.40
Transfer,Savings,2024-01-21 15:51:39,2024-01-21 15:51:39,To pocket EUR Rainy day from EUR,4.50,0.00,EUR,COMPLETED,72.90
Transfer,Savings,2024-01-22 21:47:43,2024-01-22 21:47:43,To pocket EUR Rainy day from EUR,5.00,0.00,EUR,COMPLETED,77.90
Transfer,Savings,2024-01-23 08:46:08,2024-01-23 08:46:08,To pocket EUR Rainy day from EUR,1.50,0.00,EUR,COMPLETED,79.40
Transfer,Savings,2024-01-23 19:52:35,2024-01-23 19:52:35,To pocket EUR Rainy day from EUR,4.00,0.00,EUR,COMPLETED,83.40
Transfer,Savings,2024-01-24 18:22:30,2024-01-24 18:22:30,To pocket EUR Rainy day from EUR,5.00,0.00,EUR,COMPLETED,88.40
Transfer,Savings,2024-01-25 08:41:12,2024-01-25 08:41:12,To pocket EUR Rainy day from EUR,5.00,0.00,EUR,COMPLETED,93.40
Transfer,Savings,2024-01-25 19:45:49,2024-01-25 19:45:49,To pocket EUR Rainy day from EUR,3.55,0.00,EUR,COMPLETED,96.95
Transfer,Savings,2024-01-26 08:08:01,2024-01-26 08:08:01,To pocket EUR Rainy day from EUR,1.50,0.00,EUR,COMPLETED,98.45
Transfer,Savings,2024-01-26 14:03:46,2024-01-26 14:03:46,To pocket EUR Rainy day from EUR,5.00,0.00,EUR,COMPLETED,103.45
Transfer,Savings,2024-01-26 16:31:11,2024-01-26 16:31:11,To pocket EUR Rainy day from EUR,0.10,0.00,EUR,COMPLETED,103.55
Transfer,Savings,2024-01-26 20:13:28,2024-01-26 20:13:28,To pocket EUR Rainy day from EUR,5.00,0.00,EUR,COMPLETED,108.55
Transfer,Savings,2024-01-27 10:22:02,2024-01-27 10:22:02,To pocket EUR Rainy day from EUR,5.00,0.00,EUR,COMPLETED,113.55
Transfer,Savings,2024-01-27 15:25:40,2024-01-27 15:25:40,To pocket EUR Rainy day from EUR,0.30,0.00,EUR,COMPLETED,113.85
Transfer,Savings,2024-01-27 15:26:26,2024-01-27 15:26:26,To pocket EUR Rainy day from EUR,5.00,0.00,EUR,COMPLETED,118.85
Transfer,Savings,2024-01-27 17:25:34,2024-01-27 17:25:34,To pocket EUR Rainy day from EUR,3.75,0.00,EUR,COMPLETED,122.60
Transfer,Savings,2024-01-27 19:29:38,2024-01-27 19:29:38,To pocket EUR Rainy day from EUR,0.05,0.00,EUR,COMPLETED,122.65
Transfer,Savings,2024-01-28 09:42:26,2024-01-28 09:42:26,To pocket EUR Rainy day from EUR,4.00,0.00,EUR,COMPLETED,126.65
Transfer,Savings,2024-01-28 10:18:01,2024-01-28 10:18:01,To pocket EUR Rainy day from EUR,5.00,0.00,EUR,COMPLETED,131.65
Transfer,Savings,2024-01-28 14:35:31,2024-01-28 14:35:31,To pocket EUR Rainy day from EUR,5.00,0.00,EUR,COMPLETED,136.65
Transfer,Savings,2024-01-28 15:23:13,2024-01-28 15:23:13,To pocket EUR Rainy day from EUR,2.35,0.00,EUR,COMPLETED,139.00
Transfer,Savings,2024-01-29 22:09:28,2024-01-29 22:09:28,To pocket EUR Rainy day from EUR,0.50,0.00,EUR,COMPLETED,139.50
Transfer,Savings,2024-01-30 08:11:34,2024-01-30 08:11:34,To pocket EUR Rainy day from EUR,1.50,0.00,EUR,COMPLETED,141.00
Transfer,Savings,2024-01-30 14:36:27,2024-01-30 14:36:27,To pocket EUR Rainy day from EUR,1.50,0.00,EUR,COMPLETED,142.50
Transfer,Savings,2024-01-30 20:18:33,2024-01-30 20:18:33,To pocket EUR Rainy day from EUR,4.00,0.00,EUR,COMPLETED,146.50
Transfer,Savings,2024-01-31 07:57:28,2024-01-31 07:57:28,To pocket EUR Rainy day from EUR,0.05,0.00,EUR,COMPLETED,146.55
Transfer,Savings,2024-01-31 12:31:42,2024-01-31 12:31:42,To pocket EUR Rainy day from EUR,5.00,0.00,EUR,COMPLETED,151.55
Transfer,Savings,2024-01-31 15:00:01,2024-01-31 15:00:01,To pocket EUR Rainy day from EUR,5.00,0.00,EUR,COMPLETED,156.55
Transfer,Savings,2024-01-31 18:00:13,2024-01-31 18:00:13,To pocket EUR Rainy day from EUR,1.00,0.00,EUR,COMPLETED,157.55
Transfer,Savings,2024-01-31 20:24:29,2024-01-31 20:24:29,Pocket Withdrawal,-50.00,0.00,EUR,COMPLETED,107.55
Transfer,Savings,2024-02-01 11:53:42,2024-02-01 11:53:42,To pocket EUR Rainy day from EUR,4.80,0.00,EUR,COMPLETED,112.35
Transfer,Savings,2024-02-01 11:54:45,2024-02-01 11:54:45,Pocket Withdrawal,-100.00,0.00,EUR,COMPLETED,12.35
Transfer,Savings,2024-02-01 12:01:34,2024-02-01 12:01:34,To pocket EUR Rainy day from EUR,2.80,0.00,EUR,COMPLETED,15.15
Transfer,Savings,2024-02-01 18:43:47,2024-02-01 18:43:47,To pocket EUR Rainy day from EUR,3.95,0.00,EUR,COMPLETED,19.10
Transfer,Savings,2024-02-01 18:53:04,2024-02-01 18:53:04,To pocket EUR Rainy day from EUR,4.50,0.00,EUR,COMPLETED,23.60
Transfer,Savings,2024-02-02 11:14:22,2024-02-02 11:14:22,To pocket EUR Rainy day from EUR,2.20,0.00,EUR,COMPLETED,25.80
Transfer,Savings,2024-02-02 19:57:36,2024-02-02 19:57:36,To pocket EUR Rainy day from EUR,2.90,0.00,EUR,COMPLETED,28.70
Transfer,Savings,2024-02-03 09:47:59,2024-02-03 09:47:59,Pocket Withdrawal,-28.00,0.00,EUR,COMPLETED,0.70
Transfer,Savings,2024-02-03 09:53:58,2024-02-03 09:53:58,To pocket EUR Rainy day from EUR,2.00,0.00,EUR,COMPLETED,2.70
Transfer,Savings,2024-02-04 02:52:25,2024-02-04 02:52:25,To pocket EUR Rainy day from EUR,0.05,0.00,EUR,COMPLETED,2.75
Transfer,Savings,2024-02-04 09:24:29,2024-02-04 09:24:29,To pocket EUR Rainy day from EUR,4.50,0.00,EUR,COMPLETED,7.25
Transfer,Savings,2024-02-04 09:36:22,2024-02-04 09:36:22,To pocket EUR Rainy day from EUR,0.05,0.00,EUR,COMPLETED,7.30
Transfer,Savings,2024-02-04 17:20:47,2024-02-04 17:20:47,To pocket EUR Rainy day from EUR,2.60,0.00,EUR,COMPLETED,9.90
Transfer,Savings,2024-02-05 13:52:33,2024-02-05 13:52:33,To pocket EUR Rainy day from EUR,2.85,0.00,EUR,COMPLETED,12.75
Transfer,Savings,2024-02-05 14:03:38,2024-02-05 14:03:38,To pocket EUR Rainy day from EUR,2.00,0.00,EUR,COMPLETED,14.75
Transfer,Savings,2024-02-05 22:03:05,2024-02-05 22:03:05,To pocket EUR Rainy day from EUR,0.05,0.00,EUR,COMPLETED,14.80
Transfer,Savings,2024-02-06 16:16:32,2024-02-06 16:16:32,To pocket EUR Rainy day from EUR,4.15,0.00,EUR,COMPLETED,18.95
Transfer,Savings,2024-02-06 20:59:36,2024-02-06 20:59:36,To pocket EUR Rainy day from EUR,5.00,0.00,EUR,COMPLETED,23.95
Transfer,Savings,2024-02-07 11:06:02,2024-02-07 11:06:02,To pocket EUR Rainy day from EUR,2.00,0.00,EUR,COMPLETED,25.95
Transfer,Savings,2024-02-07 15:01:58,2024-02-07 15:01:58,To pocket EUR Rainy day from EUR,5.00,0.00,EUR,COMPLETED,30.95
Transfer,Savings,2024-02-07 17:11:22,2024-02-07 17:11:22,To pocket EUR Rainy day from EUR,4.95,0.00,EUR,COMPLETED,35.90
Transfer,Savings,2024-02-09 08:21:27,2024-02-09 08:21:27,To pocket EUR Rainy day from EUR,2.00,0.00,EUR,COMPLETED,37.90
Transfer,Savings,2024-02-09 08:33:18,2024-02-09 08:33:18,To pocket EUR Rainy day from EUR,3.60,0.00,EUR,COMPLETED,41.50
Transfer,Savings,2024-02-10 10:05:28,2024-02-10 10:05:28,To pocket EUR Rainy day from EUR,4.30,0.00,EUR,COMPLETED,45.80
Transfer,Savings,2024-02-10 11:06:24,2024-02-10 11:06:24,To pocket EUR Rainy day from EUR,4.50,0.00,EUR,COMPLETED,50.30
Transfer,Savings,2024-02-10 15:21:20,2024-02-10 15:21:20,To pocket EUR Rainy day from EUR,1.75,0.00,EUR,COMPLETED,52.05
Transfer,Savings,2024-02-11 03:19:03,2024-02-11 03:19:03,To pocket EUR Rainy day from EUR,0.55,0.00,EUR,COMPLETED,52.60
Transfer,Savings,2024-02-11 08:45:22,2024-02-11 08:45:22,To pocket EUR Rainy day from EUR,0.05,0.00,EUR,COMPLETED,52.65
Transfer,Savings,2024-02-11 09:05:17,2024-02-11 09:05:17,To pocket EUR Rainy day from EUR,4.90,0.00,EUR,COMPLETED,57.55
Transfer,Savings,2024-02-11 18:35:17,2024-02-11 18:35:17,Pocket Withdrawal,-56.00,0.00,EUR,COMPLETED,1.55
Transfer,Savings,2024-02-13 00:37:12,2024-02-13 00:37:12,To pocket EUR Rainy day from EUR,3.90,0.00,EUR,COMPLETED,5.45
Transfer,Savings,2024-02-14 11:57:10,2024-02-14 11:57:10,To pocket EUR Rainy day from EUR,3.50,0.00,EUR,COMPLETED,8.95
Transfer,Savings,2024-02-15 19:41:54,2024-02-15 19:41:54,To pocket EUR Rainy day from EUR,5.00,0.00,EUR,COMPLETED,13.95
Transfer,Savings,2024-02-16 13:55:49,2024-02-16 13:55:49,To pocket EUR Rainy day from EUR,1.50,0.00,EUR,COMPLETED,15.45
Transfer,Savings,2024-02-16 14:39:56,2024-02-16 14:39:56,To pocket EUR Rainy day from EUR,0.25,0.00,EUR,COMPLETED,15.70
Transfer,Savings,2024-02-16 19:07:38,2024-02-16 19:07:38,To pocket EUR Rainy day from EUR,2.75,0.00,EUR,COMPLETED,18.45
Transfer,Savings,2024-02-16 19:25:19,2024-02-16 19:25:19,To pocket EUR Rainy day from EUR,0.50,0.00,EUR,COMPLETED,18.95
Transfer,Savings,2024-02-16 20:53:31,2024-02-16 20:53:31,To pocket EUR Rainy day from EUR,2.75,0.00,EUR,COMPLETED,21.70
Transfer,Savings,2024-02-16 23:32:13,2024-02-16 23:32:13,To pocket EUR Rainy day from EUR,3.20,0.00,EUR,COMPLETED,24.90
Transfer,Savings,2024-02-17 00:51:56,2024-02-17 00:51:56,To pocket EUR Rainy day from EUR,2.75,0.00,EUR,COMPLETED,27.65
Transfer,Savings,2024-02-17 02:44:10,2024-02-17 02:44:10,To pocket EUR Rainy day from EUR,3.30,0.00,EUR,COMPLETED,30.95
Transfer,Savings,2024-02-17 03:53:30,2024-02-17 03:53:30,To pocket EUR Rainy day from EUR,2.80,0.00,EUR,COMPLETED,33.75
Transfer,Savings,2024-02-17 12:46:11,2024-02-17 12:46:11,To pocket EUR Rainy day from EUR,1.00,0.00,EUR,COMPLETED,34.75
Transfer,Savings,2024-02-17 13:05:15,2024-02-17 13:05:15,To pocket EUR Rainy day from EUR,2.65,0.00,EUR,COMPLETED,37.40
Transfer,Savings,2024-02-17 15:31:35,2024-02-17 15:31:35,To pocket EUR Rainy day from EUR,1.00,0.00,EUR,COMPLETED,38.40
Transfer,Savings,2024-02-17 16:38:08,2024-02-17 16:38:08,To pocket EUR Rainy day from EUR,0.45,0.00,EUR,COMPLETED,38.85
Transfer,Savings,2024-02-17 17:13:41,2024-02-17 17:13:41,To pocket EUR Rainy day from EUR,1.95,0.00,EUR,COMPLETED,40.80
Transfer,Savings,2024-02-17 17:36:01,2024-02-17 17:36:01,To pocket EUR Rainy day from EUR,2.25,0.00,EUR,COMPLETED,43.05
Transfer,Savings,2024-02-17 18:22:31,2024-02-17 18:22:31,To pocket EUR Rainy day from EUR,4.20,0.00,EUR,COMPLETED,47.25
Transfer,Savings,2024-02-17 21:50:05,2024-02-17 21:50:05,To pocket EUR Rainy day from EUR,0.70,0.00,EUR,COMPLETED,47.95
Transfer,Savings,2024-02-17 21:52:53,2024-02-17 21:52:53,To pocket EUR Rainy day from EUR,0.95,0.00,EUR,COMPLETED,48.90
Transfer,Savings,2024-02-17 23:00:10,2024-02-17 23:00:10,To pocket EUR Rainy day from EUR,1.40,0.00,EUR,COMPLETED,50.30
Transfer,Savings,2024-02-17 23:48:24,2024-02-17 23:48:24,To pocket EUR Rainy day from EUR,0.20,0.00,EUR,COMPLETED,50.50
Transfer,Savings,2024-02-18 14:33:26,2024-02-18 14:33:26,To pocket EUR Rainy day from EUR,2.45,0.00,EUR,COMPLETED,52.95
Transfer,Savings,2024-02-19 08:16:38,2024-02-19 08:16:38,Pocket Withdrawal,-52.00,0.00,EUR,COMPLETED,0.95
Transfer,Savings,2024-02-19 08:28:41,2024-02-19 08:28:41,To pocket EUR Rainy day from EUR,1.50,0.00,EUR,COMPLETED,2.45
Transfer,Savings,2024-02-19 15:55:16,2024-02-19 15:55:16,To pocket EUR Rainy day from EUR,1.25,0.00,EUR,COMPLETED,3.70
Transfer,Savings,2024-02-19 16:05:38,2024-02-19 16:05:38,To pocket EUR Rainy day from EUR,1.30,0.00,EUR,COMPLETED,5.00
Transfer,Savings,2024-02-20 09:01:08,2024-02-20 09:01:08,To pocket EUR Rainy day from EUR,1.50,0.00,EUR,COMPLETED,6.50
Transfer,Savings,2024-02-23 08:13:29,2024-02-23 08:13:29,To pocket EUR Rainy day from EUR,1.50,0.00,EUR,COMPLETED,8.00
Transfer,Savings,2024-02-23 16:07:16,2024-02-23 16:07:16,To pocket EUR Rainy day from EUR,2.90,0.00,EUR,COMPLETED,10.90
Transfer,Savings,2024-02-23 17:01:23,2024-02-23 17:01:23,To pocket EUR Rainy day from EUR,5.00,0.00,EUR,COMPLETED,15.90
Transfer,Savings,2024-02-23 18:56:31,2024-02-23 18:56:31,To pocket EUR Rainy day from EUR,1.00,0.00,EUR,COMPLETED,16.90
Transfer,Savings,2024-02-23 19:48:05,2024-02-23 19:48:05,To pocket EUR Rainy day from EUR,5.00,0.00,EUR,COMPLETED,21.90
Transfer,Savings,2024-02-24 11:02:16,2024-02-24 11:02:16,To pocket EUR Rainy day from EUR,5.00,0.00,EUR,COMPLETED,26.90
Transfer,Savings,2024-02-24 14:23:41,2024-02-24 14:23:41,To pocket EUR Rainy day from EUR,0.05,0.00,EUR,COMPLETED,26.95
Transfer,Savings,2024-02-25 00:14:10,2024-02-25 00:14:10,To pocket EUR Rainy day from EUR,4.00,0.00,EUR,COMPLETED,30.95
Transfer,Savings,2024-02-25 08:15:23,2024-02-25 08:15:23,To pocket EUR Rainy day from EUR,0.05,0.00,EUR,COMPLETED,31.00
Transfer,Savings,2024-02-25 13:53:17,2024-02-25 13:53:17,To pocket EUR Rainy day from EUR,2.50,0.00,EUR,COMPLETED,33.50
Transfer,Savings,2024-02-25 14:09:44,2024-02-25 14:09:44,To pocket EUR Rainy day from EUR,0.05,0.00,EUR,COMPLETED,33.55
Transfer,Savings,2024-02-26 08:39:40,2024-02-26 08:39:40,To pocket EUR Rainy day from EUR,1.50,0.00,EUR,COMPLETED,35.05
Transfer,Savings,2024-02-26 13:07:49,2024-02-26 13:07:49,To pocket EUR Rainy day from EUR,2.50,0.00,EUR,COMPLETED,37.55
Transfer,Savings,2024-02-26 17:19:58,2024-02-26 17:19:58,To pocket EUR Rainy day from EUR,5.00,0.00,EUR,COMPLETED,42.55
Transfer,Savings,2024-02-26 18:28:24,2024-02-26 18:28:24,To pocket EUR Rainy day from EUR,1.50,0.00,EUR,COMPLETED,44.05
Transfer,Savings,2024-02-28 06:55:45,2024-02-28 06:55:45,Pocket Withdrawal,-44.05,0.00,EUR,COMPLETED,0.00
Transfer,Savings,2024-04-25 10:58:27,2024-04-25 10:58:27,Closing transaction,0.00,0.00,EUR,COMPLETED,0.00
